sein — bin / bist/ ist / sind / seid — ist gewesen — war = быть / существовать  
sie / Sie = она, они, её, их / Вы
in { Akkusativ, Dativ } = в  
und = и  
zu { Dativ } = к / для  
haben — hat — hat gehabt — hatte = иметь  
ich = я  
werden — wird — ist geworden — wurde = становиться / быть (вспомогательный глагол)  
mit { Dativ } = с  
an { Akkusativ, Dativ } = на / у / к  
auf { Akkusativ, Dativ } = на  
nicht = не  
es = это / оно  
sich = себя (возвратное местоимение)  
können — kann — konnte = мочь / уметь  
für { Akkusativ } = для  
von { Dativ } = от / из / с  
ihr = вы (мн.ч.) / её  
der Mann — Männer = мужчина / человек  
oder = или  
er = он  
auch = тоже / также  
aus { Dativ } = из  
richtig = правильно / верный  
dieser = этот  
nach { Dativ } = после / в / к  
wie = как  
dass = что  
machen — gemacht = делать  
geben — gibt — gegeben — gab = давать  
um { Akkusativ } = вокруг / ради / в (о времени)  
gut — besser — am besten = хороший  
so = так  
wenn = если / когда  
bei { Dativ } = у / при  
gehen — ist gegangen — ging = идти / ходить  
kommen — ist gekommen — kam = приходить / приезжать  
als = как / чем / когда  
über { Akkusativ, Dativ } = о / над / через  
wir = мы  
kein = никакой / не  
du = ты  
der Text — Texte = текст  
noch = ещё  
was = что  
dann = тогда / затем  
der Mensch — Menschen = человек  
nur = только  
das Wort — Wörter = слово  
falsch = неправильно / ложный  
mein = мой  
aber = но  
der Herr — Herren = господин  
mehr = больше  
die Moderator — Moderatoren = модератор
immer = всегда  
vor { Dativ } = перед / до  
die Präposition — Präpositionen = предлог  
schon = уже  
sehr = очень  
das Kind — Kinder = ребёнок  
der Schuh — Schuhe = туфля / обувь  
neu = новый  
der Teil — Teile = часть  
stehen — steht — gestanden — stand = стоять  
sehen — sieht — gesehen — sah = видеть  
heute = сегодня  
ergänzen — ergänzt = дополнять  
wollen — will — wollte = хотеть  
groß — größer — am größten = большой  
da = там / здесь / так как  
das Jahr — Jahre = год  
die Leute = люди  
sollen — soll — sollte = должен / следует  
die Frau — Frauen = женщина  
doch = всё же / однако  
mir = мне  
vieler = многие  
anderer = другой  
welcher = какой / который  
ihnen = им  
aller = все  
ja = да  
sprechen mit { Dativ } über { Akkusativ } — spricht — gesprochen — sprach = говорить  
sagen — gesagt = сказать / говорить  
finden — gefunden — fand = находить  
das Leben — Leben = жизнь  
etwas = что-то  
zwei = два  
das Haus — Häuser = дом  
benutzen — benutzt — benutzt = использовать  
bis { Akkusativ } = до  
ganz = весь / совсем  
wissen — weiß — gewusst — wusste = знать  
der Schuh — Schuhe = туфля / обувь  
hören — gehört = слышать / слушать  
jetzt = сейчас  
möchten — möchte = хотеть (вежливая форма)  
passend = подходящий  
schreiben — geschrieben — schrieb = писать  
die Kreuze = кресты  
denn = ведь / потому что  
die Lösung — Lösungen = решение  
der Tag — Tage = день  
unser = наш  
viel = много  
wieder = снова  
die Frage — Fragen = вопрос  
der Satz — Sätze = предложение  
folgend = следующий  
der Artikel — Artikel = статья / артикль  
das Deutschland = Германия  
die Person — Personen = человек / личность  
also = итак / следовательно  
helfen — hilft — geholfen — half = помогать  
hier = здесь  
leben — gelebt = жить  
lernen — gelernt = учить / учиться  
wichtig = важный  
die Aufgabe — Aufgaben = задание / задача  
das Auto — Autos = автомобиль  
der Freund — Freunde = друг  
die Grammatik — Grammatiken = грамматика  
alle = все  
denken — gedacht — dachte = думать  
durch { Akkusativ } = через / сквозь  
gern = охотно  
ob = ли / если  
der Akkusativ — Akkusative = винительный падеж  
das Beispiel — Beispiele = пример  
der Mann — Männer = мужчина / человек  
fahren — fährt — ist gefahren — fuhr = ехать / водить  
jeder = каждый  
lesen — liest — gelesen — las = читать  
mich = меня  
der Film — Filme = фильм  
der Hauptsatz — Hauptsätze = главное предложение  
die Mail — Mails = письмо (электронное)  
die Schule — Schulen = школа  
die Zeit — Zeiten = время  
bekommen — bekommen — bekam = получать  
dazu = к этому  
einmal = один раз / однажды  
früh = рано  
verstehen — verstanden — verstand = понимать  
warum = почему  
wo = где  
die Antwort — Antworten = ответ  
der Computer — Computer = компьютер  
das Verb — Verben = глагол  
weil = потому что  
die Aussage — Aussagen = утверждение  
das Partizip — Partizipien = причастие  
ohne { Akkusativ } = без  
weniger = меньше  
wer = кто  
der Ausdruck — Ausdrücke = выражение  
die Information — Informationen = информация  
die Stadt — Städte = город  
arbeiten — gearbeitet = работать  
heißen — heißt — geheißen — hieß = называться / звать  
kaufen — gekauft = покупать  
der Kasten — Kästen = ящик / коробка  
ordnen — geordnet = упорядочивать  
alt — älter — am ältesten = старый  
bleiben — ist geblieben — blieb = оставаться  
erster = первый  
müssen — muss — musste = должен / нужно  
suchen — gesucht = искать  
treffen sich — trifft — getroffen — traf = встречаться  
uns = нас  
die Arbeit — Arbeiten = работа  
der Grund — Gründe = причина / основание  
das Land — Länder = страна  
der Plural — Plurale = множественное число  
das Thema — Themen = тема  
die Uhr — Uhren = часы  
der Wortschatz — Wortschätze = словарный запас  
brauchen — gebraucht = нуждаться  
dafür = для этого  
dort = там  
die Überschrift — Überschriften = заголовок  
der Dativ — Dative = дательный падеж  
der Genitiv — Genitive = родительный падеж  
bringen — gebracht — brachte = приносить  
die Familie — Familien = семья  
das Geld = деньги  
das Kino — Kinos = кино  
der Nebensatz — Nebensätze = придаточное предложение  
der Relativsatz — Relativsätze = относительное придаточное предложение  
das Verb — Verben = глагол  
beginnen — begonnen — begann = начинать  
einfach = просто / простой  
lange = долго  
markieren — markiert = отмечать  
muss = должен  
zusammen = вместе  
die Form — Formen = форма  
die Kirche — Kirchen = церковь  
der Konjunktiv — Konjunktive = сослагательное наклонение  
muss = должен  
der Passiv — Passive = пассивный залог  
die Prüfung — Prüfungen = экзамен / проверка  
ab { Dativ } = с / от  
dein = твой  
dürfen — darf — durfte = мочь / иметь разрешение  
freuen sich auf { Akkusativ } — freut — gefreut — freute = радоваться  
kennen — gekannt — kannte = знать / быть знакомым  
oft = часто  
zufrieden = довольный  
die Eltern = родители  
der Euro — Euros = евро  
die Sprache — Sprachen = язык  
das Tier — Tiere = животное  
deutsch = немецкий  
dir = тебе  
drei = три  
fragen — gefragt = спрашивать  
nehmen — nimmt — genommen — nahm = брать  
nächster = следующий  
passt = подходит  
schnell — schneller — am schnellsten = быстрый  
zwischen { Dativ } = между  
das Ende — Enden = конец  
die Freundin — Freundinnen = подруга  
die Hilfe — Hilfen = помощь  
der Partner — Partner = партнёр  
der Singular — Singulare = единственное число  
der Urlaub — Urlaube = отпуск  
die Zahl — Zahlen = число  
beide = оба  
bilden — gebildet = образовывать  
gegen { Akkusativ } = против  
gestern = вчера  
gleich = сразу / одинаковый  
klein — kleiner — am kleinsten = маленький  
liegen — gelegen — lag = лежать  
mal = раз  
nichts = ничего  
schön — schöner — am schönsten = красивый  
weit — weiter — am weitesten = далеко / широкий  
die Beziehung — Beziehungen = отношение  
das Buch — Bücher = книга  
der Kaffee — Kaffees = кофе  
das München = Мюнхен  
der Name — Namen = имя  
die Woche — Wochen = неделя  
bekannte = известный  
darauf = на это  
erhalten — erhält — erhalten — erhielt = получать  
essen — isst — gegessen — aß = есть / кушать  
gerade = прямо / только что  
möglich = возможный  
schlecht — schlechter — am schlechtesten = плохой  
spät = поздно  
statt { Dativ } = вместо  
wenig = мало  
die Angst — Ängste = страх  
das Internet = интернет  
das Kapitel — Kapitel = глава  
der Name — Namen = имя  
das Subjekt — Subjekte = подлежащее  
die Vorstellung — Vorstellungen = представление / воображение  
die Zeitung — Zeitungen = газета  
allerdings = однако  
bitte = пожалуйста  
damit = этим / чтобы  
halten — hält — gehalten — hielt = держать  
ihm = ему  
mögen — mag — mochte = любить / нравиться  
setzen — gesetzt = ставить / садиться  
wählen — gewählt = выбирать  
das Hörverstehen = аудирование  
der Ort — Orte = место  
das Wetter — Wetter = погода  
die Zukunft = будущее  
bauen — gebaut = строить  
bieten — geboten — bot = предлагать  
deshalb = поэтому  
eigen = собственный  
erzählen — erzählt = рассказывать  
jemand = кто-то  
nennen — genannt — nannte = называть  
passieren — ist passiert = происходить  
schwer — schwerer — am schwersten = тяжёлый / сложный  
selbst = сам  
stellen — gestellt = ставить  
vielleicht = возможно / может быть  
wegen { Genitiv } = из-за  
während { Genitiv } = во время  
zuerst = сначала  
die Adjektive = прилагательные  
die Bilder = картинки  
die Endung — Endungen = окончание  
die Firma — Firmen = фирма  
das Hotel — Hotels = отель  
der Mündliche — Mündlichen = устный  
die Nachricht — Nachrichten = сообщение  
Präteritum = прошедшее время (претерит)  
die Reihenfolge — Reihenfolgen = последовательность  
bedeuten — bedeutet = означать  
eben = только что / ровно  
entscheiden — entschieden — entschied = решать  
genau = точно  
handeln — gehandelt — handelte = действовать  
ihn = его  
manchmal = иногда  
passen — gepasst = подходить  
sondern = а / но (в противопоставлении)  
spielen — gespielt = играть  
steigen — ist gestiegen — stieg = подниматься  
der Berg — Berge = гора  
die Deklination — Deklinationen = склонение  
die Lese = чтение  
die Meinung — Meinungen = мнение  
das Recht — Rechte = право  
der Satzbau — Satzbaus = построение предложения  
die Situation — Situationen = ситуация  
die Tür — Türen = дверь  
der Vater — Väter = отец  
die Welt — Welten = мир  
bald = скоро  
bestehen — bestanden — bestand = состоять / выдерживать  
fliegen — ist geflogen — flog = летать  
gesund = здоровый  
lachen — gelacht = смеяться  
meinen — gemeint = считать / думать  
sitzen — sitzt — gesessen — saß = сидеть  
studieren — studiert = учиться (в вузе)  
trinken — getrunken — trank = пить  
tun — tut — getan — tat = делать  
verdienen — verdient = зарабатывать  
vergessen — vergisst — vergessen — vergaß = забывать  
warten — gewartet = ждать  
weiter = дальше  
wohl = вероятно / хорошо  
überhaupt = вообще  
überzeugen — überzeugt = убеждать  
der Anfang — Anfänge = начало  
die Beschwerde — Beschwerden = жалоба  
das Deutsch = немецкий язык  
die Ernährung — Ernährungen = питание  
die Geschichte — Geschichten = история  
das Interesse — Interessen = интерес  
die Lücke — Lücken = пробел  
die Million — Millionen = миллион  
der Nachbar — Nachbarn = сосед  
die Party — Partys = вечеринка  
der Roman — Romane = роман  
der Track — Tracks = трек  
der Vortrag — Vorträge = доклад  
die Wahl — Wahlen = выбор  
bekannt = известный  
bestimmt = определённый  
besuchen — besucht = посещать  
daran = об этом  
darüber = об этом / над этим  
dich = тебя  
endlich = наконец  
fest = твёрдый / постоянный  
gehören — gehört = принадлежать  
gemeinsam = вместе  
glauben — geglaubt — glaubte = верить  
lang — länger — am längsten = длинный / долгий  
lassen — lässt — gelassen — ließ = оставлять / позволять  
letzter = последний  
mehrere = несколько  
nein = нет  
seit { Dativ } = с (о времени)  
tragen — trägt — getragen — trug = носить  
vorstellen — stellt vor — vorgestellt — stellte vor = представлять  
wahrscheinlich = вероятно  
zurück = обратно  
die Angabe — Angaben = указание  
das Angebot — Angebote = предложение  
der August = август  
das Bio = био (органический)  
der Chef — Chefs = начальник  
die Entscheidung — Entscheidungen = решение  
der Erfolg — Erfolge = успех  
die Ergänzung — Ergänzungen = дополнение  
der Fall — Fälle = случай  
das Gefühl — Gefühle = чувство  
der Hund — Hunde = собака  
die Idee — Ideen = идея  
der Kunde — Kunden = клиент  
der Name — Namen = имя  
Plusquamperfekt = предпрошедшее время
die Position — Positionen = позиция  
das Produkt — Produkte = продукт  
die Pronominaladverbien = местоименные наречия  
das Relativpronomen — Relativpronomen = относительное местоимение  
der Sport — Sportarten = спорт  
am { Dativ } = в / на  
besonders = особенно  
bloß = только / лишь  
daher = поэтому  
davon = об этом / от этого  
erleben — erlebt = переживать / испытывать  
frei = свободный  
gelten — gilt — gegolten — galt = действовать / считаться  
hoch — höher — am höchsten = высокий  
laut = громкий / согласно  
schließen — geschlossen — schloss = закрывать  
unter { Dativ, Akkusativ } = под  
wirklich = действительно  
ändern — geändert = менять  
der Abend — Abende = вечер  
die Anzeige — Anzeigen = объявление  
die Erfahrung — Erfahrungen = опыт  
die Erwartung — Erwartungen = ожидание  
das Essen — Essen = еда  
der Gedanke — Gedanken = мысль  
der Infinitiv — Infinitive = инфинитив  
der Kurs — Kurse = курс  
die Liebe = любовь  
die Maßschuhe = обувь на заказ  
die Modalverben = модальные глаголы  
das Paar — Paare = пара  
das Problem — Probleme = проблема  
das Pronomen — Pronomen = местоимение  
das Präsens = настоящее время  
der Prüfungsteil — Prüfungsteile = часть экзамена  
die Rede — Reden = речь  
die Regel — Regeln = правило  
die Schlüsselwörter = ключевые слова  
die Seite — Seiten = страница / сторона  
der Slum — Slums = трущобы  
der Spaß = веселье  
das Theater — Theater = театр  
die Vergangenheit — Vergangenheiten = прошлое  
anders = иначе / другой  
außer { Dativ } = кроме  
eigentlich = вообще-то / на самом деле  
einiger = некоторый  
entwickeln — entwickelt = развивать  
erkennen — erkannt — erkannte = узнавать / распознавать  
erst = только / сначала  
funktionieren — funktioniert = работать (о механизмах)  
glücklich = счастливый  
infolge { Genitiv } = вследствие  
jung — jünger — am jüngsten = молодой  
mancher = некоторый  
der Meister — Meister = мастер  
natürlich = естественно  
nie = никогда  
obwohl = хотя  
ordnen — geordnet = упорядочивать  
sicher = уверенный / безопасный  
trotz { Genitiv } = несмотря на  
verbringen — verbracht = проводить (время)  
wohnen — gewohnt = жить (проживать)  
zahlen — gezahlt = платить  
zeigen — gezeigt = показывать  
der Absatz — Absätze = абзац / каблук  
die Ausbildung — Ausbildungen = образование / обучение  
das Bild — Bilder = картинка / образ  
das Europa = Европа  
der Gast — Gäste = гость  
die Homepage — Homepages = домашняя страница  
Ihnen = вам (формально)  
die Katze — Katzen = кошка  
der Kauf — Käufe = покупка  
die Kleidung — Kleidungen = одежда  
der Konnektor — Konnektoren = соединитель  
die Konnektoren = соединители  
das Latein = латынь  
der Lehrer — Lehrer = учитель  
das Leseverstehen = понимание прочитанного  
die Minute — Minuten = минута  
die Modalverben = модальные глаголы  
der Monat — Monate = месяц  
das Musical — Musicals = мюзикл  
die Musik = музыка  
das New = новое  
die Nummer — Nummern = номер  
die Sache — Sachen = вещь / дело  
die Schweiz = Швейцария  
der Schüler — Schüler = ученик  
der Sprecher — Sprecher = оратор / диктор  
die Stelle — Stellen = место / должность  
die Straße — Straßen = улица  
die Stunde — Stunden = час  
das Stuttgart = Штутгарт  
der Termin — Termine = срок / встреча  
der Tipp — Tipps = совет  
die Transkription — Transkriptionen = транскрипция  
der Unfall — Unfälle = авария  
das Ziel — Ziele = цель  
anbieten — bietet an — angeboten — bot an = предлагать  
ausdrücken — drückt aus — ausgedrückt = выражать  
bitten — gebeten — bat = просить  
dabei = при этом  
dankbar = благодарный
dauern — gedauert = длиться / продолжаться  
eingehen — geht ein — ist eingegangen — ging ein = поступать / углубляться  
einverstanden = согласен  
erinnern sich an { Akkusativ } — erinnert = помнить / вспоминать  
fallen — fällt — ist gefallen — fiel = падать  
fühlen — gefühlt = чувствовать  
gegenüber { Dativ } = напротив / по отношению к  
gegessen = съеденный  
gewinnen — gewonnen — gewann = выигрывать  
hin = туда  
interessiert = заинтересованный  
jeweils = каждый раз / соответственно  
kaum = едва / почти не  
kurz — kürzer — am kürzesten = короткий  
lieben — geliebt = любить  
lösen — gelöst = решать / развязывать  
müde = уставший  
neutral = нейтральный  
niemand = никто  
reparieren — repariert = ремонтировать  
schicken — geschickt = отправлять  
sowie = а также  
stimmen — gestimmt = соответствовать / голосовать  
teils = частично  
verlassen — verlässt — verlassen — verließ = покидать / оставлять  
verlieren — verloren — verlor = терять / проигрывать  
verschieden = различный  
voll — voller — am vollsten = полный  
ziehen — zieht — gezogen — zog = тянуть / переезжать  
die Übung — Übungen = упражнение  
das Adjektiv — Adjektive = прилагательное  
die Adjektivendung — Adjektivendungen = окончание прилагательного  
das Alter — Alter = возраст  
das Argument — Argumente = аргумент  
die Bedeutung — Bedeutungen = значение  
das Berlin = Берлин  
der Beruf — Berufe = профессия  
die Bildung — Bildungen = образование / формирование  
das Cafe — Cafes = кафе  
das Einkaufszentrum — Einkaufszentren = торговый центр  
das Fahrrad — Fahrräder = велосипед  
der Fehler — Fehler = ошибка  
das Fenster — Fenster = окно  
das Fernsehen = телевидение  
der Fernseher — Fernseher = телевизор  
das Fest — Feste = праздник  
das Geschenk — Geschenke = подарок  
die Gesellschaft — Gesellschaften = общество / компания  
der Haarausfall = выпадение волос  
der Haushalt — Haushalte = хозяйство / бюджет  
der Hinweis — Hinweise = указание / подсказка  
die Karte — Karten = карта / билет  
das Komma — Kommata = запятая  
die Kosten = расходы  
das Krankenhaus — Krankenhäuser = больница  
das Modalverb — Modalverben = модальный глагол  
das Modell — Modelle = модель  
die Möglichkeit — Möglichkeiten = возможность  
der Müll = мусор  
die Polizei — Polizeien = полиция  
die Post — Posten = почта  
der Preis — Preise = цена / приз  
der Rat — Räte = совет  
der Satzteil — Satzteile = часть предложения  
der Schuhmacher — Schuhmacher = сапожник  
der Service — Services = сервис / обслуживание  
der Single — Singles = одиночка / сингл  
das Stück — Stücke = кусок / штука  
das Telefon — Telefone = телефон  
die Veranstaltung — Veranstaltungen = мероприятие  
der Verkehr = движение / транспорт  
der Vorteil — Vorteile = преимущество  
die Werkstatt — Werkstätten = мастерская  
die Wohnung — Wohnungen = квартира  
das Wörterbuch — Wörterbücher = словарь  
der Zweifel — Zweifel = сомнение  
abholen — holt ab — abgeholt = забирать  
dagegen = против этого  
darin = в этом / внутри  
entspannen — entspannt = расслабляться  
entstehen — ist entstanden — entstand = возникать  
etwa = примерно  
folgen — ist gefolgt = следовать  
formell = формальный  
froh = радостный  
fällen — gefällt = валить (дерево)  
führen — geführt = вести / руководить  
gar = вовсе / даже  
gering — geringer — am geringsten = небольшой / низкий  
grau = серый  
hängen — gehangen — hing = висеть  
kochen — gekocht = готовить (еду)  
konzentrieren — konzentriert = концентрировать  
laufen — läuft — ist gelaufen — lief = бегать / идти  
leider = к сожалению  
lieb = милый / дорогой  
maskulin = мужской  
nachdem = после того как  
nachdenken — denkt nach — nachgedacht — dachte nach = размышлять  
nämlich = а именно  
plötzlich = внезапно  
schließlich = в конце концов  
der Sprachbaustein — Sprachbausteine = языковой элемент  
ständig = постоянно  
tatsächlich = действительно  
toll = классный / большой  
verwenden — verwendet = использовать  
vier = четыре  
wann = когда  
weder = ни  
wohin = куда  
zwar = хотя / правда  
ärgern — geärgert = раздражать / сердиться  
übrigens = кстати  
das Adverb — Adverbien = наречие  
der Arbeitnehmer — Arbeitnehmer = работник  
der Arm — Arme = рука  
der Arzt — Ärzte = врач  
der Aspekt — Aspekte = аспект  
die Autobahn — Autobahnen = автобан  
der Bauer — Bauern = крестьянин / фермер  
der Begriff — Begriffe = понятие  
die Behinderung — Behinderungen = инвалидность / препятствие  
der Bekannte — Bekannten = знакомый  
der Besuch — Besuche = визит  
das Büro — Büros = офис  
die Dame — Damen = дама / женщина  
der Dank = благодарность  
der Deutschkurs — Deutschkurse = курс немецкого языка  
der Dialekt — Dialekte = диалект  
das Ding — Dinge = вещь  
das Eis — Eise = лёд / мороженое  
die Freude — Freuden = радость  
der Geburtstag — Geburtstage = день рождения  
die Gegenwart = настоящее (время)  
das Gerät — Geräte = устройство  
das Gespräch — Gespräche = разговор  
die Grafik — Grafiken = графика  
die Hausaufgabe — Hausaufgaben = домашнее задание  
die Indirekte — Indirekten = косвенный  
die Kartoffel — Kartoffeln = картофель  
der Kollege — Kollegen = коллега  
der Kontext — Kontexte = контекст  
der Kopfschmerz — Kopfschmerzen = головная боль  
die Kritik — Kritiken = критика  
der Liebesfilm — Liebesfilme = мелодрама  
maskulin = мужской  
die Meldung — Meldungen = сообщение  
die Modalwörter = модальные слова  
der Montag — Montage = понедельник  
der Morgen — Morgen = утро  
der Nebensatz — Nebensätze = придаточное предложение  
das Paket — Pakete = посылка  
der Patient — Patienten = пациент  
das Programm — Programme = программа  
die Reise — Reisen = путешествие  
der Rhein = Рейн (река)  
die Schlange — Schlangen = змея / очередь  
die Schokolade — Schokoladen = шоколад  
der Stau — Staus = пробка (дорожная)  
die Tabelle — Tabellen = таблица  
der Test — Tests = тест  
die Textstelle — Textstellen = место в тексте  
der Tisch — Tische = стол  
die Tochter — Töchter = дочь  
die Umfrage — Umfragen = опрос  
der Umlaut — Umlaute = умляут (знак над гласными)  
das Unternehmen — Unternehmen = предприятие  
die Verbindung — Verbindungen = связь  
der Verlust — Verluste = потеря  
das Warenhaus — Warenhäuser = универмаг  
die Warnung — Warnungen = предупреждение  
der Wunsch — Wünsche = желание  
der Zug — Züge = поезд  
allein = один / одиноко  
außerdem = кроме того  
begeistern — begeistert = восхищать  
beherrschen — beherrscht = владеть  
berichten — berichtet — berichtete = сообщать  
berücksichtigen — berücksichtigt = учитывать  
bevor = прежде чем  
bezahlen — bezahlt = платить  
christlich = христианский  
danken — gedankt = благодарить  
davor = до этого  
deutlich = ясно / отчётливо  
dritter = третий  
drücken — gedrückt = нажимать / прижимать  
durchführen — führt durch — durchgeführt = проводить  
eher = скорее / раньше  
erfahren — erfährt — erfahren — erfuhr = узнавать / испытывать  
ergeben — ergibt — ergeben — ergab = давать (результат)  
erklären — erklärt = объяснять  
erwarten — erwartet = ожидать  
fertig = готовый  
freundlich = дружелюбный  
geehrt = уважаемый  
halb = половина  
interessieren sich für { Akkusativ } — interessiert = интересоваться  
kaputt = сломанный  
kosten — gekostet = стоить  
kulturell = культурный  
leiden — gelitten — litt = страдать  
meistens = чаще всего  
morgens = утром  
paar = пара  
planen — geplant = планировать  
reden — geredet = говорить  
reich — reicher — am reichsten = богатый  
reisen — gereist = путешествовать  
rot = красный  
scheinen — geschienen — schien = казаться / светить  
schenken — geschenkt = дарить  
schlafen — schläft — geschlafen — schlief = спать  
singen — gesungen — sang = петь  
spazieren — spaziert = гулять  
stark — stärker — am stärksten = сильный  
stolz = гордый  
teuer — teurer — am teuersten = дорогой  
typisch = типичный  
unbedingt = обязательно  
unterrichten — unterrichtet = преподавать  
unterstrichen = подчёркнутый  
versprechen — verspricht — versprochen — versprach = обещать  
vorbei = мимо / законченный  
warm — wärmer — am wärmsten = тёплый  
weißen = белый  
wen = кого  
wünschen — gewünscht = желать  
übrig = оставшийся  
das Aktiv — Aktive = активный залог  
das Amt — Ämter = ведомство / должность  
die App — Apps = приложение  
der Arbeitgeber — Arbeitgeber = работодатель  
der Architekt — Architekten = архитектор  
die Armut = бедность  
die Art — Arten = вид / тип  
die Auffassung — Auffassungen = мнение / понимание  
die Auskunft — Auskünfte = справка / информация  
das Ausland — Ausländer = заграница  
das Baby — Babys = младенец  
der Ball — Bälle = мяч  
die Bank — Bänke = банк / скамейка  
der Beginn — Beginne = начало  
die Beispielprüfung — Beispielprüfungen = примерный экзамен  
der Besucher — Besucher = посетитель  
die Bevölkerung — Bevölkerungen = население  
der Brief — Briefe = письмо  
die Chemie — Chemien = химия  
der Club — Clubs = клуб  
die Diät — Diäten = диета  
der Einsteiger — Einsteiger = новичок  
der Elefant — Elefanten = слон  
das Ergebnis — Ergebnisse = результат  
das Erlebnis — Erlebnisse = переживание  
die Erziehung — Erziehungen = воспитание  
das Fahrzeug — Fahrzeuge = транспортное средство  
das Fleisch — Fleischer = мясо  
die Folge — Folgen = следствие / эпизод  
die Freizeit — Freizeiten = свободное время  
die Fußprobleme = проблемы с ногами  
das Gemüse — Gemüse = овощи  
der Geschmack — Geschmäcker = вкус  
die Gitarre — Gitarren = гитара  
das Glück = счастье  
das Griechisch = греческий язык  
das Gymnasium — Gymnasien = гимназия  
die Hand — Hände = рука  
die Handlung — Handlungen = действие / сюжет  
das Handy — Handys = мобильный телефон  
die Hauptsätze = главные предложения  
das Heimatland — Heimatländer = родина  
die Heirat — Heiraten = свадьба / женитьба  
das Herz — Herzen = сердце  
die Hose — Hosen = брюки  
die Impfung — Impfungen = прививка  
das Indien = Индия  
die Insel — Inseln = остров  
die Intuition — Intuitionen = интуиция  
das Italien = Италия  
die Jahreszeit — Jahreszeiten = время года  
das Jahrhundert — Jahrhunderte = век  
das Kasussymbol — Kasussymbole = символ падежа  
die Kindergärten = детские сады  
die Konjunktur — Konjunkturen = конъюнктура  
das Konzert — Konzerte = концерт  
der Kopf — Köpfe = голова  
das Korrelat — Korrelate = коррелят  
die Krankheit — Krankheiten = болезнь  
das Köln = Кёльн  
das Können = умение  
der Liebeskummer = любовная тоска  
die Luft — Lüfte = воздух  
die Lust — Lüste = желание / удовольствие  
der Mai = май  
die Maschine — Maschinen = машина  
der Meter — Meter = метр  
der Mitarbeiter — Mitarbeiter = сотрудник  
die Mutter — Mütter = мать  
die Nacht — Nächte = ночь  
das Nomen — Nomen = существительное  
die Not — Nöte = нужда  
die Note — Noten = оценка / нота  
die Notiz — Notizen = заметка  
der Nullartikel — Nullartikel = нулевой артикль  
die Ortsangabe — Ortsangaben = указание места  
das Parlament — Parlamente = парламент  
die Partnerin — Partnerinnen = партнёрша  
die Pause — Pausen = пауза  
der Plan — Pläne = план  
der Platz — Plätze = место  
der Punkt — Punkte = точка  
die Redemittel = средства выражения  
die Regenbogenpresse = жёлтая пресса  
die Richtung — Richtungen = направление  
die Schuhe = обувь  
der Schweizer — Schweizer = швейцарец  
die Schwester — Schwestern = сестра  
der See — Seen = озеро  
die Sehenswürdigkeit — Sehenswürdigkeiten = достопримечательность  
das Sein = бытие  
der Sommer — Sommer = лето  
der Sonntag — Sonntage = воскресенье  
das Spiel — Spiele = игра  
der Stadtpark — Stadtparks = городской парк  
die Stimme — Stimmen = голос  
die Suche — Suchen = поиск  
die Tastatur — Tastaturen = клавиатура  
die Tollwut = бешенство  
der Unsinn — Unsinnigkeiten = чепуха  
der Unterricht — Unterrichte = урок / преподавание  
die Vermutung — Vermutungen = предположение  
das Verständnis — Verständnisse = понимание  
das Wasser — Wasser = вода  
der Winter — Winter = зима  
die Wirtschaft — Wirtschaften = экономика  
der Zustand — Zustände = состояние  
abhalten — hält ab — abgehalten — hielt ab = проводить / удерживать  
ach = ах  
anfangen — fängt an — angefangen — fing an = начинать  
angenehm = приятный  
ankommen — kommt an — ist angekommen — kam an = прибывать  
anlässlich { Genitiv } = по случаю  
anrufen — ruft an — angerufen — rief an = звонить  
ansehen — sieht an — angesehen — sah an = смотреть / рассматривать  
antworten — geantwortet = отвечать  
aufgrund { Genitiv } = на основании  
ausbilden — bildet aus — ausgebildet = обучать  
aussehen — sieht aus — ausgesehen — sah aus = выглядеть  
bedanken — bedankt = благодарить  
beenden — beendet = заканчивать  
bereit = готовый  
beschweren — beschwert = жаловаться  
bestätigen — bestätigt = подтверждать  
beteiligen — beteiligt = участвовать  
bewegen — bewegt = двигать / трогать  
bewusst = сознательный  
bezüglich { Genitiv } = относительно  
danach = после этого  
desto = тем более  
deswegen = поэтому  
deutsche = немецкий  
direkt = прямо / непосредственно  
drehen — gedreht = вращать  
enthalten — enthält — enthalten — enthielt = содержать  
entlang { Genitiv } = вдоль  
enttäuschen — enttäuscht = разочаровывать  
erledigen — erledigt = выполнять / завершать  
erreichen — erreicht = достигать  
erzielen — erzielt = достигать / получать  
europäisch = европейский  
fehlend = отсутствующий  
feiern — gefeiert = праздновать  
fordern — gefordert = требовать  
französisch = французский  
frisch — frischer — am frischesten = свежий  
fähig = способный  
fünf = пять  
gerne = с удовольствием
gültig = действительный  
günstig — günstiger — am günstigsten = выгодный / дешёвый  
halt = ну / ведь  
heiraten — geheiratet = жениться / выходить замуж  
insgesamt = в общей сложности  
international = международный  
jugendliche = юношеский / подростковый  
klingeln — geklingelt = звонить (о звонке)  
kostenlos = бесплатный  
kümmern — gekümmert = заботиться  
langweilen — gelangweilt = скучать / надоедать  
leicht — leichter — am leichtesten = лёгкий  
lenken — gelenkt = направлять / управлять  
los = прочь / началось  
mindestens = по крайней мере  
mitteilen — teilt mit — mitgeteilt — teilte mit = сообщать  
neugierig = любопытный  
nun = теперь  
pünktlich = пунктуальный  
reagieren — reagiert = реагировать  
renovieren — renoviert = ремонтировать (обновлять)  
sauer = кислый / сердитый  
schaffen — geschafft = справляться / создавать  
schmecken — geschmeckt = иметь вкус  
schreien — geschrien — schrie = кричать  
schriftlich = письменный  
seitdem = с тех пор  
selten = редкий  
sowohl = как ... так и  
sperren — gesperrt = запирать / блокировать  
stattfinden — findet statt — stattgefunden — fand statt = происходить  
treten — tritt — getreten — trat = наступать / пинать  
träumen — geträumt = мечтать / видеть сон  
täglich = ежедневный  
unbekannt = неизвестный  
verkaufen — verkauft = продавать  
verlieben sich — verliebt = влюбляться  
vermutlich = предположительно  
versuchen — versucht = пытаться  
verweisen — verwiesen — verwies = ссылаться / указывать  
verzichten — verzichtet = отказываться  
verändern — verändert = изменять  
viele = многие  
vorgegeben = заданный  
wider { Akkusativ } = против  
wofür = для чего  
wütend = сердитый  
zustimmen — stimmt zu — zugestimmt = соглашаться  
die Überraschung — Überraschungen = сюрприз  
das Übungsbuch — Übungsbücher = учебник с упражнениями  
ähnlich = похожий  
überlegen — überlegt = обдумывать  
überreichen — reicht über — überreicht = вручать  
der Actionfilm — Actionfilme = боевик  
die Adverbien = наречия  
das Afrika = Африка  
die Ampel — Ampeln = светофор  
der Arbeitstag — Arbeitstage = рабочий день  
die Aufforderung — Aufforderungen = требование / призыв  
der Ausflug — Ausflüge = экскурсия  
der Autor — Autoren = автор  
die Bahnhofstraße — Bahnhofstraßen = вокзальная улица  
der Baum — Bäume = дерево  
der Bayer — Bayer = баварец  
der Belang — Belange = интерес / значение  
der Bereich — Bereiche = область  
der Berufsverkehr = час пик  
die Beschreibung — Beschreibungen = описание  
der Betreff — Betreffe = тема (письма)  
der Bezug — Bezüge = связь / отношение  
die Bilder = картинки  
das Bioprodukt — Bioprodukte = биопродукт  
die Bitte — Bitten = просьба  
der Blumenstrauß — Blumensträuße = букет цветов  
der Blödsinn = чушь  
der Bus — Busse = автобус  
der Cent — Cents = цент  
das Computerspiel — Computerspiele = компьютерная игра  
die Datei — Dateien = файл  
das Datum — Daten = дата  
der Deckel — Deckel = крышка  
der Dialog — Dialoge = диалог  
die Diskussion — Diskussionen = дискуссия  
der Druck — Drücke = давление / печать  
die Ehe — Ehen = брак  
das Ei — Eier = яйцо  
die Einladung — Einladungen = приглашение  
die Einzelheit — Einzelheiten = деталь  
das Englisch = английский язык  
die Entspannung — Entspannungen = расслабление  
das Erbe — Erben = наследство  
die Erklärung — Erklärungen = объяснение  
der Ernst = серьёзность
der Experte — Experten = эксперт  
das Extra — Extras = дополнительно / экстра  
feminin = женский  
das Ferienziel — Ferienziele = место отдыха  
der Flohmarkt — Flohmärkte = блошиный рынок  
die Forderung — Forderungen = требование  
das Foto — Fotos = фотография  
das Frankfurt = Франкфурт  
das Freizeitverhalten — Freizeitverhalten = поведение в свободное время  
der Frieden — Frieden = мир  
der Frühling — Frühlinge = весна  
die Fähigkeit — Fähigkeiten = способность  
das Gas — Gase = газ  
die Gefahr — Gefahren = опасность  
das Gehalt — Gehälter = зарплата / содержание  
das Geräusch — Geräusche = шум  
das Geschirr — Geschirre = посуда  
das Geschäft — Geschäfte = магазин / дело  
das Getränk — Getränke = напиток  
das Google = Гугл  
die Grundschule — Grundschulen = начальная школа  
die Gruppe — Gruppen = группа  
die Hauptaussage — Hauptaussagen = основное утверждение  
die Hochzeit — Hochzeiten = свадьба  
die Hotline — Hotlines = горячая линия  
der Inhalt — Inhalte = содержание  
die Institution — Institutionen = учреждение  
das Italienisch = итальянский язык  
jemand = кто-то  
der Junge — Jungen = мальчик / юноша  
der Juniorchef — Juniorchefs = младший руководитель  
der Kindergarten — Kindergärten = детский сад  
das Kleid — Kleider = платье  
das Kleinkind — Kleinkinder = малыш  
die Kleinstadt — Kleinstädte = небольшой город  
die Komposita = составные слова  
die Konjunktion — Konjunktionen = союз  
der Kontakt — Kontakte = контакт  
die Krise — Krisen = кризис  
der Käse — Käse = сыр  
der Körper — Körper = тело  
der Künstler — Künstler = художник / артист  
der Laden — Läden = магазин  
die Laune — Launen = настроение  
die Leistung — Leistungen = достижение / мощность  
der Lernerfolg — Lernerfolge = успех в обучении  
das Licht — Lichter = свет  
das Lied — Lieder = песня  
mal = раз  
die Medizin — Medizinen = медицина  
der Meinungsmacher — Meinungsmacher = формирующий мнение  
der Meister — Meister = мастер  
das Milchprodukt — Milchprodukte = молочный продукт  
das Mitglied — Mitglieder = член  
das Mittel — Mittel = средство / середина  
der Mittwoch — Mittwoche = среда  
das Modalwort — Modalwörter = модальное слово  
der Moment — Momente = момент  
das Motiv — Motive = мотив  
der Mut = смелость  
das Mädchen — Mädchen = девочка  
das Nachtleben — Nachtleben = ночная жизнь  
der Nobelpreis — Nobelpreise = Нобелевская премия  
die Oma — Omas = бабушка  
der Pfeffer — Pfeffer = перец  
please = пожалуйста  
die Politik — Politiken = политика  
der Polizist — Polizisten = полицейский  
das Polnisch = польский язык  
der Postman — Postmen = почтальон  
das Prinzip — Prinzipien = принцип  
das Pronomen — Pronomen = местоимение  
das Präsens — Präsen = настоящее время  
die Präsentation — Präsentationen = презентация  
der Prüfer — Prüfer = экзаменатор  
der Prüfungspartner — Prüfungspartner = партнёр по экзамену  
die Prüfungsteile = части экзамена  
das Radio — Radios = радио  
der Ratschlag — Ratschläge = совет  
der Raum — Räume = комната / пространство  
die Reaktion — Reaktionen = реакция  
das Regal — Regale = полка  
die Relativpronomen = относительные местоимения  
die Reparatur — Reparaturen = ремонт  
der Ring — Ringe = кольцо  
der Rollstuhl — Rollstühle = инвалидная коляска  
die Räder = колёса  
der Schaden — Schäden = ущерб  
der Schneider — Schneider = портной  
die Schuld — Schulden = вина / долг  
die Schwierigkeit — Schwierigkeiten = трудность  
der Schal — шарф
der Silvesterabend — Silvesterabende = канун Нового года  
das Sportereignis — Sportereignisse = спортивное событие  
das Sprichwort — Sprichwörter = пословица  
die Strecke — Strecken = участок / расстояние  
der Stress — Stresse = стресс  
die Subjunktion — Subjunktionen = подчинительный союз  
das Synonym — Synonyme = синоним  
der Süden = юг  
die Tat — Taten = поступок  
die Teilinformationen = частичная информация  
das Ticket — Tickets = билет  
das Training — Trainings = тренировка  
der Traum — Träume = мечта / сон  
der Turm — Türme = башня  
die Tätigkeit — Tätigkeiten = деятельность  
die Türkei = Турция  
die Umgebung — Umgebungen = окружение  
der Umzug — Umzüge = переезд  
der Unbestimmte — Unbestimmten = неопределённый  
die Unterstützung — Unterstützungen = поддержка  
die Verantwortung — Verantwortungen = ответственность  
der Verbrauch — Verbräuche = потребление  
der Verbraucher — Verbraucher = потребитель  
die Verfügung — Verfügungen = распоряжение  
der Vergleich — Vergleiche = сравнение  
die Veränderung — Veränderungen = изменение  
der Vogel — Vögel = птица  
die Vorwahlnummer — Vorwahlnummern = код номера  
der Wagen — Wagen = вагон / машина  
die Wahrscheinlichkeit — Wahrscheinlichkeiten = вероятность  
die Wand — Wände = стена  
warum = почему  
der Weg — Wege = путь  
das Weihnachten = Рождество  
der Weihnachtsmarkt — Weihnachtsmärkte = рождественский рынок  
das Wiesbaden = Висбаден  
der Wille — Willen = воля  
woran = на чём  
die Wortart — Wortarten = часть речи  
die Wörter = слова  
der Zeitungsartikel — Zeitungsartikel = газетная статья  
der Zuschauer — Zuschauer = зритель  
das Zürich = Цюрих  
abends = вечером  
abhängig = зависимый  
das Adjektiv — Adjektive = прилагательное  
alleine = один / одиноко  
anfertigen — fertigt an — angefertigt = изготавливать  
angesichts { Genitiv } = ввиду  
der Angestellte — Angestellten = служащий  
anhören — hört an — angehört = слушать  
anscheinend = по-видимому  
anstatt { Genitiv } = вместо  
ausreichend = достаточный  
auswählen — wählt aus — ausgewählt = выбирать  
beantworten — beantwortet = отвечать  
bedienen — bedient = обслуживать  
bedingt = обусловленный  
befinden — befunden — befand = находиться  
benachbart = соседний  
berechnen — berechnet = вычислять  
berühmt = знаменитый  
betragen — beträgt — betragen — betrag = составлять (сумму)  
bewerben — bewirbt — beworben — bewarb = подавать заявку  
bezeichnen — bezeichnet = обозначать  
bislang = до сих пор  
buchen — gebucht = бронировать  
böse = злой  
dadurch = этим / через это  
dahin = туда  
damals = тогда  
daraus = из этого  
darum = поэтому / вокруг этого  
deklinieren — dekliniert = склонять  
demgegenüber = напротив этого  
dick — dicker — am dicksten = толстый  
diskutieren — diskutiert = обсуждать  
dorthin = туда  
dunkel — dunkler — am dunkelsten = тёмный  
ebenfalls = также  
eingreifen — greift ein — eingegriffen — griff ein = вмешиваться  
einhalten — hält ein — eingehalten — hielt ein = соблюдать  
einheitlich = единообразный  
einladen — lädt ein — eingeladen — lud ein = приглашать  
einreichen — reicht ein — eingereicht = подавать (документы)  
einschränken — schränkt ein — eingeschränkt = ограничивать  
emotional = эмоциональный  
empfehlen — empfiehlt — empfohlen — empfahl = рекомендовать  
entgegen = навстречу / против  
entschließen — entschlossen — schloss = решаться  
entweder = либо  
erblich = наследственный  
erholen — erholt = отдыхать  
erstellen — erstellt = создавать  
der Erwachsene — Erwachsenen = взрослый  
eröffnen — eröffnet = открывать  
euch = вас  
falls = если  
fast = почти  
fertigen — gefertigt = изготавливать  
finanzieren — finanziert = финансировать  
formulieren — formuliert = формулировать  
fünfter = пятый  
garantieren — garantiert = гарантировать  
gelingen — ist gelungen — gelang = удаваться  
genannt = названный  
genießen — genossen — genoss = наслаждаться  
geraten — gerät — ist geraten — geriet = попадать / советовать  
gespannt = напряжённый / взволнованный  
grübeln — gegrübelt = размышлять / ломать голову  
heiß — heißer — am heißesten = горячий  
heraus = наружу  
herstellen — stellt her — hergestellt = производить  
hinauf = вверх  
hinein = внутрь  
hingegen = напротив  
hinnehmen — nimmt hin — hingenommen — nahm hin = принимать (как факт)  
hinter { Dativ, Akkusativ } = позади  
hoffen — gehofft = надеяться  
humanitär = гуманитарный  
informieren — informiert = информировать  
interessant = интересный  
je = каждый / чем  
jedoch = однако  
jährlich = ежегодный  
kalt — kälter — am kältesten = холодный  
keinesfalls = ни в коем случае  
kirchlich = церковный  
komisch = смешной / странный  
konventionell = традиционный  
leuchten — geleuchtet = светить  
lieber = лучше / милый  
meist = больше всего  
merken — gemerkt = замечать  
modern = современный  
morgen = завтра  
morgendlich = утренний  
möglicherweise = возможно  
na = ну  
nachlesen — liest nach — nachgelesen — las nach = перечитывать / проверять  
notieren — notiert = записывать  
per { Dativ } = через / с помощью  
privat = частный  
prägen — geprägt = формировать / чеканить  
prüfen — geprüft = проверять  
reinigen — gereinigt = чистить  
retten — gerettet = спасать  
rufen — gerufen — rief = звать / кричать  
ruhig — ruhiger — am ruhigsten = спокойный  
schalten — geschaltet = переключать  
scheiden — geschieden — schied = разводиться / отделять  
sicherlich = конечно  
siebziger = семидесятые  
sofort = сразу  
solcher = такой  
sorgen — sorgt — gesorgt = заботиться  
sozial = социальный  
stattdessen = вместо этого  
stockend = прерывистый  
stoppen — gestoppt = останавливать  
streichen — gestrichen — strich = вычёркивать / красить  
streng — strenger — am strengsten = строгий  
stressen — gestresst = напрягать  
super = супер  
surfen — gesurft = серфить  
tatkräftig = энергичный  
teil = часть  
teilnehmen — nimmt teil — teilgenommen — nahm teil = участвовать  
tief — tiefer — am tiefsten = глубокий  
die Toten = мёртвые  
trennbar = отделимый  
trennen — getrennt = разделять  
trotzdem = несмотря на это  
unterstreichen — unterstrichen — unterstrich = подчёркивать  
unterstützen — unterstützt = поддерживать  
unzufrieden = недовольный  
verantwortlich = ответственный  
verbinden — verbunden — verband = соединять  
verheiraten — verheiratet = женить / выдавать замуж  
verlangen — verlangt = требовать  
verrückt = сумасшедший  
verschieben — verschoben — verschob = сдвигать / откладывать  
vertagen — vertagt = откладывать (заседание)  
vertrauen — vertraut = доверять  
verursachen — verursacht = вызывать  
völlig = полностью  
wachsen — wächst — ist gewachsen — wuchs = расти  
warnen — gewarnt = предупреждать  
weiterhin = далее  
weltbekannt = всемирно известный  
wem = кому  
wild — wilder — am wildesten = дикий  
willst = хочешь  
woher = откуда  
womit = чем  
worüber = о чём  
wunderschön = прекрасный  
zehn = десять  
zunehmen — nimmt zu — zugenommen — nahm zu = увеличиваться  
zuordnen — ordnet zu — zugeordnet = относить / приписывать  
zurzeit = в настоящее время  
zuständig = ответственный / компетентный  
zusätzlich = дополнительный  
zweifeln — gezweifelt = сомневаться  
zweiter = второй  
zählen — gezählt = считать  
das Öl — Öle = масло  
das Österreich = Австрия  
die Übersicht — Übersichten = обзор  
öffnen — geöffnet = открывать  
üben — übt — geübt — übte = практиковать / упражняться  
überleben — überlebt = выживать  
überreden — überredet = уговаривать  
der Abbau — Abbauten = добыча / сокращение  
die Abende = вечера  
der Abfall — Abfälle = мусор  
der Absolvent — Absolventen = выпускник  
die Abteilung — Abteilungen = отдел  
die Achtung — Achtungen = внимание  
die Adresse — Adressen = адрес  
das Akkusativsymbol — Akkusativsymbole = символ винительного падежа  
die Aktivität — Aktivitäten = активность  
die Altsprache — Altsprachen = древний язык  
der Anbieter — Anbieter = поставщик  
der Andrang — Andränge = наплыв  
der Anfänger — Anfänger = начинающий  
der Anhang — Anhänge = приложение  
die Ansage — Ansagen = объявление  
die Anschaffung — Anschaffungen = приобретение  
der Ansprechpartner — Ansprechpartner = контактное лицо  
die Anweisung — Anweisungen = инструкция  
das Aquajogging = акваджоггинг  
der Arbeitsalltag — Arbeitsalltage = рабочие будни  
der Arbeitsplatz — Arbeitsplätze = рабочее место  
das Asien = Азия  
die Atmung — Atmungen = дыхание  
das Audio — Audios = аудио  
der Aufbau — Aufbauten = структура / строительство  
der Aufenthalt — Aufenthalte = пребывание  
das Aufgabenblatt — Aufgabenblätter = лист с заданиями  
der Aufräumtag — Aufräumtage = день уборки  
der Auftrag — Aufträge = заказ  
das Auge — Augen = глаз  
die Ausrüstung — Ausrüstungen = оборудование  
die Ausstellung — Ausstellungen = выставка  
der Bahnhof — Bahnhöfe = вокзал  
die Bahnstrecke — Bahnstrecken = железнодорожная линия  
der Bauch — Bäuche = живот  
die Baustelle — Baustellen = стройка  
die Bedingung — Bedingungen = условие  
die Bedrohung — Bedrohungen = угроза  
die Begegnung — Begegnungen = встреча  
der Bericht — Berichte = отчёт  
der Berliner — Berliner = берлинец  
die Berufsausbildung — Berufsausbildungen = профессиональное обучение  
die Beschreibung — Beschreibungen = описание  
die Betonung — Betonungen = ударение  
der Betrieb — Betriebe = предприятие / эксплуатация  
der Beweis — Beweise = доказательство  
die Bewerbung — Bewerbungen = заявка / резюме  
die Biokost = биопродукты  
die Biolade — Bioladen = биомагазин  
die Blume — Blumen = цветок  
das Brasilien = Бразилия  
der Brenner — Brenner = горелка
das Brot — Brote = хлеб  
der Buddhist — Buddhisten = буддист  
das Budget — Budgets = бюджет  
das Bundesland — Bundesländer = федеральная земля  
die Bundesrepublik — Bundesrepubliken = федеральная республика  
die Bundesstraße — Bundesstraßen = федеральная дорога  
die Bushaltestelle — Bushaltestellen = автобусная остановка  
die Bühne — Bühnen = сцена  
der Bürger — Bürger = гражданин  
die Bürgerin — Bürgerinnen = гражданка  
die Bürgerinitiative — Bürgerinitiativen = гражданская инициатива  
die Charaktereigenschaft — Charaktereigenschaften = черта характера  
der Chauffeur — Chauffeure = шофёр  
die Choice — Choices = выбор  
der Code — Codes = код  
der Computerkurs — Computerkurse = компьютерный курс  
das Computerprogramm — Computerprogramme = компьютерная программа  
die Delikatesse — Delikatessen = деликатес  
das Detail — Details = деталь  
der Diener — Diener = слуга  
die Dienstleistung — Dienstleistungen = услуга  
die Dolmetscherin — Dolmetscherinnen = переводчица  
der Draht — Drähte = проволока  
das Ehepaar — Ehepaare = супружеская пара  
das Eichhörnchen — Eichhörnchen = белка  
der Eindruck — Eindrücke = впечатление  
die Eingebung — Eingebungen = озарение  
die Einigung — Einigungen = объединение
die Einlage — Einlagen = вклад / стелька  
die Einleitung — Einleitungen = введение  
der Empfänger — Empfänger = получатель  
die Endposition — Endpositionen = конечная позиция  
das Engagement — Engagements = участие / приверженность  
das England = Англия  
der Enthusiasmus — Enthusiasmen = энтузиазм  
der Entschluss — Entschlüsse = решение  
die Entschuldigung — Entschuldigungen = извинение  
die Entspannung — Entspannungen = расслабление  
die Enttäuschung — Enttäuschungen = разочарование  
das Ereignis — Ereignisse = событие  
der Erfahrungsbericht — Erfahrungsberichte = отчёт об опыте  
das Erfahrungsgedächtnis — Erfahrungsgedächtnisse = память опыта  
die Ernte — Ernten = урожай  
das Experiment — Experimente = эксперимент  
die Explosion — Explosionen = взрыв  
der Fachkräftemangel — Fachkräftemängel = нехватка специалистов  
die Fachsprache — Fachsprachen = профессиональный язык  
die Fahrkarte — Fahrkarten = билет на транспорт  
die Fahrprüfung — Fahrprüfungen = экзамен по вождению  
der Fahrradstand — Fahrradstände = велостоянка  
die Fahrt — Fahrten = поездка  
das Fasching — Faschinge = карнавал  
die Faulheit — Faulheiten = лень  
das Feld — Felder = поле  
das Fett — Fette = жир  
die Feuerwehr — Feuerwehren = пожарная служба  
der Filter — Filter = фильтр  
der Fisch — Fische = рыба  
die Fitness = фитнес  
das Fitnessstudio — Fitnessstudios = фитнес-студия  
die Fledermaus — Fledermäuse = летучая мышь  
die Fledermäuse = летучие мыши  
der Flug — Flüge = полёт  
folgend = следующий  
das Fragewort — Fragewörter = вопросительное слово  
der Frankfurter — Frankfurter = франкфуртец  
das Frankreich = Франция  
der Freitag — Freitage = пятница  
der Freizeittrend — Freizeittrends = тренд свободного времени  
die Fremdsprache — Fremdsprachen = иностранный язык  
der Friede — Frieden = мир  
das Futur — Future = будущее (время)  
der Fußball — Fußbälle = футбол  
die Fünfzehnjährige — Fünfzehnjährigen = пятнадцатилетняя  
die Fürstin — Fürstinnen = княгиня  
der Gatte — Gatten = супруг  
das Gebiet — Gebiete = область  
der Gebrauch — Gebräuche = использование / обычай  
das Gebäude — Gebäude = здание  
die Gebührenerhöhung — Gebührenerhöhungen = повышение сборов  
die Geduld = терпение  
der Gegensatz — Gegensätze = противоположность  
die Gehirnströme = мозговые волны  
der Geist — Geister = дух  
das Gelenk — Gelenke = сустав  
die Gemeinde — Gemeinden = община  
der Genuss — Genüsse = наслаждение  
der Geruch — Gerüche = запах  
die Geschäftsreise — Geschäftsreisen = деловая поездка  
die Gesundheit = здоровье  
das Gesundheitsprogramm — Gesundheitsprogramme = программа здоровья  
der Gesundheitszustand — Gesundheitszustände = состояние здоровья  
das Gift — Gifte = яд  
der Glaube — Glauben = вера  
die Goethestraße — Goethestraßen = улица Гёте  
der Grad — Grade = градус / степень  
das Grammatikkapitel — Grammatikkapitel = глава по грамматике  
die Grenze — Grenzen = граница  
das Griechenland = Греция  
die Großeltern = бабушка и дедушка  
die Grundregel — Grundregeln = основное правило  
die Grundstufe — Grundstufen = начальный уровень  
die Größe — Größen = размер  
das Halbjahr — Halbjahre = полугодие  
die Halle — Hallen = зал  
das Halloween = Хэллоуин  
der Handel — Handels = торговля  
die Hauptaussage — Hauptaussagen = основное утверждение  
der Hausbewohner — Hausbewohner = житель дома  
die Haushaltspflicht — Haushaltspflichten = домашняя обязанность  
die Heimat — Heimaten = родина  
die Heizung — Heizungen = отопление  
die Helenenstraße — Helenenstraßen = улица Хеленен  
her = сюда  
der Herbst — Herbste = осень  
das Hindernis — Hindernisse = препятствие  
die Hindus = индусы  
der Hit — Hits = хит  
der Hoax — Hoaxes = обман / мистификация  
das Hobby — Hobbys = хобби  
der Hof — Höfe = двор  
die Hosenträger = подтяжки  
der Händler — Händler = торговец  
die Höflichkeit — Höflichkeiten = вежливость  
der Hörtext — Hörtexte = аудиотекст  
der Impuls — Impulse = импульс  
das Indefinitpronomen — Indefinitpronomen = неопределённое местоимение  
der Insasse — Insassen = обитатель / пассажир  
die Integration — Integrationen = интеграция  
interessant = интересный  
das Interphon — Interphone = интерфон  
das Interview — Interviews = интервью  
das Izmir = Измир  
der Jeck — Jecken = шут / карнавальный персонаж  
der Jude — Juden = еврей  
das Kamel — Kamele = верблюд  
der Karfreitag — Karfreitage = Страстная пятница  
der Kasus — Kasus = падеж  
der Keller — Keller = подвал  
der Kerl — Kerle = парень  
die Kerze — Kerzen = свеча  
der Kilometer — Kilometer = километр  
der Kirchenkritiker — Kirchenkritiker = критик церкви  
die Klammer — Klammern = скобка  
das Klavier — Klaviere = пианино  
klein — kleiner — am kleinsten = маленький  
das Kleintier — Kleintiere = мелкое животное  
der Knopf — Knöpfe = кнопка  
das Koblenz = Кобленц  
das Koma — Komas = кома  
der Konditionalsatz — Konditionalsätze = условное предложение  
der Konditor — Konditoren = кондитер  
der Konflikt — Konflikte = конфликт  
der Konkurrent — Konkurrenten = конкурент  
der Konsum — Konsume = потребление  
die Kontrolle — Kontrollen = контроль  
das Konzept — Konzepte = концепция  
der Konzern — Konzerne = концерн  
die Kostenerstattung — Kostenerstattungen = возмещение затрат  
das Kostüm — Kostüme = костюм  
der Kreis — Kreise = круг / район  
der Kreislauf — Kreisläufe = круговорот  
das Krokodil — Krokodile = крокодил  
die Kulanzregelung — Kulanzregelungen = правило доброй воли  
der Kummer — Kummer = горе / печаль  
die Kundennummer — Kundennummern = номер клиента  
der König — Könige = король  
die Körnerfresserei = поедание зёрен  
die Kündigung — Kündigungen = увольнение / расторжение  
die Lage — Lagen = положение / местоположение  
die Landstraße — Landstraßen = загородная дорога  
das Lebensjahr — Lebensjahre = год жизни  
das Lebensmittel — Lebensmittel = продукт питания  
die Lebensumstände = жизненные обстоятельства  
das Leid = страдание  
die Leitung — Leitungen = руководство / провод  
das Liebesnest — Liebesnester = любовное гнёздышко  
die Lohnnebenkosten = дополнительные расходы на зарплату  
der Londoner — Londoner = лондонец  
das Lotto — Lottos = лотерея  
das Luxemburg = Люксембург  
der Lärm — Lärme = шум  
die Lösungsmöglichkeit — Lösungsmöglichkeiten = возможность решения  
der Lückentext — Lückentexte = текст с пропусками  
das Madrid = Мадрид  
der Main = Майн (река)  
der Majoran = майоран  
das Mallorca = Майорка  
der Mantel — Mäntel = пальто  
der Marathon — Marathons = марафон  
die Marine — Marinen = морской флот  
das Material — Materialien = материал  
der Maurer — Maurer = каменщик  
das Meer — Meere = море  
das Meeresufer — Meeresufer = морской берег  
die Menge — Mengen = количество  
die Miete — Mieten = аренда  
der Mieter — Mieter = арендатор  
das Milieu — Milieus = среда  
die Milliarde — Milliarden = миллиард  
die Mitarbeiterin — Mitarbeiterinnen = сотрудница  
das Mittagessen — Mittagessen = обед  
die Modalpartikel — Modalpartikeln = модальная частица  
die Mode — Moden = мода  
das Museum — Museen = музей  
die Musikveranstaltung — Musikveranstaltungen = музыкальное мероприятие  
die Muskelkraft = мышечная сила  
die Muskulatur — Muskulaturen = мускулатура  
die Mühe — Mühen = усилие  
die Natur — Naturen = природа  
die Nebenwirkung — Nebenwirkungen = побочный эффект  
die Nomen = существительные  
der Nominativ — Nominative = именительный падеж  
der Notruf — Notrufe = экстренный вызов  
das Obst = фрукты  
das Opfer — Opfer = жертва  
die Organisation — Organisationen = организация  
die Orthopädie — Orthopädien = ортопедия  
das Osterfest = Пасхальный праздник  
die Ostereier = пасхальные яйца  
das Ostern = Пасха  
der Parkplatz — Parkplätze = парковочное место  
die Parkplätze = парковочные места  
die Partizipien = причастия  
das Pech = невезение  
die Pension — Pensionen = пансион / пенсия  
das Personal = персонал  
das Pferd — Pferde = лошадь  
die Pflanze — Pflanzen = растение  
das Pflanzenschutzmittel — Pflanzenschutzmittel = средство защиты растений  
die Pflegekraft — Pflegekräfte = медработник по уходу  
die Physik — Physiken = физика  
das Picknick — Picknicks = пикник  
die Pluralendung — Pluralendungen = окончание множественного числа  
der Pole — Polen = поляк  
der Polizeibesuch — Polizeibesuche = визит полиции  
der Poll — Polls = опрос  
der Popstar — Popstars = поп-звезда  
das Postamt — Postämter = почтовое отделение  
die Produktion — Produktionen = производство  
der Professor — Professoren = профессор  
die Prognose — Prognosen = прогноз  
das Projekt — Projekte = проект  
das Präfix — Präfixe = префикс  
die Präzisionsuhr — Präzisionsuhren = точные часы  
die Qualität — Qualitäten = качество  
der Rabatt — Rabatte = скидка  
das Rad — Räder = колесо / велосипед  
das Radiointerview — Radiointerviews = радио-интервью  
der Rasen — Rasen = газон  
das Rathaus — Rathäuser = ратуша  
die Ratschläge = советы  
die Realität — Realitäten = реальность  
die Rechnung — Rechnungen = счёт / расчёт  
die Rechtspartei — Rechtsparteien = правая партия  
die Regierung — Regierungen = правительство  
der Reinfall — Reinfälle = провал  
die Reinigung — Reinigungen = уборка
der Reiseveranstalter — Reiseveranstalter = туроператор  
der Reporter — Reporter = репортёр  
die Rose — Rosen = роза  
die Ruhe — Ruhen = покой  
das Rätoromanisch = ретороманский язык  
das Rätsel — Rätsel = загадка  
der Rückgang — Rückgänge = снижение  
das Saarland = Саарланд  
der Sachverhalt — Sachverhalte = обстоятельство дела  
der Salat — Salate = салат  
der Samstag — Samstage = суббота  
die Sandstrände = песчаные пляжи  
das Satzende — Satzenden = конец предложения  
das Schema — Schemata = схема  
der Schiedsrichter — Schiedsrichter = судья  
das Schlafengehen = отход ко сну  
die Schlagzeile — Schlagzeilen = заголовок  
der Schluss — Schlüsse = вывод / конец  
der Schmerz — Schmerzen = боль  
die Schnittstelle — Schnittstellen = интерфейс  
der Schokoladennikolaus — Schokoladennikoläuse = шоколадный Николаус  
der Schriftliche — Schriftlichen = письменный  
der Schritt — Schritte = шаг  
die Schuhmodelle = модели обуви  
der Schulfreund — Schulfreunde = школьный друг  
die Schulzeit — Schulzeiten = школьное время  
das Schwimmbad — Schwimmbäder = бассейн  
schön — schöner — am schönsten = красивый  
die Schönheit — Schönheiten = красота  
die Sehnsucht — Sehnsüchte = тоска  
das Sekretariat — Sekretariate = секретариат  
die Sekretärin — Sekretärinnen = секретарь
das Seminar — Seminare = семинар  
der Senior — Senioren = пожилой человек  
die Servicezeit — Servicezeiten = время обслуживания  
die Show — Shows = шоу  
die Sicherheit — Sicherheiten = безопасность  
die Sicht — Sichten = вид / обзор  
das Silbenrätsel — Silbenrätsel = слоговая загадка  
der Sitz — Sitze = сиденье  
das Smartphone — Smartphones = смартфон  
die Software — Softwares = программное обеспечение  
der Sohn — Söhne = сын  
der Spam — Spams = спам  
das Spanien = Испания  
der Spaziergänger — Spaziergänger = гуляющий  
der Speicherplatz — Speicherplätze = место для хранения  
der Sperrmüllservice — Sperrmüllservices = служба вывоза крупногабаритного мусора  
die Spinne — Spinnen = паук  
das Sportprogramm — Sportprogramme = спортивная программа  
der Spracherwerb — Spracherwerbe = освоение языка  
die Sprachprüfung — Sprachprüfungen = языковой экзамен  
die Spülmaschine — Spülmaschinen = посудомоечная машина  
das Stadion — Stadien = стадион  
die Stadthalle — Stadthallen = городской зал  
der Stadtrat — Stadträte = городской совет  
der Standesbeamter — Standesbeamte = сотрудник ЗАГСа  
der Start — Starts = старт  
die Steinzeitmenschen = люди каменного века  
der Stellenabbau — Stellenabbauten = сокращение штатов  
der Stoff — Stoffe = материал / ткань  
der Strauß — Sträuße = букет / страус  
die Straßenbahn — Straßenbahnen = трамвай  
der Streik — Streiks = забастовка  
der Streit — Streite = спор  
das Studienfach — Studienfächer = учебный предмет  
der Studierende — Studierenden = студент  
das Studium — Studien = учёба / исследование  
super = супер  
der Superlativ — Superlative = превосходная степень  
die Szene — Szenen = сцена  
die Tante — Tanten = тётя  
der Tarifpartner — Tarifpartner = тарифный партнёр  
die Tarifpartnerschaft — Tarifpartnerschaften = тарифное партнёрство  
die Taxis = такси  
der Techniker — Techniker = техник  
der Teig — Teige = тесто  
die Teigwaren = макаронные изделия  
der Theaterschuhmacher — Theaterschuhmacher = театральный сапожник  
die Theorie — Theorien = теория  
die Tierhaltung — Tierhaltungen = содержание животных  
der Tod — Tode = смерть  
der Trend — Trends = тренд  
die Treppe — Treppen = лестница  
das Trier = Трир  
die Tänze = танцы  
die Türkei = Турция  
die Unterkunft — Unterkünfte = жильё  
der Unterschied — Unterschiede = различие  
die Variante — Varianten = вариант  
die Vegetarierin — Vegetarierinnen = вегетарианка  
der Veranstalter — Veranstalter = организатор  
die Veranstaltungshinweise = информация о мероприятиях  
die Verben = глаголы  
der Verbstamm — Verbsträmme = основа глагола  
die Verfilmung — Verfilmungen = экранизация  
der Verkauf — Verkäufe = продажа  
der Verkäufer — Verkäufer = продавец  
der Verlag — Verlage = издательство  
die Verpflegung — Verpflegungen = питание  
die Versorgung — Versorgungen = обеспечение  
die Verspätung — Verspätungen = опоздание  
die Verständnisbarriere — Verständnisbarrieren = барьер понимания  
der Vertrag — Verträge = договор  
die Volkshochschule — Volkshochschulen = народный университет  
die Vollpension — Vollpensionen = полный пансион  
voraus = вперёд  
die Vorbereitung — Vorbereitungen = подготовка  
das Vorjahr — Vorjahre = предыдущий год  
die Vorsicht = осторожность  
der Vorverkauf — Vorverkäufe = предварительная продажа  
der Wandel — Wandel = изменение  
die Ware — Waren = товар  
die Wechselpräposition — Wechselpräpositionen = переменный предлог  
die Weihnachtszeit — Weihnachtszeiten = рождественское время  
der Wein — Weine = вино  
die Wendung — Wendungen = оборот / поворот  
das Werk — Werke = произведение / завод  
der Wert — Werte = ценность  
das Wesen — Wesen = существо / сущность  
der Wetterbericht — Wetterberichte = прогноз погоды  
wider { Akkusativ } = против  
das Wien = Вена  
die Wirklichkeit — Wirklichkeiten = действительность  
der Wissenschaftler — Wissenschaftler = учёный  
die Wolke — Wolken = облако  
das Wortfeld — Wortfelder = словообразовательное поле  
die Wörterbücher = словари  
das Yoga — Yogas = йога  
die Zahlenangabe — Zahlenangaben = указание числа  
das Zeugnis — Zeugnisse = свидетельство / аттестат  
der Zucker — Zucker = сахар  
die Zusammenfassung — Zusammenfassungen = краткое изложение  
der Zusammenhang — Zusammenhänge = связь  
die Zusatzstoffe = добавки  
der Zweck — Zwecke = цель  
die Zweisprachigkeit — Zweisprachigkeiten = двуязычие  
abbauen — baut ab — abgebaut = разбирать / сокращать  
der Abgeordnete — Abgeordneten = депутат  
ablehnen — lehnt ab — abgelehnt = отклонять  
abnehmen — nimmt ab — abgenommen — nahm ab = снимать / худеть  
abstürzen — stürzt ab — ist abgestürzt = падать / разбиваться  
abwertend = уничижительный  
achten — geachtet = обращать внимание  
die Adjektivendung — Adjektivendungen = окончание прилагательного  
alleinerziehend = одинокий родитель  
altmodisch = старомодный  
anbraten — brät an — angebratan — briet an = обжаривать  
andererseits = с другой стороны  
angeben — gibt an — angegeben — gab an = указывать / хвастаться  
angefertigen — fertigt an — angefertigt = изготавливать  
angepasst = приспособленный  
anhalten — hält an — angehalten — hielt an = останавливать  
anhand { Genitiv } = на основе  
anregen — regt an — angeregt = побуждать / стимулировать  
die Antwort — Antworten = ответ  
anwenden — wendet an — angewendet = применять  
arm — ärmer — am ärmsten = бедный  
aufbauen — baut auf — aufgebaut — baute auf = строить / основывать  
auffallen — fällt auf — ist aufgefallen — fiel auf = бросаться в глаза  
aufgeregt = взволнованный  
aufhören — hört auf — aufgehört = прекращать  
aufnehmen — nimmt auf — aufgenommen — nahm auf = записывать / принимать  
aufpassen — passt auf — aufgepasst = присматривать  
aufregend = волнующий  
aufräumen — räumt auf — aufgeräumt = убирать  
aufwachen — wacht auf — ist aufgewacht = просыпаться  
ausführlich = подробный  
ausgeben — gibt aus — ausgegeben — gab aus = тратить  
aushandeln — handelt aus — ausgehandelt = договариваться  
austauschen — tauscht aus — ausgetauscht = обменивать  
auswendig = наизусть  
auszeichnen — zeichnet aus — ausgezeichnet = отличать / награждать  
außerhalb { Genitiv } = вне  
bedauern — bedauert = сожалеть  
bedürfen — bedarf — bedurft — bedurfte = нуждаться  
beeinflussen — beeinflusst = влиять  
beeinträchtigen — beeinträchtigt = ухудшать  
begeistert = восторженный  
begreifen — begriffen — begriff = понимать  
begründen — begründet = обосновывать  
behalten — behält — behalten — behielt = сохранять  
beilegen — legt bei — beigelegt = прилагать  
bekennen — bekannt — bekannte = признавать  
belaufen — beläuft — belaufen — belief = составлять (сумму)  
beliebt = популярный  
bellen — gebellt = лаять  
bemalt = расписной  
beobachten — beobachtet = наблюдать  
beraten — berät — beraten — beriet = советовать  
bereiten — bereitet = готовить  
bereuen — bereut = сожалеть  
beruflich = профессиональный  
beruhigen — beruhigt = успокаивать  
beschließen — beschlossen — beschloss = решать  
beschreiben — beschrieben — beschrieb = описывать  
beschädigen — beschädigt = повреждать  
beschäftigen — beschäftigt = заниматься  
besichtigen — besichtigt = осматривать  
besonderer = особый  
bestellen — bestellt = заказывать  
bestimmen — bestimmt = определять  
betonen — betont = подчёркивать  
bevorzugen — bevorzugt = предпочитать  
beweisen — beweist — bewiesen — bewies = доказывать  
beziehen — bezieht — bezogen — bezog = относиться / переезжать  
bilingual = двуязычный  
billig — billiger — am billigsten = дешёвый  
bisher = до сих пор  
bisschen = немного  
bissen — beißt — gebissen — biss = кусать  
blau = синий  
brechen — bricht — gebrochen — brach = ломать  
bunt — bunter — am buntesten = яркий / разноцветный  
die CD — CDs = компакт-диск  
der Dank — Danke = благодарность  
dennoch = тем не менее  
dienen — gedient = служить  
die Doppelkonnektoren = двойные соединители  
dramatisch = драматичный  
dreimal = трижды  
durchgegangen = пройденный  
dänisch = датский  
eingeschlafen = заснувший  
einige = некоторые  
einigen — geeinigt = договариваться  
einkaufen — kauft ein — eingekauft = покупать  
einliefern — liefert ein — eingeliefert = доставлять  
einnehmen — nimmt ein — eingenommen — nahm ein = принимать / занимать  
einsetzen — setzt ein — eingesetzt = использовать / вставлять  
einzeln = отдельный  
elektrisch = электрический  
empfangen — empfängt — empfangen — empfing = принимать / встречать  
entdecken — entdeckt = обнаруживать  
entsprechen — entspricht — entsprochen — entsprach = соответствовать  
entsprechend = соответственно  
entwerfen — entwirft — entworfen — entwarf = разрабатывать  
erfinden — erfunden — erfand = изобретать  
erlernen — erlernt — erlernte = изучать  
erläutern — erläutert = пояснять  
erneut = вновь  
ernst — ernster — am ernstesten = серьёзный  
erreichbar = доступный  
erschrocken = испуганный  
ersetzen — ersetzt = заменять  
erteilen — erteilt = давать (разрешение)  
erwachen — ist erwacht = пробуждаться  
erziehen — erzieht — erzogen — erzog = воспитывать  
familiär = семейный  
faul — fauler — am faulsten = ленивый  
fehlen — gefehlt = отсутствовать  
ferner = далее  
fernsehen — fernsieht — ferngesehen — fernsah = смотреть телевизор  
fliehen — ist geflohen — floh = бежать  
französische = французский  
friedlich = мирный  
fundiert = обоснованный  
fügen — gefügt = добавлять  
fünfzehnjährig = пятнадцатилетний  
füttern — gefüttert = кормить  
gefährlich = опасный  
gehörend = принадлежащий  
geistig = духовный / умственный  
gemocht = любимый  
genug = достаточно  
geschehen — geschieht — ist geschehen — geschah = происходить  
gewählt = выбранный  
gratulieren — gratuliert = поздравлять  
grün = зелёный  
gründen — gegründet = основывать  
gründlich = тщательный  
gute = хороший  
hektisch = лихорадочный  
herein = внутрь  
herum = вокруг  
hierbei = при этом  
hinunter = вниз  
hinweg = через  
hinzugeben — gibt hinzu — hinzugegeben — gab hinzu = добавлять  
höflich = вежливый  
ideal = идеальный  
indem = тем, что  
inklusive = включая  
innen = внутри  
irgendwas = что-нибудь  
irgendwo = где-нибудь  
isst = ест  
italienisch = итальянский  
jedenfalls = в любом случае  
jeglicher = любой  
jetzig = нынешний  
kabarettistisch = кабаретный  
kannst = можешь  
kennenlernen — lernt kennen — kennengelernt — lernte kennen = знакомиться  
klappen — geklappt = получаться  
klettern — geklettert = лазать  
klopfen — geklopft = стучать  
km = километр
kommend = приходящий  
komplett = полный  
korrekt = правильный  
krank — kränker — am kränksten = больной  
kriegen — gekriegt = получать  
kritisch = критический  
künstlich = искусственный  
laden — lädt — geladen — lud = загружать / приглашать  
landen — gelandet = приземляться  
laufend = текущий  
lauten — gelautet = звучать  
lecker = вкусный  
lehren — gelehrt = обучать  
leisten — geleistet = выполнять / оказывать  
leiten — geleitet = руководить  
liefern — geliefert = поставлять  
links = слева  
logisch = логичный  
meistern — gemeistert = овладевать  
melden — gemeldet = сообщать  
messen — misst — gemessen — maß = измерять  
mitbringen — bringt mit — mitgebracht — brachte mit = приносить с собой  
miteinander = друг с другом  
mitkommen — kommt mit — ist mitgekommen — kam mit = идти вместе  
mitnehmen — nimmt mit — mitgenommen — nahm mit = брать с собой  
mm = миллиметр
die Musik = музыка  
neben { Dativ } = рядом  
negativ = негативный  
nett = милый
normal = нормальный  
notwendig = необходимый  
nutzen — genutzt = использовать  
nötig = нужный  
offen — offener — am offensten = открытый  
offiziell = официальный  
optimal = оптимальный  
pausenlos = без перерыва  
perfekt = идеальный  
pflanzen — gepflanzt = сажать  
politisch = политический  
positiv = позитивный  
probieren — probiert = пробовать  
die Pronomen = местоимения  
raten — rät — geraten — riet = советовать  
rauben — geraubt = грабить  
rauchen — geraucht = курить  
regelmäßig = регулярный  
regnen — geregnet = идти (о дожде)  
reif — reifer — am reifsten = зрелый  
riechen — gerochen — roch = пахнуть  
rosarot = розовый  
rund — runder — am rundesten = круглый  
räumen — geräumt = убирать  
rühren — gerührt = мешать  
scharf — schärfer — am schärfsten = острый  
schauen — geschaut = смотреть  
scheitern — ist gescheitert = терпеть неудачу  
schief = кривой  
schlagen — schlägt — geschlagen — schlug = бить  
schlimm — schlimmer — am schlimmsten = плохой  
schlittschuhlaufen — läuft Schlittschuh — Schlittschuh gelaufen — lief Schlittschuh = кататься на коньках  
schuld = виноват  
schwimmen — geschwommen — schwamm = плавать  
schwitzen — geschwitzt = потеть  
schätzen — geschätzt = оценивать  
schützen — geschützt = защищать  
sehnen — gesehnt = тосковать  
sinken — ist gesunken — sank = тонуть / опускаться  
sogar = даже  
somit = таким образом  
sommerlich = летний  
sonst = иначе / другой  
spannend = захватывающий  
speichern — gespeichert = сохранять  
spießig = мещанский  
sprachlich = языковой  
sterben — stirbt — ist gestorben — starb = умирать  
stoßen — stößt — gestoßen — stieß = толкать  
streiten — gestritten — stritt = спорить  
städtisch = городской  
subjektiv = субъективный  
tanzen — getanzt = танцевать  
teilweise = частично  
telefonieren — telefoniert = звонить по телефону  
total = полный  
traurig = грустный  
treiben — getrieben — trieb = гнать / заниматься  
töten — getötet = убивать  
türkisch = турецкий  
umfangreich = обширный  
umleiten — leitet um — umgeleitet = перенаправлять  
umsatteln — sattelt um — umgesattelt = переучиваться  
unbestimmt = неопределённый  
ungarisch = венгерский  
unglaublich = невероятный  
unpersönlich = безличный  
unpopulär = непопулярный  
unschätzbar = неоценимый  
unten = внизу  
unterhalten — unterhält — unterhalten — unterhielt = развлекать / беседовать  
unterschiedlich = различный  
unvergesslich = незабываемый  
unüblich = необычный  
verbessern — verbessert = улучшать  
verbrauchen — verbraucht = потреблять  
verbreiten — verbreitet = распространять  
vereinen — vereint = объединять  
verfügen — verfügt = располагать  
vergangen = прошедший  
verhalten — verhält — verhalten — verhielt = вести себя  
verletzen — verletzt = ранить  
vermeiden — vermieden — vermied = избегать  
vermuten — vermutet = предполагать  
verneinen — verneint = отрицать  
vernichten — vernichtet = уничтожать  
versetzen — versetzt = переводить / переносить  
vertreiben — vertrieben — vertrieb = изгонять / продавать  
verärgert = раздражённый  
vollwertig = полноценный  
vorbehalten — behält vor — vorbehalten — behielt vor = сохранять за собой  
vorbereiten — bereitet vor — vorbereitet = подготавливать  
vorher = раньше  
vorlesen — liest vor — vorgelesen — las vor = читать вслух  
wachsend = растущий  
wahr — wahrer — am wahrsten = истинный  
wechseln — gewechselt = менять  
wehren — gewehrt = сопротивляться  
weisen — gewiesen — wies = указывать  
weiterführen — führt weiter — weitergeführt = продолжать  
weiße = белый  
wert — werter — am wertesten = ценный  
wiedergeben — gibt wieder — wiedergegeben — gab wieder = воспроизводить  
wiederholen — wiederholt = повторять  
wirst = станешь  
wozu = зачем  
würzen — gewürzt = приправлять  
wüssten = знали бы  
ziemlich = довольно  
zuhören — hört zu — zugehört = слушать  
zustellen — stellt zu — zugestellt = доставлять  
zweimal = дважды  
zwingen — gezwungen — zwang = заставлять  
die Älteren = пожилые  
die Ölrechnung — Ölrechnungen = счёт за масло  
die Überschriften = заголовки  
äußerst = крайне  
öffnen — geöffnet = открывать  
ökologisch = экологический  
östlich = восточный  
überlebt = выживший  
überraschen — überrascht = удивлять  
überraschend = удивительный  
übertreffen — übertrifft — übertroffen — übertraf = превосходить