zu sein = to be = быть
du bist = you are = ты есть
er ist = he is = он есть
ihr seid = you are = вы (мн.) есть
wir sind = we are = мы есть
sie sind = they are = они есть
ich bin das gewesen = I have been that = я был этим
ich war = I was = я был
zu haben = to have = иметь
du hast = you have = ты имеешь
er hat = he has = он имеет
ihr habt = you have = вы (мн.) имеете
ich habe das gehabt = I have had that = я имел это
ich hatte = I had = я имел
ich hätte = I would have = я бы имел
zu werden = to become = становиться
er wird = he becomes = он становится
ich bin der Mann geworden = I have become the man = я стал мужчиной
ich wurde = I became = я стал
mit dem Mann = with the man = с мужчиной
an = on; at = на; у
auf = on; upon = на
sich = oneself = себя
zu können = to be able to = мочь
er kann = he can = он может
ich habe das gekonnt = I have been able to do that = я мог это
ich konnte = I could = я мог
für den Mann = for the man = для мужчины
von dem Mann = from the man = от мужчины
ihr = you (plural) = вы
der Mann = the man = мужчина
Männer = men = мужчины
aus dem Haus = from the house = из дома
richtig = correct = правильный
nach dem Mann = after the man = после мужчины
zu machen = to do = делать
ich habe das gemacht = I have done that = я сделал это
zu geben = to give = давать
er gibt = he gives = он даёт
ich habe das gegeben = I have given that = я дал это
ich gab = I gave = я дал
um den Mann = around the man = вокруг мужчины
gut = good = хороший
besser = better = лучше
am besten = best = лучший
wenn = if; when = если; когда
bei dem Mann = at the man's place = у мужчины
zu gehen = to go = идти
er geht = he goes = он идёт
ich bin der Mann gegangen = I have gone to the man = я пошёл к мужчине
ich ging = I went = я шёл
zu gehen um = to be about = касаться
er geht um den Mann = it is about the man = это касается мужчины
ich bin um den Mann gegangen = I have gone around the man = я обошёл мужчину
ich ging um den Mann = I went around the man = я обходил мужчину
zu kommen = to come = приходить
er kommt = he comes = он приходит
ich bin der Mann gekommen = I have come to the man = я пришёл к мужчине
ich kam = I came = я пришёл
als = as; when; than = как; когда; чем
über den Mann = about the man = о мужчине
der Text = the text = текст
Texte = texts = тексты
noch = still; yet = ещё
dann = then = тогда
der Mensch = the person = человек
Menschen = people = люди
das Wort = the word = слово
Wörter = words = слова
falsch = wrong = неправильный
der Herr = the gentleman = господин
Herren = gentlemen = господа
viel = much = много
mehr = more = больше
am meisten = most = больше всего
der Moderator = the moderator = ведущий
Moderatoren = moderators = ведущие
immer = always = всегда
vor dem Mann = in front of the man = перед мужчиной
die Präposition = the preposition = предлог
Präpositionen = prepositions = предлоги
schon = already = уже
sehr = very = очень
das Kind = the child = ребёнок
Kinder = children = дети
der Schuh = the shoe = ботинок
Schuhe = shoes = ботинки
neu = new = новый
der Teil = the part = часть
Teile = parts = части
zu stehen = to stand = стоять
er steht = he stands = он стоит
ich habe da gestanden = I have stood there = я стоял там
ich stand = I stood = я стоял
zu sehen = to see = видеть
er sieht = he sees = он видит
ich habe das gesehen = I have seen that = я видел это
ich sah = I saw = я видел
heute = today = сегодня
zu ergänzen = to complete = дополнять
er ergänzt = he completes = он дополняет
ich habe das ergänzt = I have completed that = я дополнил это
zu wollen = to want = хотеть
er will = he wants = он хочет
ich habe das gewollt = I have wanted that = я хотел это
ich wollte = I wanted = я хотел
groß = big; large = большой
größer = bigger = больше
am größten = biggest = самый большой
da = there = там
das Jahr = the year = год
Jahre = years = года
die Leute = the people = люди
zu sollen = to be supposed to = должен
er soll = he should = он должен
ich habe das gesollt = I was supposed to do that = я был должен это
ich sollte = I should = я должен был
die Frau = the woman = женщина
Frauen = women = женщины
doch = yet; however = всё же; однако
mir = to me = мне
andere = other = другой
welcher = which = который
ihnen = to them = им
zu sprechen mit = to speak with = говорить с
er spricht mit dem Mann über das Leben = he speaks with the man about life = он говорит с мужчиной о жизни
ich habe mit dem Mann über das Leben gesprochen = I have spoken with the man about life = я говорил с мужчиной о жизни
ich sprach mit dem Mann über das Leben = I spoke with the man about life = я говорил с мужчиной о жизни
zu sprechen von = to speak of = говорить о
ich habe von dem Haus gesprochen = I have spoken of the house = я говорил о доме
zu sprechen für = to speak for = говорить в пользу 
ich habe für den Mann gesprochen = I have spoken for the man = я говорил в опльзу мужчины
zu sagen = to say = сказать
er sagt = he says = он говорит
ich habe das gesagt = I have said that = я сказал это
ich sagte = I said = я сказал
zu finden = to find = находить
er findet = he finds = он находит
ich habe das gefunden = I have found that = я нашёл это
ich fand = I found = я нашёл
das Leben = the life = жизнь
Leben = lives = жизни
etwas = something = что-то
das Haus = the house = дом
Häuser = houses = дома
zu benutzen = to use = использовать
er benutzt = he uses = он использует
ich habe das benutzt = I have used that = я использовал это
ich benutzte = I used = я использовал
bis den Tag = until the day = до дня
ganz = whole; entirely = весь; совсем
zu wissen = to know = знать
er weiß = he knows = он знает
ich habe das gewusst = I have known that = я знал это
ich wusste = I knew = я знал
ich wüsste = I would know = я бы знал
zu hören = to hear = слышать
er hört = he hears = он слышит
ich habe das gehört = I have heard that = я слышал это
ich hörte = I heard = я слышал
jetzt = now = сейчас
zu möchten = to would like = хотеть бы
er möchte = he would like = он хотел бы
ich habe das gemöchtet = I would have liked that = я хотел бы это
ich möchte = I would like = я бы хотел
passend = suitable = подходящий
zu schreiben = to write = писать
er schreibt an den Mann über das Leben = he writes to the man about life = он пишет мужчине о жизни
ich habe an den Mann über das Leben geschrieben = I have written to the man about life = я написал мужчине о жизни
ich schrieb = I wrote = я писал
das Kreuz = the cross = крест
Kreuze = crosses = кресты
denn = because = потому что
die Lösung = the solution = решение
Lösungen = solutions = решения
der Tag = the day = день
Tage = days = дни
unser = our = наш
viel = much = много
viele = many = многие
wieder = again = снова
die Frage nach dem Mann = the question about the man = вопрос о мужчине
Fragen = questions = вопросы
der Satz = the sentence = предложение
Sätze = sentences = предложения
folgend = following = следующий
der Artikel = the article = артикль; статья
Artikel = articles = артикли; статьи
Deutschland = Germany = Германия
die Person = the person = персона
Personen = persons = персоны
also = so; therefore = итак; следовательно
zu helfen bei = to help with = помогать с
er hilft bei der Aufgabe = he helps with the task = он помогает с заданием
ich habe bei der Aufgabe geholfen = I have helped with the task = я помог с заданием
ich half bei der Aufgabe = I helped with the task = я помогал с заданием
hier = here = здесь
zu leben = to live = жить
er lebt = he lives = он живёт
ich habe da gelebt = I have lived there = я жил там
ich lebte da = I lived there = я жил
zu lernen = to learn = учиться
er lernt = he learns = он учится
ich habe das gelernt = I have learned that = я выучил это
ich lernte = I learned = я учился
wichtig = important = важный
die Aufgabe = the task = задание
Aufgaben = tasks = задания
das Auto = the car = машина
Autos = cars = машины
der Freund = the friend = друг
Freunde = friends = друзья
die Grammatik = the grammar = грамматика
Grammatiken = grammars = грамматики
alle = all = все
zu denken an = to think of = думать о
er denkt an den Mann = he thinks of the man = он думает о мужчине
ich habe an den Mann gedacht = I have thought of the man = я думал о мужчине
ich dachte an den Mann = I thought of the man = я думал о мужчине
durch den Park = through the park = через парк
gern = gladly = с удовольствием
ob = whether; if = ли
das Beispiel = the example = пример
Beispiele = examples = примеры
der Mann = the man = мужчина
Männer = men = мужчины
zu fahren = to drive = ехать
er fährt = he drives = он едет
ich bin mit dem Auto gefahren = I have driven the car = я ехал на машине
ich fuhr = I drove = я ехал
jeder = everyone = каждый
zu lesen = to read = читать
er liest = he reads = он читает
ich habe das Buch gelesen = I have read the book = я прочитал книгу
ich las = I read = я читал
mich = me = меня
der Film = the film = фильм
Filme = films = фильмы
der Hauptsatz = the main clause = главное предложение
Hauptsätze = main clauses = главные предложения
die Mail = the email = письмо
Mails = emails = письма
die Schule = the school = школа
Schulen = schools = школы
die Zeit für den Mann = the time for the man = время для мужчины
Zeiten = times = времена
zu bekommen = to receive = получать
er bekommt = he receives = он получает
ich habe das bekommen = I have received that = я получил это
ich bekam = I received = я получил
dazu = in addition = к этому
einmal = once = однажды
früh = early = рано
zu verstehen = to understand = понимать
er versteht = he understands = он понимает
ich habe dich verstanden = I have understood you = я понял тебя
ich verstand = I understood = я понял
warum = why = почему
wo = where = где
die Antwort auf die Frage = the answer to the question = ответ на вопрос
Antworten = answers = ответы
der Computer = the computer = компьютер
Computer = computers = компьютеры
das Verb = the verb = глагол
Verben = verbs = глаголы
weil = because = потому что
die Aussage = the statement = высказывание
Aussagen = statements = высказывания
das Partizip = the participle = причастие
Partizipien = participles = причастия
ohne den Mann = without the man = без мужчины
weniger = less = меньше
wer = who = кто
der Ausdruck = the expression = выражение
Ausdrücke = expressions = выражения
die Information = the information = информация
Informationen = informations = информации
die Stadt = the city = город
Städte = cities = города
zu arbeiten = to work = работать
er arbeitet = he works = он работает
ich habe da gearbeitet = I have worked there = я работал там
ich arbeitete = I worked = я работал
zu heißen = to be called = называться
er heißt = he is called = он называется
ich habe so geheißen = I have been called that = меня так называли
ich hieß = I was called = меня звали
zu kaufen = to buy = покупать
er kauft = he buys = он покупает
ich habe das gekauft = I have bought that = я купил это
ich kaufte = I bought = я купил
der Kasten = the box = ящик
Kästen = boxes = ящики
zu ordnen = to arrange = упорядочивать
er ordnet = he arranges = он упорядочивает
ich habe das geordnet = I have arranged that = я упорядочил это
ich ordnete = I arranged = я упорядочивал
alt = old = старый
älter = older = старше
am ältesten = oldest = самый старый
zu bleiben = to stay = оставаться
er bleibt = he stays = он остаётся
ich bin zu Hause geblieben = I have stayed at home = я остался дома
ich blieb = I stayed = я остался
erste = first = первый
zu müssen = to have to = быть должным
er muss = he must = он должен
ich habe das gemusst = I have had to do that = я должен был это
ich musste = I had to = я был должен
zu suchen nach = to search for = искать
er sucht nach dem Mann = he searches for the man = он ищет мужчину
ich habe nach dem Mann gesucht = I have searched for the man = я искал мужчину
ich suchte nach dem Mann = I searched for the man = я искал мужчину
zu treffen sich = to meet = встречаться
er trifft sich = he meets = он встречается
ich habe mich mit dem Mann getroffen = I have met with the man = я встретился с мужчиной
ich traf mich mit dem Mann = I met with the man = я встретился с мужчиной
uns = us = нас
die Arbeit an dem Projekt = the work on the project = работа над проектом
Arbeiten = works = работы
der Grund für die Reise = the reason for the trip = причина поездки
Gründe = reasons = причины
das Land = the country = страна
Länder = countries = страны
der Plural = the plural = множественное число
das Thema = the topic = тема
Themen = topics = темы
die Uhr = the clock = часы
Uhren = clocks = часы
der Wortschatz = the vocabulary = словарный запас
Wortschätze = vocabularies = словарные запасы
zu brauchen = to need = нуждаться
er braucht = he needs = он нуждается
ich habe das gebraucht = I have needed that = это мне нужно было
ich brauchte = I needed = мне это было нужно
dafür = for that = для этого
dort = there = там
die Überschrift = the heading = заголовок
Überschriften = headings = заголовки
zu bringen zu = to bring to = приносить
er bringt zum Mann = he brings to the man = он приносит мужчине
ich habe zum Mann gebracht = I have brought to the man = я принёс мужчине
ich brachte zum Mann = I brought to the man = я приносил мужчине
die Familie = the family = семья
Familien = families = семьи
das Geld = the money = деньги
das Kino = the cinema = кинотеатр
Kinos = cinemas = кинотеатры
der Nebensatz = the subordinate clause = придаточное предложение
Nebensätze = subordinate clauses = придаточные предложения
der Relativsatz = the relative clause = относительное предложение
Relativsätze = relative clauses = относительные предложения
zu beginnen mit = to begin with = начинать с
er beginnt mit der Aufgabe = he begins with the task = он начинает с задания
ich habe mit der Aufgabe begonnen = I have begun with the task = я начал с задания
ich begann mit der Aufgabe = I began with the task = я начал с задания
einfach = simple = простой
lange = long = долго
zu markieren = to mark = отмечать
er markiert = he marks = он отмечает
ich habe das markiert = I have marked that = я отметил это
ich markierte = I marked = я отметил
zusammen = together = вместе
die Form = the form = форма
Formen = forms = формы
die Kirche = the church = церковь
Kirchen = churches = церкви
der Konjunktiv = the subjunctive = конъюнктив
der Passiv = the passive = пассив
die Prüfung = the exam = экзамен
Prüfungen = exams = экзамены
ab dem Tag = from the day = с (определённого) дня
dein = your = твой
zu dürfen = to be allowed to = иметь разрешение
er darf = he may = он может
ich habe das gedurft = I have been allowed to do that = мне это было можно
ich durfte = I was allowed = мне было разрешено
sich freuen über; auf = to be glad about = радоваться
er freut sich über das Geschenk = he is glad about the gift = он радуется подарку
ich habe mich über das Geschenk gefreut = I have been glad about the gift = я радовался подарку
ich freute mich über das Geschenk = I was glad about the gift = я радовался подарку
ich freue mich auf den Urlaub = I am looking forward to the vacation = я с нетерпением жду отпуска
zu kennen = to know (someone) = знать (кого-то)
er kennt = he knows = он знает
ich habe ihn gekannt = I have known him = я знал его
ich kannte = I knew = я знал
oft = often = часто
zufrieden mit dem Mann = satisfied with the man = доволен мужчиной
die Eltern = the parents = родители
der Euro = the euro = евро
Euros = euros = евро (мн.)
die Sprache = the language = язык
Sprachen = languages = языки
das Tier = the animal = животное
Tiere = animals = животные
deutsch = German = немецкий
dir = to you = тебе
zu fragen nach = to ask about = спрашивать о
er fragt nach dem Weg = he asks about the way = он спрашивает дорогу
ich habe nach dem Weg gefragt = I have asked about the way = я спрашивал дорогу
ich fragte nach dem Weg = I asked about the way = я спросил дорогу
zu nehmen = to take = брать
er nimmt = he takes = он берёт
ich habe das genommen = I have taken that = я взял это
ich nahm = I took = я взял
nächste = next = следующий
zu passen zu = to fit with = подходить
er passt zu dem Stil = he fits the style = он подходит этому стилю
ich habe zu dem Stil gepasst = I have fit the style = я подошёл стилю
ich passte zu dem Stil = I fit the style = я подошёл стилю
schnell = fast = быстрый
schneller = faster = быстрее
am schnellsten = fastest = самый быстрый
zwischen dem Mann und der Frau = between the man and the woman = между мужчиной и женщиной
das Ende = the end = конец
Enden = ends = концы
die Freundin = the (female) friend = подруга
Freundinnen = (female) friends = подруги
die Hilfe für den Mann = the help for the man = помощь для мужчины
Hilfen = helps; aids = помощи
der Partner = the (male) partner = партнёр
Partner = partners = партнёры
die Partnerin = the (female) partner = партнёрша
Partnerinnen = (female) partners = партнёрши
der Singular = the singular = единственное число
der Urlaub = the vacation = отпуск
Urlaube = vacations = отпуска
die Zahl = the number = число
Zahlen = numbers = числа
beide = both = оба
zu bilden = to form = формировать
er bildet = he forms = он формирует
ich habe das gebildet = I have formed that = я сформировал это
ich bildete = I formed = я сформировал
gegen den Mann = against the man = против мужчины
wider den Willen = against the will = вопреки воле
gestern = yesterday = вчера
gleich = same = тот же; равный
klein = small = маленький
kleiner = smaller = меньше
am kleinsten = smallest = самый маленький
zu liegen = to lie (rest) = лежать
er liegt = he lies = он лежит
ich habe auf dem Bett gelegen = I have lain on the bed = я лежал на кровати
ich lag auf dem Bett = I lay on the bed = я лежал на кровати
mal = time; once (as in "einmal") = раз; как-то
nichts = nothing = ничто
schön = beautiful = красивый
schöner = more beautiful = красивее
am schönsten = most beautiful = самый красивый
weit = far = далёкий
weiter = farther = дальше
am weitesten = farthest = самый далёкий
die Beziehung = the relationship = отношение
Beziehungen = relationships = отношения
das Buch = the book = книга
Bücher = books = книги
der Kaffee = the coffee = кофе
Kaffees = coffees = разновидности кофе
München = Munich = Мюнхен
der Name = the name = имя
Namen = names = имена
die Woche = the week = неделя
Wochen = weeks = недели
bekannt = known = известный
darauf = on that; thereupon = на это; затем
zu erhalten = to receive = получать
er erhält = he receives = он получает
ich habe das erhalten = I have received that = я получил это
ich erhielt = I received = я получил
zu essen = to eat = есть
er isst = he eats = он ест
ich habe das gegessen = I have eaten that = я это съел
ich aß = I ate = я ел
geradeaus = straight ahead = прямо
gerade = just; straight = только что; прямо
möglich = possible = возможно
schlecht = bad = плохой
schlechter = worse = хуже
am schlechtesten = worst = самый плохой
spät = late = поздно
statt des Mannes = instead of the man = вместо мужчины
wenig = little = мало
die Angst vor dem Mann = the fear of the man = страх перед мужчиной
Ängste = fears = страхи
das Internet = the Internet = интернет
das Kapitel = the chapter = глава
Kapitel = chapters = главы
das Subjekt = the subject = подлежащее
Subjekte = subjects = подлежащие
die Vorstellung von dem Mann = the idea; presentation of the man = представление о мужчине
Vorstellungen = ideas; presentations = представления
die Zeitung = the newspaper = газета
Zeitungen = newspapers = газеты
allerdings = indeed; however = однако; действительно
bitte = please = пожалуйста
damit = so that; with that = чтобы; с этим
zu halten = to hold = держать
er hält = he holds = он держит
ich habe das gehalten = I have held that = я держал это
ich hielt = I held = я держал
ihm = to him = ему
zu mögen = to like = нравиться
er mag = he likes = он любит
ich mochte das = I liked that = мне это нравилось
zu setzen = to set; to place = ставить
er setzt = he sets = он ставит
ich habe das gesetzt = I have set that = я поставил это
ich setzte = I set = я поставил
zu wählen = to choose; to vote = выбирать
er wählt = he chooses = он выбирает
ich habe das gewählt = I have chosen that = я выбрал это
ich wählte = I chose = я выбрал
das Hörverstehen = the listening comprehension = аудирование
der Ort = the place = место
Orte = places = места
das Wetter = the weather = погода
Wetter = weathers = погодные условия (редко во множественном)
die Zukunft = the future = будущее
zu bauen = to build = строить
er baut = he builds = он строит
ich habe das gebaut = I have built that = я построил это
ich baute = I built = я строил
zu bieten = to offer = предлагать
er bietet = he offers = он предлагает
ich habe das geboten = I have offered that = я предложил это
ich bot = I offered = я предложил
deshalb = therefore = поэтому
eigen = own = собственный
zu erzählen von = to tell about = рассказывать о
er erzählt von dem Urlaub = he tells about the vacation = он рассказывает об отпуске
ich habe von dem Urlaub erzählt = I have told about the vacation = я рассказал об отпуске
ich erzählte von dem Urlaub = I told about the vacation = я рассказывал об отпуске
jemand = someone = кто-то
zu nennen = to name; to call = называть
er nennt = he names = он называет
ich habe ihn Peter genannt = I have called him Peter = я назвал его Петером
ich nannte ihn Peter = I called him Peter = я назвал его Петером
zu passieren = to happen = происходить
es passiert = it happens = это происходит
es ist passiert = it has happened = это произошло
es passierte = it happened = это случилось
schwer = difficult; heavy = трудный; тяжёлый
schwerer = more difficult; heavier = труднее; тяжелее
am schwersten = most difficult = самый трудный
selbst = oneself; even = сам; даже
zu stellen = to place; to pose = ставить
er stellt = he places = он ставит
ich habe das gestellt = I have placed that = я поставил это
ich stellte = I placed = я ставил
vielleicht = maybe = может быть
wegen des Mannes = because of the man = из-за мужчины
während des Tages = during the day = в течение дня
zuerst = first; at first = сначала
das Adjektiv = the adjective = прилагательное
Adjektive = adjectives = прилагательные
das Bild = the picture = картина
Bilder = pictures = картины
die Endung = the ending = окончание
Endungen = endings = окончания
die Firma = the company = фирма
Firmen = companies = фирмы
das Hotel = the hotel = отель
Hotels = hotels = отели
mündlich = oral = устный
mündlicher = more oral = более устный
am mündlichsten = most oral = самый устный
die Nachricht von dem Mann = the message from the man = сообщение от мужчины
Nachrichten = messages; news = сообщения; новости
Präteritum = preterite (past simple) = претерит
die Reihenfolge = the sequence = порядок
Reihenfolgen = sequences = порядки
zu bedeuten = to mean = значить
er bedeutet = it means = это значит
es hat das bedeutet = it has meant that = это означало
es bedeutete = it meant = это значило
eben = just; exactly = как раз; именно
zu entscheiden = to decide = решать
er entscheidet = he decides = он решает
ich habe das entschieden = I have decided that = я решил это
ich entschied = I decided = я решил
genau = exactly = точно
zu handeln = to act = действовать
er handelt = he acts = он действует
ich habe richtig gehandelt = I have acted correctly = я поступил правильно
ich handelte = I acted = я действовал
sich handeln um = to be about = речь идёт о
es handelt sich um einen Mann = it is about a man = речь идёт о мужчине
es hat sich um einen Mann gehandelt = it has been about a man = речь шла о мужчине
es handelte sich um einen Mann = it was about a man = речь шла о мужчине
zu handeln von = to deal with = повествовать о
das Buch handelt von dem Krieg = the book is about the war = книга повествует о войне
das Buch hat von dem Krieg gehandelt = the book was about the war = книга была о войне
das Buch handelte von dem Krieg = the book was about the war = книга была о войне
ihn = him = его
manchmal = sometimes = иногда
sondern = but rather = а (напротив)
zu spielen = to play = играть
er spielt = he plays = он играет
ich habe Fußball gespielt = I have played football = я играл в футбол
ich spielte = I played = я играл
zu steigen = to climb; to rise = подниматься; расти
er steigt = he climbs = он поднимается
ich bin auf den Berg gestiegen = I have climbed the mountain = я поднялся на гору
ich stieg = I climbed = я поднимался
der Berg = the mountain = гора
Berge = mountains = горы
die Deklination = the declension = склонение
Deklinationen = declensions = склонения
die Lese = the reading = чтение (редк.)
die Meinung = the opinion = мнение
Meinungen = opinions = мнения
das Recht = the right; the law = право
Rechte = rights; laws = права
der Satzbau = the sentence structure = структура предложения
Satzbaus = (genitive) of the sentence structure = структуры предложения
die Situation = the situation = ситуация
Situationen = situations = ситуации
die Tür = the door = дверь
Türen = doors = двери
der Vater = the father = отец
Väter = fathers = отцы
die Welt = the world = мир
Welten = worlds = миры
bald = soon = скоро
zu bestehen = to pass; to exist = выдержать; существовать
er besteht = he passes; exists = он выдерживает; существует
ich habe die Prüfung bestanden = I have passed the exam = я сдал экзамен
ich bestand = I passed = я сдал
zu bestehen auf = to insist on = настаивать
er besteht auf dem Recht = he insists on the right = он настаивает на праве
ich habe auf dem Recht bestanden = I have insisted on the right = я настоял на праве
ich bestand auf dem Recht = I insisted on the right = я настаивал
zu bestehen aus = to consist of = состоять из
es besteht aus drei Teilen = it consists of three parts = оно состоит из трёх частей
es hat aus drei Teilen bestanden = it consisted of three parts = оно состояло из трёх частей
es bestand aus drei Teilen = it consisted of three parts = оно состояло из трёх частей
zu fliegen = to fly = летать
er fliegt = he flies = он летит
ich bin nach Berlin geflogen = I have flown to Berlin = я прилетел в Берлин
ich flog = I flew = я летел
gesund = healthy = здоровый
zu lachen = to laugh = смеяться
er lacht = he laughs = он смеётся
ich habe sehr gelacht = I have laughed a lot = я много смеялся
ich lachte = I laughed = я смеялся
zu meinen = to mean; to think = иметь в виду; думать
er meint = he means = он имеет в виду
ich habe das gemeint = I have meant that = я это имел в виду
ich meinte = I meant; I thought = я имел в виду; я думал
zu sitzen = to sit = сидеть
er sitzt = he sits = он сидит
ich habe auf dem Stuhl gesessen = I have sat on the chair = я сидел на стуле
ich saß auf dem Stuhl = I sat on the chair = я сидел на стуле
zu studieren = to study (at university) = учиться (в вузе)
er studiert = he studies = он учится
ich habe Physik studiert = I have studied physics = я учился физике
ich studierte Physik = I studied physics = я изучал физику
zu trinken = to drink = пить
er trinkt = he drinks = он пьёт
ich habe Wasser getrunken = I have drunk water = я выпил воду
ich trank Wasser = I drank water = я пил воду
zu tun = to do = делать
er tut = he does = он делает
ich habe das getan = I have done that = я сделал это
ich tat das = I did that = я сделал это
zu verdienen = to earn = зарабатывать
er verdient = he earns = он зарабатывает
ich habe Geld verdient = I have earned money = я заработал деньги
ich verdiente Geld = I earned money = я зарабатывал деньги
zu vergessen = to forget = забывать
er vergisst = he forgets = он забывает
ich habe das vergessen = I have forgotten that = я забыл это
ich vergaß das = I forgot that = я забыл это
zu warten auf = to wait for = ждать
er wartet auf den Bus = he waits for the bus = он ждёт автобус
ich habe auf den Bus gewartet = I have waited for the bus = я ждал автобус
ich wartete auf den Bus = I waited for the bus = я ждал автобус
weiter = further; continue = далее; дальше
wohl = probably; well = вероятно; хорошо
überhaupt = at all = вообще
zu überzeugen von = to convince of = убеждать в
er überzeugt von dem Plan = he convinces of the plan = он убеждает в плане
ich habe dich vom Plan überzeugt = I have convinced you of the plan = я убедил тебя в плане
ich überzeugte dich vom Plan = I convinced you of the plan = я убеждал тебя в плане
der Anfang = the beginning = начало
Anfänge = beginnings = начала
die Beschwerde über den Lärm = the complaint about the noise = жалоба на шум
Beschwerden = complaints = жалобы
die Ernährung = the nutrition = питание
Ernährungen = nursings = питания (редко во множественном)
die Geschichte = the story; history = история
Geschichten = stories; histories = истории
das Interesse an dem Thema = the interest in the topic = интерес к теме
Interessen = interests = интересы
die Lücke = the gap; blank = пропуск
Lücken = gaps = пропуски
die Million = the million = миллион
Millionen = millions = миллионы
der Nachbar = the neighbor = сосед
Nachbarn = neighbors = соседи
die Party = the party = вечеринка
Partys = parties = вечеринки
der Roman = the novel = роман
Romane = novels = романы
der Track = the track = трек
Tracks = tracks = треки
der Vortrag = the presentation; lecture = доклад
Vorträge = presentations; lectures = доклады
die Wahl = the election; choice = выбор
Wahlen = elections = выборы
bestimmt = certainly; specific = определённо; определённый
zu besuchen = to visit = посещать
er besucht = he visits = он посещает
ich habe das Museum besucht = I have visited the museum = я посетил музей
ich besuchte das Museum = I visited the museum = я посетил музей
daran = on that; about that = на этом; об этом
darüber = about it; over that = об этом; над этим
dich = you (accusative) = тебя
endlich = finally = наконец
fest = firm; fixed = твёрдый; прочный
zu gehören = to belong to = принадлежать
er gehört dem Mann = he belongs to the man = он принадлежит мужчине
ich habe dem Mann gehört = I have belonged to the man = я принадлежал мужчине
ich gehörte dem Mann = I belonged to the man = я принадлежал мужчине
gemeinsam = together; in common = совместный; общий
zu glauben an = to believe in = верить в
er glaubt an den Erfolg = he believes in success = он верит в успех
ich habe an den Erfolg geglaubt = I have believed in success = я верил в успех
ich glaubte an den Erfolg = I believed in success = я верил в успех
lang = long = длинный
länger = longer = длиннее
am längsten = longest = самый длинный
zu lassen = to let; allow = позволять; оставлять
er lässt = he lets = он позволяет
ich habe ihn gehen lassen = I have let him go = я позволил ему уйти
ich ließ ihn gehen = I let him go = я позволил ему уйти
letzte = last = последний
mehrere = several = несколько
seit dem Tag = since the day = с того дня
zu tragen = to carry; to wear = носить
er trägt = he carries; wears = он несёт; носит
ich habe die Tasche getragen = I have carried the bag = я нёс сумку
ich trug die Tasche = I carried the bag = я нёс сумку
zu vorstellen = to introduce; imagine = представлять
er stellt den Mann vor = he introduces the man = он представляет мужчину
ich habe den Mann vorgestellt = I have introduced the man = я представил мужчину
ich stellte den Mann vor = I introduced the man = я представил мужчину
wahrscheinlich = probably = вероятно
zurück = back = назад
die Angabe = the information = указание
Angaben = data; information = данные
das Angebot = the offer = предложение
Angebote = offers = предложения
der August = August = август
das Bio = organic; biology (contextual) = эко; биология
der Chef = the boss = начальник
Chefs = bosses = начальники
die Entscheidung = the decision = решение
Entscheidungen = decisions = решения
der Erfolg = the success = успех
Erfolge = successes = успехи
die Ergänzung = the addition; complement = дополнение
Ergänzungen = additions = дополнения
der Fall = the case; situation = случай
Fälle = cases = случаи
das Gefühl = the feeling = чувство
Gefühle = feelings = чувства
der Hund = the dog = собака
Hunde = dogs = собаки
die Idee = the idea = идея
Ideen = ideas = идеи
der Kunde = the customer = клиент
Kunden = customers = клиенты
Plusquamperfekt = past perfect = плюсквамперфект; предпрошедшее время
die Position = the position = позиция
Positionen = positions = позиции
das Produkt = the product = продукт
Produkte = products = продукты
die Pronominaladverbien = pronominal adverbs = местоименные наречия
das Relativpronomen = the relative pronoun = относительное местоимение
Relativpronomen = relative pronouns = относительные местоимения
der Sport = sports = спорт
Sportarten = types of sports = виды спорта
am Montag = on Monday = в понедельник
besonders = especially = особенно
bloß = only; just = просто; лишь
daher = therefore; from that = поэтому; оттуда
davon = from that; of it = от этого; об этом
zu erleben = to experience = переживать
er erlebt = he experiences = он переживает
ich habe das erlebt = I have experienced that = я пережил это
ich erlebte das = I experienced that = я пережил это
frei von = free from = свободен от
frei von dem Problem = free from the problem = свободен от проблемы
zu gelten = to be valid = быть действительным
er gilt = it is valid = это действительно
es hat gegolten = it has been valid = это было действительно
es galt = it was valid = это было действительно
hoch = high = высокий
höher = higher = выше
am höchsten = highest = самый высокий
laut = loud = громкий
lauter = louder = громче
am lautesten = loudest = самый громкий
zu schließen = to close = закрывать
er schließt = he closes = он закрывает
ich habe die Tür geschlossen = I have closed the door = я закрыл дверь
ich schloss die Tür = I closed the door = я закрыл дверь
unter dem Tisch = under the table = под столом
wirklich = really; truly = действительно
zu ändern = to change = изменять
er ändert = he changes = он меняет
ich habe das geändert = I have changed that = я изменил это
ich änderte = I changed = я изменил
der Abend = the evening = вечер
Abende = evenings = вечера
die Anzeige = the advertisement; report = объявление; заявление
Anzeigen = advertisements; reports = объявления; заявления
die Erfahrung = the experience = опыт
Erfahrungen = experiences = опыты
die Erwartung = the expectation = ожидание
Erwartungen = expectations = ожидания
das Essen = the food; meal = еда; приём пищи
Essen = meals = приёмы пищи
der Gedanke an den Mann = the thought of the man = мысль о мужчине
Gedanken = thoughts = мысли
der Infinitiv = the infinitive = инфинитив
Infinitive = infinitives = инфинитивы
der Kurs = the course = курс
Kurse = courses = курсы
die Liebe zu dem Mann = the love for the man = любовь к мужчине
Lieben = loves = любви
die Maßschuhe = custom-made shoes = обувь на заказ
die Modalverben = modal verbs = модальные глаголы
das Paar = the pair; couple = пара
Paare = pairs; couples = пары
das Problem = the problem = проблема
Probleme = problems = проблемы
das Pronomen = the pronoun = местоимение
Pronomen = pronouns = местоимения
das Präsens = present tense = настоящее время
der Prüfungsteil = the exam section = часть экзамена
Prüfungsteile = exam sections = части экзамена
die Rede = the speech; talk = речь
Reden = speeches = речи
die Regel = the rule = правило
Regeln = rules = правила
die Schlüsselwörter = keywords = ключевые слова
die Seite = the page; side = страница; сторона
Seiten = pages; sides = страницы; стороны
der Slum = the slum = трущоба
Slums = slums = трущобы
der Spaß = the fun = удовольствие
das Theater = the theater = театр
Theater = theaters = театры
die Vergangenheit = the past = прошлое
Vergangenheiten = pasts = прошедшие времена
ander = other = другой
außer dem Mann = except the man = кроме мужчины
eigentlich = actually; really = вообще-то; на самом деле
einige = some = некоторые
zu entwickeln = to develop = развивать
er entwickelt = he develops = он развивает
ich habe das entwickelt = I have developed that = я разработал это
ich entwickelte das = I developed that = я разрабатывал это
zu erkennen = to recognize = узнавать
er erkennt = he recognizes = он узнаёт
ich habe ihn erkannt = I have recognized him = я узнал его
ich erkannte ihn = I recognized him = я узнал его
erst = only; not until = только; лишь
zu funktionieren = to function; to work = функционировать
es funktioniert = it works = это работает
es hat funktioniert = it has worked = это сработало
es funktionierte = it worked = это работало
glücklich = happy = счастливый
infolge des Unfalls = as a result of the accident = вследствие аварии
jung = young = молодой
jünger = younger = моложе
am jüngsten = youngest = самый молодой
manche = some; several = некоторые
der Meister = the master = мастер
Meister = masters = мастера
natürlich = of course; natural = конечно; естественный
nie = never = никогда
obwohl = although = хотя
zu ordnen = to arrange = упорядочить
er ordnet = he arranges = он упорядочивает
ich habe das geordnet = I have arranged that = я упорядочил это
ich ordnete das = I arranged that = я упорядочивал это
sicher = safe; certain = безопасный; уверенный
trotz des Regens = despite the rain = несмотря на дождь
zu verbringen = to spend (time) = проводить
er verbringt = he spends = он проводит
ich habe den Tag verbracht = I have spent the day = я провёл день
ich verbrachte den Tag = I spent the day = я проводил день
zu wohnen = to live; to reside = жить
er wohnt = he lives = он живёт
ich habe in Berlin gewohnt = I have lived in Berlin = я жил в Берлине
ich wohnte in Berlin = I lived in Berlin = я жил в Берлине
zu zahlen = to pay = платить
er zahlt = he pays = он платит
ich habe das gezahlt = I have paid that = я заплатил это
ich zahlte das = I paid that = я платил это
zu zeigen = to show = показывать
er zeigt = he shows = он показывает
ich habe dir das gezeigt = I have shown that to you = я показал тебе это
ich zeigte dir das = I showed that to you = я показал тебе это
der Absatz = the paragraph; sales = абзац; сбыт
Absätze = paragraphs; sales = абзацы; сбыты
die Ausbildung = the education; training = обучение
Ausbildungen = educations; trainings = образования
Europa = Europe = Европа
der Gast = the guest = гость
Gäste = guests = гости
die Homepage = the website = домашняя страница
Homepages = websites = сайты
die Katze = the cat = кошка
Katzen = cats = кошки
der Kauf = the purchase = покупка
Käufe = purchases = покупки
die Kleidung = the clothes = одежда
Kleidungen = types of clothing = разновидности одежды (редко)
der Konnektor = the connector (grammar) = союз
Konnektoren = connectors = союзы
Latein = Latin = латинский
der Lehrer = the teacher = учитель
Lehrer = teachers = учителя
das Leseverstehen = reading comprehension = понимание прочитанного
die Minute = the minute = минута
Minuten = minutes = минуты
die Modalverben = modal verbs = модальные глаголы
der Monat = the month = месяц
Monate = months = месяцы
das Musical = the musical = мюзикл
Musicals = musicals = мюзиклы
die Musik = the music = музыка
die Nummer = the number = номер
Nummern = numbers = номера
die Sache = the thing; matter = вещь; дело
Sachen = things; matters = вещи; дела
die Schweiz = Switzerland = Швейцария
der Schüler = the pupil; student = ученик
Schüler = pupils; students = ученики
der Sprecher = the speaker = диктор; оратор
Sprecher = speakers = дикторы
die Stelle = the place; job; position = место; должность
Stellen = positions; jobs = позиции; должности
die Straße = the street = улица
Straßen = streets = улицы
die Stunde = the hour; lesson = час; урок
Stunden = hours; lessons = часы; занятия
Stuttgart = Stuttgart = Штутгарт
der Termin = the appointment; date = встреча; срок
Termine = appointments; deadlines = встречи; сроки
der Tipp = the tip = совет
Tipps = tips = советы
die Transkription = the transcription = расшифровка; транскрипция
Transkriptionen = transcriptions = транскрипции
der Unfall = the accident = авария
Unfälle = accidents = аварии
das Ziel = the goal = цель
Ziele = goals = цели
zu anbieten = to offer = предлагать
er bietet an = he offers = он предлагает
ich habe das angeboten = I have offered that = я предложил это
ich bot das an = I offered that = я предложил это
zu ausdrücken = to express = выражать
er drückt aus = he expresses = он выражает
ich habe meine Meinung ausgedrückt = I have expressed my opinion = я выразил своё мнение
ich drückte meine Meinung aus = I expressed my opinion = я выразил своё мнение
zu bitten um = to ask for; to request = просить
er bittet um Hilfe = he asks for help = он просит о помощи
ich habe um Hilfe gebeten = I have asked for help = я попросил о помощи
ich bat um Hilfe = I asked for help = я просил о помощи
dabei = at the same time; along with = при этом; вместе с этим
dankbar für die Hilfe = thankful for the help = благодарен за помощь
zu dauern = to last = длиться
es dauert = it lasts = это длится
es hat lange gedauert = it has lasted long = это долго длилось
es dauerte = it lasted = это длилось
zu eingehen = to enter into; to engage = входить; поступить
er geht ein = he enters = он входит
ich bin auf den Vorschlag eingegangen = I have responded to the proposal = я откликнулся на предложение
ich ging auf den Vorschlag ein = I responded to the proposal = я принял предложение
einverstanden mit dem Vorschlag = agreeable with the proposal = согласен с предложением
sich erinnern an = to remember = вспоминать
er erinnert sich an den Tag = he remembers the day = он вспоминает день
ich habe mich an den Tag erinnert = I have remembered the day = я вспомнил этот день
ich erinnerte mich an den Tag = I remembered the day = я вспомнил день
zu fallen = to fall = падать
er fällt = he falls = он падает
ich bin gefallen = I have fallen = я упал
ich fiel = I fell = я падал
sich fühlen = to feel = чувствовать себя
er fühlt sich gut = he feels good = он чувствует себя хорошо
ich habe mich schlecht gefühlt = I have felt bad = я чувствовал себя плохо
ich fühlte mich schlecht = I felt bad = я чувствовал себя плохо
gegenüber dem Haus = across from the house = напротив дома
zu gewinnen = to win = выигрывать
er gewinnt = he wins = он выигрывает
ich habe das Spiel gewonnen = I have won the game = я выиграл игру
ich gewann das Spiel = I won the game = я выиграл игру
hin = there (direction) = туда
interessiert an dem Thema = interested in the topic = заинтересован в теме
jeweils = each; respectively = соответственно
kaum = hardly; barely = едва
kurz = short = короткий
kürzer = shorter = короче
am kürzesten = shortest = самый короткий
zu lieben = to love = любить
er liebt = he loves = он любит
ich habe dich geliebt = I have loved you = я любил тебя
ich liebte dich = I loved you = я любил тебя
zu lösen = to solve = решать
er löst das Problem = he solves the problem = он решает проблему
ich habe das Problem gelöst = I have solved the problem = я решил проблему
ich löste das Problem = I solved the problem = я решал проблему
müde von der Arbeit = tired from the work = устал от работы
neutral = neutral = нейтральный
niemand = nobody = никто
zu reparieren = to repair = чинить
er repariert = he repairs = он чинит
ich habe das repariert = I have repaired that = я починил это
ich reparierte = I repaired = я чинил
zu schicken = to send = отправлять
er schickt = he sends = он отправляет
ich habe das geschickt = I have sent that = я отправил это
ich schickte = I sent = я отправил
sowie = as well as = а также
zu stimmen = to vote; to agree = голосовать; соответствовать
er stimmt zu = he agrees = он соглашается
ich habe zugestimmt = I have agreed = я согласился
ich stimmte zu = I agreed = я согласился
teils = partly; partially = частично
zu verlassen = to leave = покидать
er verlässt = he leaves = он покидает
ich habe das Haus verlassen = I have left the house = я покинул дом
ich verließ das Haus = I left the house = я покинул дом
zu verlieren = to lose = терять
er verliert = he loses = он теряет
ich habe das verloren = I have lost that = я потерял это
ich verlor das = I lost that = я потерял это
verschieden = different; various = разный
voll = full = полный
voller = fuller = полнее
am vollsten = fullest = самый полный
zu ziehen = to pull; to move = тянуть; переезжать
er zieht = he pulls; moves = он тянет; переезжает
ich habe nach Berlin gezogen = I have moved to Berlin = я переехал в Берлин
ich zog nach Berlin = I moved to Berlin = я переехал
die Übung = the exercise = упражнение
Übungen = exercises = упражнения
die Adjektivendung = the adjective ending = окончание прилагательного
Adjektivendungen = adjective endings = окончания прилагательных
das Alter = the age = возраст
das Argument = the argument = аргумент
Argumente = arguments = аргументы
die Bedeutung = the meaning = значение
Bedeutungen = meanings = значения
Berlin = Berlin = Берлин
der Beruf = the profession = профессия
Berufe = professions = профессии
die Bildung = the education; formation = образование; формирование
Bildungen = educations; formations = образования
das Cafe = the café = кафе
Cafes = cafés = кафе
das Einkaufszentrum = the shopping center = торговый центр
Einkaufszentren = shopping centers = торговые центры
das Fahrrad = the bicycle = велосипед
Fahrräder = bicycles = велосипеды
der Fehler = the mistake = ошибка
Fehler = mistakes = ошибки
das Fenster = the window = окно
Fenster = windows = окна
das Fernsehen = television = телевидение
der Fernseher = the television set = телевизор
Fernseher = television sets = телевизоры
das Fest = the festival; celebration = праздник
Feste = festivals; celebrations = праздники
das Geschenk = the gift = подарок
Geschenke = gifts = подарки
die Gesellschaft = the society = общество
Gesellschaften = societies = общества
der Haarausfall = the hair loss = выпадение волос
der Haushalt = the household = хозяйство
Haushalte = households = хозяйства
der Hinweis = the hint; indication = указание
Hinweise = hints; indications = указания
die Karte = the card; map = карта; карточка
Karten = cards; maps = карты; карточки
das Komma = the comma = запятая
Kommata = commas = запятые
die Kosten = the costs = затраты; расходы
das Krankenhaus = the hospital = больница
Krankenhäuser = hospitals = больницы
das Modalverb = the modal verb = модальный глагол
Modalverben = modal verbs = модальные глаголы
das Modell = the model = модель
Modelle = models = модели
die Möglichkeit = the possibility = возможность
Möglichkeiten = possibilities = возможности
der Müll = the trash = мусор
die Polizei = the police = полиция
Polizeien = police forces; police departments (rare, plural) = полиция (множественное)
die Post = the post; mail = почта
Posten = posts; positions; lots (depending on context) = должности; лоты; места
der Preis = the price; prize = цена; приз
Preise = prices; prizes = цены; призы
der Rat = the advice; council = совет
Räte = councils = советы; советы (организации)
der Satzteil = the clause; part of a sentence = часть предложения
Satzteile = parts of sentences = части предложения
der Schuhmacher = the shoemaker = сапожник
Schuhmacher = shoemakers = сапожники
der Service = the service = сервис; обслуживание
Services = services = сервисы; обслуживания
der Single = the single person = холостяк; одиночка
Singles = singles = холостяки; одиночки
das Stück = the piece = кусок; часть
Stücke = pieces = куски; части
das Telefon = the telephone = телефон
Telefone = telephones = телефоны
die Veranstaltung = the event = мероприятие
Veranstaltungen = events = мероприятия
der Verkehr = the traffic = движение; транспорт
der Vorteil = the advantage = преимущество
Vorteile = advantages = преимущества
die Werkstatt = the workshop; garage = мастерская
Werkstätten = workshops; garages = мастерские
die Wohnung = the apartment = квартира
Wohnungen = apartments = квартиры
das Wörterbuch = the dictionary = словарь
Wörterbücher = dictionaries = словари
der Zweifel = the doubt = сомнение
Zweifel = doubts = сомнения
zu abholen = to pick up = забирать
er holt ab = he picks up = он забирает
ich habe das abgeholt = I have picked that up = я забрал это
ich holte das ab = I picked that up = я забирал это
dagegen = against it; on the other hand = против этого; напротив
darin = in it = в этом
zu entspannen = to relax = расслабляться
er entspannt = he relaxes = он расслабляется
ich habe mich entspannt = I have relaxed = я расслабился
ich entspannte mich = I relaxed = я расслаблялся
zu entstehen = to arise; develop = возникать
er entsteht = it arises = оно возникает
es ist entstanden = it has arisen = оно возникло
es entstand = it arose = оно возникало
etwa = approximately; about; perhaps = примерно; около; возможно
zu folgen = to follow = следовать
er folgt = he follows = он следует
ich bin gefolgt = I have followed = я последовал
ich folgte = I followed = я следовал
formell = formal = официальный
froh über = glad about = радоваться чему-то
er ist froh über das Geschenk = he is glad about the gift = он рад подарку
zu fällen = to fell; cut down (trees) = валить (деревья)
er fällt = he fells = он валит
ich habe den Baum gefällt = I have felled the tree = я спилил дерево
ich fällte den Baum = I felled the tree = я спиливал дерево
zu führen = to lead; conduct = вести
er führt = he leads = он ведёт
ich habe das Gespräch geführt = I have conducted the conversation = я провёл разговор
ich führte das Gespräch = I conducted the conversation = я вел разговор
gar = really; quite = вообще; совсем
gering = low; small = низкий; небольшой
geringer = lower; smaller = ниже; меньше
am geringsten = lowest; smallest = наименьший
grau = gray = серый
zu hängen = to hang = висеть
er hängt = he hangs = он вешает; висит
ich habe das Bild gehangen = I have hung the picture = я повесил картину
ich hing das Bild = I hung the picture = я повесил картину
zu kochen = to cook = готовить (еду)
er kocht = he cooks = он готовит
ich habe das Essen gekocht = I have cooked the food = я приготовил еду
ich kochte das Essen = I cooked the food = я готовил еду
sich konzentrieren auf = to concentrate on = концентрироваться на
er konzentriert sich auf die Arbeit = he concentrates on the work = он концентрируется на работе
ich habe mich auf die Arbeit konzentriert = I have concentrated on the work = я сосредоточился на работе
ich konzentrierte mich auf die Arbeit = I concentrated on the work = я сосредотачивался на работе
zu laufen = to run; to walk = бегать; ходить
er läuft = he runs; walks = он бежит; идёт
ich bin gelaufen = I have run; walked = я бегал; ходил
ich lief = I ran; walked = я бежал; ходил
leider = unfortunately = к сожалению
lieb = dear; kind = дорогой; милый
maskulin = masculine = мужской род
nachdem = after; after that = после того как
nachdenken über = to think about = думать о
er denkt nach über das Problem = he thinks about the problem = он думает о проблеме
ich habe über das Problem nachgedacht = I have thought about the problem = я подумал о проблеме
ich dachte über das Problem nach = I thought about the problem = я думал о проблеме
nämlich = namely; you see = а именно; ведь
plötzlich = suddenly = внезапно
schließlich = finally; in the end = в конце концов
der Sprachbaustein = the language unit = языковой блок
Sprachbausteine = language units = языковые блоки
ständig = constantly; continuous = постоянно
tatsächlich = actually; indeed = действительно
toll = great; fantastic = классный; здорово
zu verwenden = to use = использовать
er verwendet = he uses = он использует
ich habe das verwendet = I have used that = я использовал это
ich verwendete das = I used that = я использовал это
wann = when = когда
weder … noch … = neither … nor … = ни … ни …
wohin = where to = куда
zwar = indeed; certainly; though = действительно; однако
sich ärgern über = to be annoyed about = сердиться на
er ärgert sich über das Problem = he is annoyed about the problem = он сердится на проблему
ich habe mich darüber geärgert = I have been annoyed about it = я злился из-за этого
ich ärgerte mich darüber = I was annoyed about it = я злился
übrigens = by the way = кстати
das Adverb = the adverb = наречие
Adverbien = adverbs = наречия
der Arbeitnehmer = the employee = работник
Arbeitnehmer = employees = работники
der Arm = the arm = рука
Arme = arms = руки
der Arzt = the doctor = врач
Ärzte = doctors = врачи
der Aspekt = the aspect = аспект
Aspekte = aspects = аспекты
die Autobahn = the highway = автомагистраль
Autobahnen = highways = автомагистрали
der Bauer = the farmer = фермер; крестьянин
Bauern = farmers = фермеры
der Begriff = the term; concept = понятие
Begriffe = terms; concepts = понятия
die Behinderung = the disability = инвалидность
Behinderungen = disabilities = инвалидности
der Bekannte = the acquaintance (male) = знакомый
Bekannten = acquaintances = знакомые
der Besuch = the visit = визит
Besuche = visits = визиты
das Büro = the office = офис
Büros = offices = офисы
die Dame = the lady = леди; дама
Damen = ladies = леди; дамы
der Dank für = the thanks for = благодарность за
der Dank für die Hilfe = the thanks for the help = благодарность за помощь
der Deutschkurs = the German course = курс немецкого языка
Deutschkurse = German courses = курсы немецкого языка
der Dialekt = the dialect = диалект
Dialekte = dialects = диалекты
das Ding = the thing = вещь
Dinge = things = вещи
das Eis = the ice; ice cream = лёд; мороженое
Eise = ices; types of ice (plural, rare) = виды льда (редко)
die Freude an = the joy in = радость от
die Freuden = joys = радости
die Freude über; auf = the joy about; looking forward to = радость из-за; ждать с радостью
Freuden = joys = радости
der Geburtstag = the birthday = день рождения
Geburtstage = birthdays = дни рождения
die Gegenwart = the present = настоящее время; присутствие
das Gerät = the device = устройство
Geräte = devices = устройства
das Gespräch = the conversation = разговор
Gespräche = conversations = разговоры
die Grafik = the graphic = графика
Grafiken = graphics = графики
die Hausaufgabe = the homework = домашнее задание
Hausaufgaben = homeworks = домашние задания
indirekt = indirect = косвенный
die Kartoffel = the potato = картофель
Kartoffeln = potatoes = картофелины
der Kollege = the colleague = коллега
Kollegen = colleagues = коллеги
der Kontext = the context = контекст
Kontexte = contexts = контексты
der Kopfschmerz = the headache = головная боль
Kopfschmerzen = headaches = головные боли
die Kritik = the criticism = критика
Kritiken = criticisms; reviews = критики; отзывы
der Liebesfilm = the romance film = романтический фильм
Liebesfilme = romance films = романтические фильмы
maskulin = masculine = мужской род
die Meldung = the message; report = сообщение; доклад
Meldungen = messages; reports = сообщения; доклады
der Montag = Monday = понедельник
Montage = assemblies; montages = монтажи (в зависимости от контекста)
der Morgen = the morning = утро
Morgen = mornings = утра
das Paket = the package = посылка
Pakete = packages = посылки
der Patient = the patient = пациент
Patienten = patients = пациенты
das Programm = the program = программа
Programme = programs = программы
die Reise = the trip = путешествие
Reisen = trips = путешествия
der Rhein = the Rhine (river) = Рейн (река)
die Schlange = the queue; snake = очередь; змея
Schlangen = queues; snakes = очереди; змеи
die Schokolade = the chocolate = шоколад
Schokoladen = chocolates = разновидности шоколада
der Stau = the traffic jam = пробка
Staus = traffic jams = пробки
die Tabelle = the table = таблица
Tabellen = tables = таблицы
der Test = the test = тест
Tests = tests = тесты
die Textstelle = the passage; text passage = отрывок текста
Textstellen = passages = отрывки
der Tisch = the table = стол
Tische = tables = столы
die Tochter = the daughter = дочь
Töchter = daughters = дочери
die Umfrage = the survey = опрос
Umfragen = surveys = опросы
der Umlaut = the umlaut = умлау́т
Umlaute = umlauts = умлау́ты
das Unternehmen = the enterprise; company = предприятие; компания
Unternehmen = enterprises; companies = предприятия; компании
die Verbindung = the connection = связь
Verbindungen = connections = связи
der Verlust = the loss = потеря
Verluste = losses = потери
das Warenhaus = the department store = универмаг
Warenhäuser = department stores = универмаги
die Warnung vor = the warning against = предупреждение о
Warnungen = warnings = предупреждения
der Wunsch = the wish = желание
Wünsche = wishes = желания
der Zug = the train = поезд
Züge = trains = поезда
allein = alone = один(а); одиноко
außerdem = besides; furthermore = кроме того
zu begeistern = to inspire; to enthuse = вдохновлять
er begeistert = he inspires = он вдохновляет
ich habe viele Menschen begeistert = I have inspired many people = я вдохновил много людей
ich begeisterte die Menschen = I inspired the people = я вдохновлял людей
zu beherrschen = to master; to control = владеть; контролировать
er beherrscht = he masters = он владеет
ich habe die Sprache beherrscht = I have mastered the language = я владел языком
ich beherrschte die Sprache = I mastered the language = я владел языком
zu berichten über = to report about = сообщать о
er berichtet über das Ereignis = he reports about the event = он сообщает о событии
ich habe über das Ereignis berichtet = I have reported about the event = я сообщил о событии
ich berichtete über das Ereignis = I reported about the event = я сообщал о событии
zu berichten von = to report from; about = рассказывать о
er berichtet von der Reise = he reports about the trip = он рассказывает о путешествии
ich habe von der Reise berichtet = I have reported about the trip = я рассказал о путешествии
ich berichtete von der Reise = I reported about the trip = я рассказывал о путешествии
zu berücksichtigen = to consider = учитывать
er berücksichtigt = he considers = он учитывает
ich habe das berücksichtigt = I have considered that = я учёл это
ich berücksichtigte das = I considered that = я учитывал это
bevor = before = до того как
zu bezahlen = to pay = платить
er bezahlt = he pays = он платит
ich habe die Rechnung bezahlt = I have paid the bill = я оплатил счёт
ich bezahlte die Rechnung = I paid the bill = я платил счёт
christlich = Christian = христианский
zu danken = to thank = благодарить
er dankt = he thanks = он благодарит
ich habe dem Mann gedankt = I have thanked the man = я поблагодарил мужчину
ich dankte dem Mann = I thanked the man = я благодарил мужчину
davor = before that; in front of that = до этого; перед этим
deutlich = clear; distinct = ясный; отчётливый
dritte = third = третий
zu drücken = to press; to push = нажимать; толкать
er drückt = he presses = он нажимает
ich habe den Knopf gedrückt = I have pressed the button = я нажал кнопку
ich drückte den Knopf = I pressed the button = я нажимал кнопку
zu durchführen = to carry out; to execute = выполнять
er führt das Projekt durch = he carries out the project = он выполняет проект
ich habe das Projekt durchgeführt = I have carried out the project = я выполнил проект
ich führte das Projekt durch = I carried out the project = я выполнял проект
eher = rather; sooner = скорее; раньше
zu erfahren = to learn; to find out = узнавать
er erfährt = he learns = он узнаёт
ich habe die Wahrheit erfahren = I have learned the truth = я узнал правду
ich erfuhr die Wahrheit = I learned the truth = я узнал правду
zu ergeben = to result in; to yield = приводить к
es ergibt = it results = это приводит к
es hat das Ergebnis ergeben = it has yielded the result = это дало результат
es ergab = it resulted = это привело к
zu erklären = to explain = объяснять
er erklärt = he explains = он объясняет
ich habe das erklärt = I have explained that = я объяснил это
ich erklärte das = I explained that = я объяснял это
zu erwarten = to expect = ожидать
er erwartet = he expects = он ожидает
ich habe eine Antwort erwartet = I have expected an answer = я ожидал ответа
ich erwartete eine Antwort = I expected an answer = я ожидал ответа
fertig mit dem Projekt = finished with the project = законченный с проектом
freundlich = friendly; kind = дружелюбный; приятный
geehrt = honored = удостоенный
halb = half = половина; половинный
sich interessieren für = to be interested in = интересоваться
er interessiert sich für Musik = he is interested in music = он интересуется музыкой
ich habe mich für Musik interessiert = I have been interested in music = я интересовался музыкой
ich interessierte mich für Musik = I was interested in music = я интересовался музыкой
kaputt = broken = сломанный
zu kosten = to cost = стоить
es kostet = it costs = это стоит
es hat 10 Euro gekostet = it cost 10 euros = это стоило 10 евро
es kostete 10 Euro = it cost 10 euros = это стоило 10 евро
kulturell = cultural = культурный
zu leiden an = to suffer from (disease) = страдать от (болезни)
er leidet an der Krankheit = he suffers from the illness = он страдает от болезни
ich habe an der Krankheit gelitten = I have suffered from the illness = я страдал от болезни
ich litt an der Krankheit = I suffered from the illness = я страдал от болезни
zu leiden unter = to suffer from (circumstances) = страдать от (обстоятельств)
er leidet unter dem Lärm = he suffers from the noise = он страдает от шума
ich habe unter dem Lärm gelitten = I have suffered from the noise = я страдал от шума
ich litt unter dem Lärm = I suffered from the noise = я страдал от шума
meistens = mostly; usually = обычно
morgens = in the mornings = по утрам
paar = couple; few = пара; несколько
zu planen = to plan = планировать
er plant = he plans = он планирует
ich habe das Projekt geplant = I have planned the project = я спланировал проект
ich plante das Projekt = I planned the project = я планировал проект
zu reden = to talk = говорить
er redet = he talks = он говорит
ich habe mit ihm geredet = I have talked with him = я говорил с ним
ich redete mit ihm = I talked with him = я говорил с ним
reich an = rich in = богатый на
reicher = richer = богаче
am reichsten = richest = самый богатый
zu reisen = to travel = путешествовать
er reist = he travels = он путешествует
ich bin viel gereist = I have traveled a lot = я много путешествовал
ich reiste viel = I traveled a lot = я много путешествовал
rot = red = красный
zu scheinen = to shine; to seem = светить; казаться
es scheint = it shines; seems = светит; кажется
es hat geschienen = it has shined = светило
es schien = it shined; seemed = светило; казалось
zu schenken = to give (as a gift) = дарить
er schenkt = he gives = он дарит
ich habe ihr Blumen geschenkt = I have given her flowers = я подарил ей цветы
ich schenkte ihr Blumen = I gave her flowers = я дарил ей цветы
zu schlafen = to sleep = спать
er schläft = he sleeps = он спит
ich habe gut geschlafen = I have slept well = я хорошо спал
ich schlief gut = I slept well = я спал хорошо
zu singen = to sing = петь
er singt = he sings = он поёт
ich habe laut gesungen = I have sung loudly = я пел громко
ich sang laut = I sang loudly = я пел громко
zu spazieren = to walk; stroll = гулять
er spaziert = he walks = он гуляет
ich bin im Park spaziert = I have walked in the park = я гулял в парке
ich spazierte im Park = I walked in the park = я гулял в парке
stark = strong = сильный
stärker = stronger = сильнее
am stärksten = strongest = самый сильный
stolz auf = proud of = гордый за
er ist stolz auf seinen Erfolg = he is proud of his success = он гордится своим успехом
teuer = expensive = дорогой
teurer = more expensive = дороже
am teuersten = most expensive = самый дорогой
typisch = typical = типичный
unbedingt = absolutely; necessarily = обязательно
zu unterrichten in = to teach in = преподавать в
er unterrichtet in der Schule = he teaches at the school = он преподаёт в школе
ich habe in der Schule unterrichtet = I have taught at the school = я преподавал в школе
ich unterrichtete in der Schule = I taught at the school = я преподавал в школе
zu unterrichten von = to teach about = преподавать о
er unterrichtet von Grammatik = he teaches about grammar = он рассказывает о грамматике
ich habe von Grammatik unterrichtet = I have taught about grammar = я преподавал о грамматике
ich unterrichtete von Grammatik = I taught about grammar = я преподавал о грамматике
unterstrichen = underlined = подчеркнутый
zu versprechen = to promise = обещать
er verspricht = he promises = он обещает
ich habe das versprochen = I have promised that = я обещал это
ich versprach das = I promised that = я обещал это
vorbei = past; over = мимо; прошло
warm = warm = тёплый
wärmer = warmer = теплее
am wärmsten = warmest = самый тёплый
weiß = white; know (context) = белый; знать
wen = whom (accusative) = кого
zu wünschen = to wish = желать
er wünscht = he wishes = он желает
ich habe dir Glück gewünscht = I have wished you luck = я пожелал тебе удачи
ich wünschte dir Glück = I wished you luck = я желал тебе удачи
übrig = left over; remaining = оставшийся; лишний
das Aktiv = the active voice = активный залог
Aktive = active voices = активные залоги
das Amt = the office; agency = должность; ведомство
Ämter = offices; agencies = должности; ведомства
die App = the app = приложение
Apps = apps = приложения
der Arbeitgeber = the employer = работодатель
Arbeitgeber = employers = работодатели
der Architekt = the architect = архитектор
Architekten = architects = архитекторы
die Armut = the poverty = бедность
die Art = the kind; type = вид; тип
Arten = kinds; types = виды
die Auffassung = the opinion; view = мнение; взгляд
Auffassungen = opinions; views = мнения
die Auskunft = the information = справка; информация
Auskünfte = informations; references = справки; сведения
das Ausland = the foreign countries = заграница
Ausländer = foreigners = иностранцы
das Baby = the baby = младенец
Babys = babies = младенцы
der Ball = the ball = мяч
Bälle = balls = мячи
die Bank = the bench; bank = скамейка; банк
Bänke = benches = скамейки
der Beginn = the beginning = начало
Beginne = beginnings (rare plural) = начала
die Beispielprüfung = the sample exam = пример экзамена
Beispielprüfungen = sample exams = примеры экзаменов
der Besucher = the visitor = посетитель
Besucher = visitors = посетители
die Bevölkerung = the population = население
Bevölkerungen = populations = населения
der Brief = the letter = письмо
Briefe = letters = письма
die Chemie = the chemistry = химия
Chemien = chemistries = химии
der Club = the club = клуб
Clubs = clubs = клубы
die Diät = the diet = диета
Diäten = diets = диеты
der Einsteiger = the beginner = начинающий
Einsteiger = beginners = начинающие
der Elefant = the elephant = слон
Elefanten = elephants = слоны
das Ergebnis = the result = результат
Ergebnisse = results = результаты
das Erlebnis = the experience = переживание
Erlebnisse = experiences = переживания
die Erziehung = the upbringing; education = воспитание
Erziehungen = upbringings; educations = воспитания
das Fahrzeug = the vehicle = транспортное средство
Fahrzeuge = vehicles = транспортные средства
das Fleisch = the meat = мясо
Fleischer = butchers = мясники
die Folge = the consequence; episode = следствие; серия
Folgen = consequences; episodes = последствия; серии
die Freizeit = the free time = свободное время
Freizeiten = free times = свободные времена
die Fußprobleme = foot problems = проблемы с ногами
das Gemüse = the vegetable = овощ
Gemüse = vegetables = овощи
der Geschmack nach = the taste of = вкус чего-либо
Geschmäcker = tastes = вкусы
die Gitarre = the guitar = гитара
Gitarren = guitars = гитары
das Glück = the luck; happiness = удача; счастье
griechisch = Greek = греческий
das Gymnasium = the high school = гимназия
Gymnasien = high schools = гимназии
die Hand = the hand = рука
Hände = hands = руки
die Handlung = the plot; action = сюжет; действие
Handlungen = plots; actions = сюжеты; действия
das Handy = the mobile phone = мобильный телефон
Handys = mobile phones = мобильные телефоны
das Heimatland = the homeland = родина
Heimatländer = homelands = родины
die Heirat = the marriage = брак
Heiraten = marriages = браки
das Herz = the heart = сердце
Herzen = hearts = сердца
die Hose = the trousers = брюки
Hosen = trousers = брюки
die Impfung = the vaccination = вакцинация
Impfungen = vaccinations = вакцинации
Indien = India = Индия
die Insel = the island = остров
Inseln = islands = острова
die Intuition = the intuition = интуиция
Intuitionen = intuitions = интуиции
Italien = Italy = Италия
die Jahreszeit = the season = время года
Jahreszeiten = seasons = времена года
das Jahrhundert = the century = век
Jahrhunderte = centuries = века
das Kasussymbol = the case symbol = падежный знак
Kasussymbole = case symbols = падежные знаки
die Konjunktur = the economic situation = конъюнктура
Konjunkturen = economic situations = конъюнктуры
das Konzert = the concert = концерт
Konzerte = concerts = концерты
der Kopf = the head = голова
Köpfe = heads = головы
das Korrelat = the correlate = коррелят
Korrelate = correlates = корреляты
die Krankheit = the illness = болезнь
Krankheiten = illnesses = болезни
Köln = Cologne = Кёльн
das Können = the ability = умение
der Liebeskummer = the lovesickness = любовная тоска
die Luft = the air = воздух
Lüfte = airs = воздуха (редко во множественном)
die Lust auf = the desire for = желание чего-либо
Lüste = desires = желания
der Mai = May = май
die Maschine = the machine = машина
Maschinen = machines = машины
der Meter = the meter = метр
Meter = meters = метры
der Mitarbeiter = the employee = сотрудник
Mitarbeiter = employees = сотрудники
die Mutter = the mother = мать
Mütter = mothers = матери
die Nacht = the night = ночь
Nächte = nights = ночи
das Nomen = the noun = существительное
Nomen = nouns = существительные
die Not = the distress = нужда; бедствие
Nöte = distresses = нужды; бедствия
die Note = the grade; note = оценка; нота
Noten = grades; notes = оценки; ноты
die Notiz = the note = заметка
Notizen = notes = заметки
der Nullartikel = the zero article = нулевой артикль
Nullartikel = zero articles = нулевые артикли
die Ortsangabe = the location indication = указание места
Ortsangaben = location indications = указания места
das Parlament = the parliament = парламент
Parlamente = parliaments = парламенты
die Pause = the break = перерыв
Pausen = breaks = перерывы
der Plan = the plan = план
Pläne = plans = планы
der Platz = the place; square = место; площадь
Plätze = places; squares = места; площади
der Punkt = the point = точка
Punkte = points = точки
die Redemittel = the speech means = речевые средства
die Regenbogenpresse = the tabloid press = желтая пресса
die Richtung = the direction = направление
Richtungen = directions = направления
der Schweizer = the Swiss person = швейцарец
Schweizer = Swiss people = швейцарцы
die Schwester = the sister = сестра
Schwestern = sisters = сёстры
der See = the lake; sea = озеро; море
Seen = lakes = озёра
die Sehenswürdigkeit = the sightseeing attraction = достопримечательность
Sehenswürdigkeiten = sightseeing attractions = достопримечательности
das Sein = the being = бытие
der Sommer = the summer = лето
Sommer = summers = лета
der Sonntag = the Sunday = воскресенье
Sonntage = Sundays = воскресенья
das Spiel = the game = игра
Spiele = games = игры
der Stadtpark = the city park = городской парк
Stadtparks = city parks = городские парки
die Stimme = the voice = голос
Stimmen = voices = голоса
die Suche nach = the search for = поиск чего-либо
Suchen = searches = поиски
die Tastatur = the keyboard = клавиатура
Tastaturen = keyboards = клавиатуры
die Tollwut = the rabies = бешенство
der Unsinn = the nonsense = ерунда
der Unterricht = the lesson; teaching = урок; преподавание
Unterrichte = lessons; teachings = уроки; преподавания
die Vermutung = the assumption = предположение
Vermutungen = assumptions = предположения
das Verständnis für = the understanding of = понимание чего-либо
Verständnisse = understandings = понимания
das Wasser = the water = вода
der Winter = the winter = зима
Winter = winters = зимы
die Wirtschaft = the economy; business = экономика; хозяйство
Wirtschaften = economies; businesses = экономики; хозяйства
der Zustand = the condition; state = состояние
Zustände = conditions; states = состояния
zu abhalten = to hold (an event) = проводить
er hält die Sitzung ab = he holds the meeting = он проводит собрание
ich habe die Sitzung abgehalten = I have held the meeting = я провёл собрание
ich hielt die Sitzung ab = I held the meeting = я проводил собрание
ach; achso = oh; I see = ах; понятно
zu anfangen mit = to start with = начинать с
er fängt mit der Arbeit an = he starts with the work = он начинает работу
ich habe mit der Arbeit angefangen = I have started the work = я начал работу
ich fing mit der Arbeit an = I started the work = я начал работу
angenehm für = pleasant for = приятный для
ankommen = to arrive = прибывать
er kommt an = he arrives = он прибывает
ich bin angekommen = I have arrived = я прибыл
ich kam an = I arrived = я прибыл
ankommen auf = to depend on = зависеть от
es kommt auf die Situation an = it depends on the situation = это зависит от ситуации
es ist angekommen = it has depended = это зависело
es kam an = it depended = это зависело
anlässlich = on the occasion of = по случаю
zu anrufen bei = to call at (someone's place) = звонить кому-либо
er ruft bei dem Arzt an = he calls the doctor = он звонит врачу
ich habe bei dem Arzt angerufen = I have called the doctor = я звонил врачу
ich rief bei dem Arzt an = I called the doctor = я звонил врачу
zu ansehen = to look at = смотреть
er sieht das Bild an = he looks at the picture = он смотрит на картину
ich habe das Bild angesehen = I have looked at the picture = я посмотрел на картину
ich sah das Bild an = I looked at the picture = я смотрел на картину
zu antworten auf mit = to answer to with = отвечать на что-то с чем-то
er antwortet auf die Frage mit der Lösung = he answers the question with the solution = он отвечает на вопрос решением
ich habe auf die Frage mit der Lösung geantwortet = I have answered the question with the solution = я ответил на вопрос решением
ich antwortete auf die Frage mit der Lösung = I answered the question with the solution = я отвечал на вопрос решением
aufgrund = due to; based on = из-за; на основании
zu ausbilden = to train = обучать
er bildet aus = he trains = он обучает
ich habe viele Fachkräfte ausgebildet = I have trained many specialists = я подготовил многих специалистов
ich bildete Fachkräfte aus = I trained specialists = я обучал специалистов
zu aussehen = to look like = выглядеть
er sieht müde aus = he looks tired = он выглядит усталым
ich habe gut ausgesehen = I have looked good = я хорошо выглядел
ich sah gut aus = I looked good = я выглядел хорошо
zu bedanken bei dem Mann für das Geschenk = to thank the man for the gift = благодарить мужчину за подарок
er bedankt sich bei dem Mann für das Geschenk = he thanks the man for the gift = он благодарит мужчину за подарок
ich habe mich bei dem Mann für das Geschenk bedankt = I have thanked the man for the gift = я поблагодарил мужчину за подарок
ich bedankte mich bei dem Mann für das Geschenk = I thanked the man for the gift = я благодарил мужчину за подарок
zu beenden = to finish = заканчивать
er beendet = he finishes = он заканчивает
ich habe das Projekt beendet = I have finished the project = я закончил проект
ich beendete das Projekt = I finished the project = я закончил проект
bereit zu dem Gespräch = ready for the conversation = готов к разговору
zu beschweren bei dem Chef über die Arbeit = to complain to the boss about the work = жаловаться начальнику на работу
er beschwert sich bei dem Chef über die Arbeit = he complains to the boss about the work = он жалуется начальнику на работу
ich habe mich bei dem Chef über die Arbeit beschwert = I have complained to the boss about the work = я пожаловался начальнику на работу
ich beschwerte mich bei dem Chef über die Arbeit = I complained to the boss about the work = я жаловался начальнику на работу
zu bestätigen = to confirm = подтверждать
er bestätigt = he confirms = он подтверждает
ich habe die Reservierung bestätigt = I have confirmed the reservation = я подтвердил бронь
ich bestätigte die Reservierung = I confirmed the reservation = я подтвердил бронь
zu beteiligen = to participate = участвовать
er beteiligt sich = he participates = он участвует
ich habe mich an dem Projekt beteiligt = I have participated in the project = я участвовал в проекте
ich beteiligte mich an dem Projekt = I participated in the project = я участвовал в проекте
sich bewegen = to move = двигаться
er bewegt sich = he moves = он двигается
ich habe mich viel bewegt = I have moved a lot = я много двигался
ich bewegte mich viel = I moved a lot = я много двигался
bewusst = conscious; aware = осознанный; сознательный
bezüglich des Themas = regarding the topic = относительно темы
danach = after that = после этого
je mehr, desto besser = the more, the better = чем больше, тем лучше
deswegen = therefore = поэтому
direkt = direct(ly) = прямой; напрямую
zu drehen = to turn = поворачивать
er dreht = he turns = он поворачивает
ich habe mich umgedreht = I have turned around = я повернулся
ich drehte mich um = I turned around = я повернулся
zu enthalten = to contain = содержать
es enthält = it contains = оно содержит
es hat viele Vitamine enthalten = it has contained many vitamins = оно содержало много витаминов
es enthielt viele Vitamine = it contained many vitamins = оно содержало много витаминов
entlang der Straße = along the street = вдоль улицы
zu enttäuschen = to disappoint = разочаровывать
er enttäuscht = he disappoints = он разочаровывает
ich habe ihn enttäuscht = I have disappointed him = я его разочаровал
ich enttäuschte ihn = I disappointed him = я разочаровал его
zu erledigen = to complete = выполнять
er erledigt = he completes = он выполняет
ich habe die Aufgabe erledigt = I have completed the task = я выполнил задание
ich erledigte die Aufgabe = I completed the task = я выполнил задание
zu erreichen = to reach = достигать
er erreicht = he reaches = он достигает
ich habe das Ziel erreicht = I have reached the goal = я достиг цели
ich erreichte das Ziel = I reached the goal = я достиг цели
zu erzielen = to achieve = достигать
er erzielt = he achieves = он достигает
ich habe einen Gewinn erzielt = I have achieved a profit = я получил прибыль
ich erzielte einen Gewinn = I achieved a profit = я получил прибыль
europäisch = European = европейский
fehlend = missing = отсутствующий
zu feiern = to celebrate = праздновать
er feiert = he celebrates = он празднует
ich habe meinen Geburtstag gefeiert = I have celebrated my birthday = я отпраздновал свой день рождения
ich feierte meinen Geburtstag = I celebrated my birthday = я праздновал свой день рождения
zu fordern = to demand = требовать
er fordert = he demands = он требует
ich habe Gerechtigkeit gefordert = I have demanded justice = я требовал справедливости
ich forderte Gerechtigkeit = I demanded justice = я требовал справедливости
französisch = French = французский
frisch = fresh = свежий
frischer = fresher = свежее
am frischesten = freshest = самый свежий
fähig zu der Aufgabe = capable of the task = способный к заданию
gern(e) = gladly = охотно
gültig = valid = действительный
günstig = cheap; favorable = выгодный; дешёвый
günstiger = cheaper; more favorable = более выгодный
am günstigsten = cheapest; most favorable = самый выгодный
halt = just; simply (colloquial) = просто
zu heiraten = to marry = жениться; выходить замуж
er heiratet = he marries = он женится
ich habe sie geheiratet = I have married her = я женился на ней
ich heiratete sie = I married her = я женился на ней
insgesamt = overall; in total = всего; в целом
international = international = международный
die Jugendlichen = the youth = молодёжь
zu klingeln = to ring (bell) = звенеть
es klingelt = it rings = звонит
ich habe die Tür geglockt = I have rung the doorbell = я звонил в дверь
ich klingelte = I rang = я звонил
kostenlos = free of charge = бесплатно
zu kümmern um = to take care of = заботиться о
er kümmert sich um das Kind = he takes care of the child = он заботится о ребёнке
ich habe mich um das Kind gekümmert = I have taken care of the child = я заботился о ребёнке
ich kümmerte mich um das Kind = I took care of the child = я заботился о ребёнке
zu langweilen = to bore = надоедать
er langweilt sich = he is bored = ему скучно
ich habe mich gelangweilt = I have been bored = мне было скучно
ich langweilte mich = I was bored = мне было скучно
leicht = easy; light = лёгкий
leichter = easier; lighter = легче
am leichtesten = easiest; lightest = самый лёгкий
zu lenken = to steer; to direct = управлять
er lenkt = he steers = он управляет
ich habe das Auto gelenkt = I have driven the car = я водил машину
ich lenkte das Auto = I drove the car = я водил машину
los = off; away; loose = вон; свободный
mindestens = at least = по крайней мере
zu mitteilen = to inform = сообщать
er teilt mit = he informs = он сообщает
ich habe die Nachricht mitgeteilt = I have communicated the message = я сообщил новость
ich teilte die Nachricht mit = I communicated the message = я сообщил новость
neugierig auf das Ergebnis = curious about the result = любопытный к результату
nun = now = теперь
zu reagieren auf = to react to = реагировать на
er reagiert auf die Frage = he reacts to the question = он реагирует на вопрос
ich habe darauf reagiert = I have reacted to that = я на это отреагировал
ich reagierte darauf = I reacted to that = я реагировал на это
zu renovieren = to renovate = ремонтировать
er renoviert = he renovates = он ремонтирует
ich habe die Wohnung renoviert = I have renovated the apartment = я отремонтировал квартиру
ich renovierte die Wohnung = I renovated the apartment = я ремонтировал квартиру
sauer = sour = кислый
sauer auf den Mann = angry at the man = сердит на мужчину
zu schaffen = to manage; to create = справляться; создавать
er schafft = he manages = он справляется
ich habe die Aufgabe geschafft = I have managed the task = я справился с заданием
ich schaffte die Aufgabe = I managed the task = я справился с заданием
schmecken nach dem Essen = to taste of the food = иметь вкус еды
es schmeckt nach dem Essen = it tastes of the food = оно на вкус как еда
ich habe das geschmeckt = I have tasted that = я попробовал это
ich schmeckte das = I tasted that = я пробовал это
zu schreien = to shout = кричать
er schreit = he shouts = он кричит
ich habe laut geschrien = I have shouted loudly = я громко кричал
ich schrie laut = I shouted loudly = я кричал громко
schriftlich = written = письменный
seitdem = since then = с тех пор
selten = rare; seldom = редко
sowohl … als auch … = both … and … = как … так и …
nicht nur …, sondern auch … = not only … but also … = не только …, но и …
zu sperren = to block = блокировать
er sperrt = he blocks = он блокирует
ich habe die Straße gesperrt = I have blocked the street = я заблокировал улицу
ich sperrte die Straße = I blocked the street = я блокировал улицу
stattfinden = to take place = происходить
es findet statt = it takes place = это происходит
es hat stattgefunden = it has taken place = это произошло
es fand statt = it took place = это происходило
zu treten = to step; to kick = ступать; пинать
er tritt = he steps; kicks = он ступает; пинает
ich bin auf den Boden getreten = I have stepped on the floor = я наступил на пол
ich trat auf den Boden = I stepped on the floor = я наступил на пол
zu träumen von = to dream of = мечтать о
er träumt von der Reise = he dreams of the trip = он мечтает о путешествии
ich habe von der Reise geträumt = I have dreamed of the trip = я мечтал о путешествии
ich träumte von der Reise = I dreamed of the trip = я мечтал о путешествии
täglich = daily = ежедневно
unbekannt = unknown = неизвестный
zu verkaufen = to sell = продавать
er verkauft = he sells = он продает
ich habe das Auto verkauft = I have sold the car = я продал машину
ich verkaufte das Auto = I sold the car = я продал машину
sich verlieben in den Mann = to fall in love with the man = влюбиться в мужчину
er verliebt sich in den Mann = he falls in love with the man = он влюбляется в мужчину
ich habe mich in den Mann verliebt = I have fallen in love with the man = я влюбился в мужчину
ich verliebte mich in den Mann = I fell in love with the man = я влюблялся в мужчину
vermutlich = probably = вероятно
zu versuchen = to try = пытаться
er versucht = he tries = он пытается
ich habe es versucht = I have tried it = я попытался
ich versuchte es = I tried it = я пытался
zu verweisen = to refer = направлять; ссылаться
er verweist = he refers = он направляет
ich habe ihn darauf verwiesen = I have referred him to it = я ссылался на это
ich verwies ihn darauf = I referred him to it = я ссылался на это
zu verzichten = to renounce; to give up = отказываться
er verzichtet = he gives up = он отказывается
ich habe darauf verzichtet = I have given up on that = я отказался от этого
ich verzichtete darauf = I gave up on that = я отказался от этого
zu verändern = to change = изменять
er verändert = he changes = он меняет
ich habe das verändert = I have changed that = я изменил это
ich veränderte das = I changed that = я изменял это
vorgegeben = predetermined; prescribed = заданный
wofür = for what = для чего
wütend auf den Mann = angry at the man = злой на мужчину
zu zustimmen = to agree = соглашаться
er stimmt zu = he agrees = он соглашается
ich habe dem Vorschlag zugestimmt = I have agreed to the proposal = я согласился с предложением
ich stimmte dem Vorschlag zu = I agreed to the proposal = я согласился с предложением
die Überraschung = the surprise = сюрприз
Überraschungen = surprises = сюрпризы
das Übungsbuch = the exercise book = учебное пособие
Übungsbücher = exercise books = учебные пособия
ähnlich = similar = похожий
zu überlegen = to consider; to think over = обдумывать
er überlegt = he considers = он обдумывает
ich habe das überlegt = I have considered that = я обдумал это
ich überlegte das = I considered that = я обдумывал это
zu überreichen = to hand over = вручать
er reicht das Geschenk über = he hands over the gift = он вручает подарок
ich habe das Geschenk überreicht = I have handed over the gift = я вручил подарок
ich reichte das Geschenk über = I handed over the gift = я вручал подарок
der Actionfilm = the action movie = боевик
Actionfilme = action movies = боевики
die Adverbien = the adverbs = наречия
das Afrika = Africa = Африка
die Ampel = the traffic light = светофор
Ampeln = traffic lights = светофоры
der Arbeitstag = the working day = рабочий день
Arbeitstage = working days = рабочие дни
die Aufforderung = the request; call = призыв; требование
Aufforderungen = requests; calls = призывы; требования
der Ausflug = the excursion = экскурсия
Ausflüge = excursions = экскурсии
der Autor = the author = автор
Autoren = authors = авторы
die Bahnhofstraße = the station street = улица вокзала
Bahnhofstraßen = station streets = улицы вокзала
der Baum = the tree = дерево
Bäume = trees = деревья
der Bayer = the Bavarian = баварец
Bayer = Bavarians = баварцы
der Belang = the concern; interest = значение; интерес
Belange = concerns; interests = значения; интересы
der Bereich = the area; field = область; сфера
Bereiche = areas; fields = области; сферы
der Berufsverkehr = the rush hour = час пик
die Beschreibung = the description = описание
Beschreibungen = descriptions = описания
der Betreff = the subject (email) = тема (письма)
Betreffe = subjects = темы
der Bezug auf = the reference to = ссылка на
Bezüge = references = ссылки
das Bioprodukt = the organic product = биопродукт
Bioprodukte = organic products = биопродукты
die Bitte um = the request for = просьба о
Bitten = requests = просьбы
der Blumenstrauß = the bouquet = букет цветов
Blumensträuße = bouquets = букеты
der Blödsinn = the nonsense = чепуха
der Bus = the bus = автобус
Busse = buses = автобусы
der Cent = the cent = цент
Cents = cents = центы
das Computerspiel = the computer game = компьютерная игра
Computerspiele = computer games = компьютерные игры
die Datei = the file = файл
Dateien = files = файлы
das Datum = the date = дата
Daten = dates; data = даты; данные
der Deckel = the lid; cover = крышка
Deckel = lids; covers = крышки
der Dialog = the dialogue = диалог
Dialoge = dialogues = диалоги
die Diskussion = the discussion = обсуждение
Diskussionen = discussions = обсуждения
der Druck = the pressure; print = давление; печать
Drücke = pressures; prints = давления; отпечатки
die Ehe = the marriage = брак
Ehen = marriages = браки
das Ei = the egg = яйцо
Eier = eggs = яйца
zu einladen zu der Party = to invite to the party = приглашать на вечеринку
er lädt zu der Party ein = he invites to the party = он приглашает на вечеринку
ich habe zu der Party eingeladen = I have invited to the party = я пригласил на вечеринку
ich lud zu der Party ein = I invited to the party = я приглашал на вечеринку
die Einzelheit = the detail = подробность
Einzelheiten = details = подробности
englisch = English = английский
die Entspannung = the relaxation = расслабление
Entspannungen = relaxations = расслабления
das Erbe = the inheritance; heritage = наследство; наследие
Erben = heirs = наследники
die Erklärung = the explanation = объяснение
Erklärungen = explanations = объяснения
der Ernst = the seriousness = серьёзность
der Experte = the expert = эксперт
Experten = experts = эксперты
extra = extra = дополнительно
feminin = feminine = женский род
das Ferienziel = the holiday destination = место отдыха
Ferienziele = holiday destinations = места отдыха
der Flohmarkt = the flea market = блошиный рынок
Flohmärkte = flea markets = блошиные рынки
die Forderung = the demand = требование
Forderungen = demands = требования
das Foto = the photo = фотография
Fotos = photos = фотографии
Frankfurt = Frankfurt = Франкфурт
das Freizeitverhalten = the leisure behavior = поведение в свободное время
der Frieden = the peace = мир
der Frühling = the spring = весна
Frühlinge = springs = весны
die Fähigkeit = the ability = способность
Fähigkeiten = abilities = способности
das Gas = the gas = газ
Gase = gases = газы
die Gefahr = the danger = опасность
Gefahren = dangers = опасности
das Gehalt = the salary = зарплата
Gehälter = salaries = зарплаты
das Geräusch = the noise = шум
Geräusche = noises = шумы
das Geschirr = the dishes = посуда
Geschirre = dish sets = наборы посуды
das Geschäft = the business; shop = бизнес; магазин
Geschäfte = businesses; shops = бизнесы; магазины
das Getränk = the drink = напиток
Getränke = drinks = напитки
die Grundschule = the primary school = начальная школа
Grundschulen = primary schools = начальные школы
die Gruppe = the group = группа
Gruppen = groups = группы
die Hauptaussage = the main statement = главное утверждение
Hauptaussagen = main statements = главные утверждения
die Hochzeit = the wedding = свадьба
Hochzeiten = weddings = свадьбы
die Hotline = the hotline = горячая линия
Hotlines = hotlines = горячие линии
der Inhalt = the content = содержание
Inhalte = contents = содержания
die Institution = the institution = учреждение
Institutionen = institutions = учреждения
italienisch = Italian = итальянский
jemand = someone = кто-то
der Junge = the boy = мальчик
Jungen = boys = мальчики
der Juniorchef = the junior boss = младший начальник
Juniorchefs = junior bosses = младшие начальники
der Kindergarten = the kindergarten = детский сад
Kindergärten = kindergartens = детские сады
das Kleid = the dress = платье
Kleider = dresses = платья
das Kleinkind = the toddler = малыш
Kleinkinder = toddlers = малыши
die Kleinstadt = the small town = маленький город
Kleinstädte = small towns = маленькие города
die Komposita = the compound words = составные слова
die Konjunktion = the conjunction = союз
Konjunktionen = conjunctions = союзы
der Kontakt = the contact = контакт
Kontakte = contacts = контакты
die Krise = the crisis = кризис
Krisen = crises = кризисы
der Käse = the cheese = сыр
der Körper = the body = тело
Körper = bodies = тела
der Künstler = the artist = художник
Künstler = artists = художники
der Laden = the shop = магазин
Läden = shops = магазины
die Laune = the mood = настроение
Launen = moods = настроения
die Leistung = the performance; achievement = производительность; достижение
Leistungen = performances; achievements = производительности; достижения
der Lernerfolg = the learning success = успех в обучении
Lernerfolge = learning successes = успехи в обучении
das Licht = the light = свет
Lichter = lights = огни
das Lied = the song = песня
Lieder = songs = песни
die Medizin = the medicine = медицина; лекарство
Medizinen = medicines = лекарства
der Meinungsmacher = the opinion maker = формирователь мнения
Meinungsmacher = opinion makers = формирователи мнений
der Meister = the master = мастер
Meister = masters = мастера
das Milchprodukt = the dairy product = молочный продукт
Milchprodukte = dairy products = молочные продукты
das Mitglied = the member = член
Mitglieder = members = члены
das Mittel = the means; remedy = средство
Mittel = means; remedies = средства
der Mittwoch = Wednesday = среда
Mittwoche = Wednesdays = среды
das Modalwort = the modal word = модальное слово
Modalwörter = modal words = модальные слова
der Moment = the moment = момент
Momente = moments = моменты
das Motiv = the motive = мотив
Motive = motives = мотивы
der Mut = the courage = мужество
das Mädchen = the girl = девочка
Mädchen = girls = девочки
das Nachtleben = the nightlife = ночная жизнь
der Nobelpreis = the Nobel Prize = Нобелевская премия
Nobelpreise = Nobel Prizes = Нобелевские премии
die Oma = the grandma = бабушка
Omas = grandmas = бабушки
der Pfeffer = the pepper = перец
die Politik = the politics = политика
Politiken = policies = политики
der Polizist = the policeman = полицейский
Polizisten = policemen = полицейские
polnisch = Polish = польский
der Postman = the postman = почтальон
Postmen = postmen = почтальоны
das Prinzip = the principle = принцип
Prinzipien = principles = принципы
das Präsens = the present tense = настоящее время
Präsen (note: plural rare or typo, keeping as given) = present tenses = настоящие времена
die Präsentation = the presentation = презентация
Präsentationen = presentations = презентации
der Prüfer = the examiner = экзаменатор
Prüfer = examiners = экзаменаторы
der Prüfungspartner = the exam partner = партнёр по экзамену
Prüfungspartner = exam partners = партнёры по экзамену
die Prüfungsteile = the exam parts = части экзамена
das Radio = the radio = радио
Radios = radios = радиоприёмники
der Ratschlag = the advice = совет
Ratschläge = advices = советы
der Raum = the room = комната
Räume = rooms = комнаты
die Reaktion auf = the reaction to = реакция на
Reaktionen = reactions = реакции
das Regal = the shelf = полка
Regale = shelves = полки
die Reparatur = the repair = ремонт
Reparaturen = repairs = ремонты
der Ring = the ring = кольцо
Ringe = rings = кольца
der Rollstuhl = the wheelchair = инвалидная коляска
Rollstühle = wheelchairs = инвалидные коляски
das Rad = the wheel = колесо
Räder = wheels = колёса
der Schaden = the damage = ущерб
Schäden = damages = повреждения
der Schneider = the tailor = портной
Schneider = tailors = портные
die Schuld = the guilt; debt = вина; долг
Schulden = debts = долги
die Schwierigkeit = the difficulty = трудность
Schwierigkeiten = difficulties = трудности
der Schal = the scarf = шарф
Schals = scarves = шарфы
der Silvesterabend = New Year's Eve = канун Нового года
Silvesterabende = New Year's Eves = кануны Нового года
das Sportereignis = the sporting event = спортивное событие
Sportereignisse = sporting events = спортивные события
das Sprichwort = the proverb = пословица
Sprichwörter = proverbs = пословицы
die Strecke = the route; distance = расстояние; маршрут
Strecken = routes; distances = маршруты; расстояния
der Stress = the stress = стресс
Stresse = stresses = стрессы
die Subjunktion = the subordinating conjunction = подчинительный союз
Subjunktionen = subordinating conjunctions = подчинительные союзы
das Synonym = the synonym = синоним
Synonyme = synonyms = синонимы
der Süden = the south = юг
die Tat = the deed; act = действие; поступок
Taten = deeds; acts = действия; поступки
die Teilinformationen = the partial information = частичная информация
das Ticket = the ticket = билет
Tickets = tickets = билеты
das Training = the training = тренировка
Trainings = trainings = тренировки
der Traum = the dream = мечта; сон
Träume = dreams = мечты; сны
der Turm = the tower = башня
Türme = towers = башни
die Tätigkeit = the activity = деятельность
Tätigkeiten = activities = деятельности
die Türkei = Turkey = Турция
die Umgebung = the surroundings = окружение
Umgebungen = surroundings = окружения
der Umzug = the move; relocation = переезд
Umzüge = moves; relocations = переезды
unbestimmt = indefinite = неопределённый
die Unterstützung = the support = поддержка
Unterstützungen = supports = поддержки
die Verantwortung für = the responsibility for = ответственность за
Verantwortungen = responsibilities = ответственности
der Verbrauch = the consumption = потребление
Verbräuche = consumptions = потребления
der Verbraucher = the consumer = потребитель
Verbraucher = consumers = потребители
die Verfügung = the disposal; order = распоряжение; приказ
Verfügungen = disposals; orders = распоряжения; приказы
der Vergleich = the comparison = сравнение
Vergleiche = comparisons = сравнения
die Veränderung = the change = изменение
Veränderungen = changes = изменения
der Vogel = the bird = птица
Vögel = birds = птицы
die Vorwahlnummer = the area code = код города
Vorwahlnummern = area codes = коды городов
der Wagen = the car; wagon = машина; вагон
Wagen = cars; wagons = машины; вагоны
die Wahrscheinlichkeit = the probability = вероятность
Wahrscheinlichkeiten = probabilities = вероятности
die Wand = the wall = стена
Wände = walls = стены
warum = why = почему
der Weg = the way; path = путь
Wege = ways; paths = пути
die Weihnachten = Christmas = Рождество
der Weihnachtsmarkt = the Christmas market = рождественский рынок
Weihnachtsmärkte = Christmas markets = рождественские рынки
Wiesbaden = Wiesbaden = Висбаден
der Wille = the will = воля
Willen = wills = воли
woran = on what = на чем
die Wortart = the part of speech = часть речи
Wortarten = parts of speech = части речи
der Zeitungsartikel = the newspaper article = газетная статья
Zeitungsartikel = newspaper articles = газетные статьи
der Zuschauer = the spectator = зритель
Zuschauer = spectators = зрители
Zürich = Zurich = Цюрих
abends = in the evening = вечером
abhängig von = dependent on = зависимый от
alleine = alone = один
zu anfertigen = to produce; to make = изготавливать
er fertigt an = he produces = он изготавливает
ich habe das angefertigt = I have produced that = я изготовил это
ich fertigte das an = I produced that = я изготовлял это
angesichts = in view of = ввиду; учитывая
der Angestellte = the employee = служащий
Angestellten = employees = служащие
zu anhören = to listen to = слушать
er hört an = he listens to = он слушает
ich habe das angehört = I have listened to that = я слушал это
ich hörte das an = I listened to that = я слушал это
anscheinend = apparently = по-видимому
anstatt = instead of = вместо
ausreichend = sufficient = достаточный
zu auswählen = to select; to choose = выбирать
er wählt aus = he selects = он выбирает
ich habe das ausgewählt = I have selected that = я выбрал это
ich wählte das aus = I selected that = я выбирал это
zu beantworten = to answer = отвечать
er beantwortet = he answers = он отвечает
ich habe die Frage beantwortet = I have answered the question = я ответил на вопрос
ich beantwortete die Frage = I answered the question = я отвечал на вопрос
zu bedienen = to serve; to operate = обслуживать; пользоваться
er bedient = he serves; operates = он обслуживает; управляет
ich habe die Maschine bedient = I have operated the machine = я управлял машиной
ich bediente die Maschine = I operated the machine = я управлял машиной
bedingt = conditional; limited = условный; ограниченный
sich befinden = to be located = находиться
er befindet sich = he is located = он находится
ich habe mich dort befunden = I have been there = я находился там
ich befand mich dort = I was located there = я находился там
benachbart = neighboring = соседний
zu berechnen = to calculate = вычислять
er berechnet = he calculates = он вычисляет
ich habe das berechnet = I have calculated that = я вычислил это
ich berechnete das = I calculated that = я вычислял это
berühmt = famous = знаменитый
betragen = to amount to = составлять
er beträgt = it amounts to = это составляет
es hat 100 Euro betragen = it has amounted to 100 euros = это составляло 100 евро
es betrug = it amounted to = это составляло
sich bewerben bei um = to apply to (somebody) for (something) = подавать заявление
er bewirbt sich bei der Firma um die Stelle = he applies to the company for the job = он подаёт заявление в компанию на должность
ich habe mich bei der Firma um die Stelle beworben = I have applied to the company for the job = я подал заявление в компанию на должность
ich bewarb mich bei der Firma um die Stelle = I applied to the company for the job = я подавал заявление в компанию на должность
zu bezeichnen = to designate; to call = обозначать; называть
er bezeichnet = he designates = он обозначает
ich habe das bezeichnet = I have designated that = я обозначил это
ich bezeichnete das = I designated that = я обозначал это
bislang = until now; so far = до сих пор
zu buchen = to book = бронировать
er bucht = he books = он бронирует
ich habe das Hotel gebucht = I have booked the hotel = я забронировал отель
ich buchte das Hotel = I booked the hotel = я бронировал отель
böse auf den Mann = angry at the man = сердит на мужчину
böser = angrier = сердитей
am bösesten = angriest = самый сердитый
dadurch = thereby; through that = таким образом
dahin = there (direction) = туда
damals = at that time; back then = тогда
daraus = from that = из этого
darum = therefore; about that = поэтому; об этом
zu deklinieren = to decline (grammar) = склонять
er dekliniert = he declines = он склоняет
ich habe das Wort dekliniert = I have declined the word = я склонял слово
ich deklinierte das Wort = I declined the word = я склонял слово
demgegenüber = in contrast; on the other hand = напротив
dick = thick; fat = толстый
dicker = thicker; fatter = толще; жирнее
am dicksten = thickest; fattest = самый толстый; жирный
zu diskutieren = to discuss = обсуждать
er diskutiert = he discusses = он обсуждает
ich habe das Thema diskutiert = I have discussed the topic = я обсудил тему
ich diskutierte das Thema = I discussed the topic = я обсуждал тему
dorthin = to there = туда
dunkel = dark = тёмный
dunkler = darker = темнее
am dunkelsten = darkest = самый тёмный
einfach = also = также
zu eingreifen = to intervene = вмешиваться
er greift ein = he intervenes = он вмешивается
ich bin eingegriffen = I have intervened = я вмешался
ich griff ein = I intervened = я вмешивался
einhalten = to comply with = соблюдать
er hält ein = he complies = он соблюдает
ich habe die Regeln eingehalten = I have complied with the rules = я соблюдал правила
ich hielt die Regeln ein = I complied with the rules = я соблюдал правила
einheitlich = uniform; consistent = единообразный
zu einladen = to invite = приглашать
er lädt ein = he invites = он приглашает
ich habe dich eingeladen = I have invited you = я пригласил тебя
ich lud dich ein = I invited you = я приглашал тебя
zu einreichen = to submit = подавать; представлять
er reicht ein = he submits = он подаёт
ich habe den Antrag eingereicht = I have submitted the application = я подал заявление
ich reichte den Antrag ein = I submitted the application = я подавал заявление
zu einschränken = to restrict = ограничивать
er schränkt ein = he restricts = он ограничивает
ich habe das eingeschränkt = I have restricted that = я ограничил это
ich schränkte das ein = I restricted that = я ограничивал это
emotional = emotional = эмоциональный
zu empfehlen = to recommend = рекомендовать
er empfiehlt = he recommends = он рекомендует
ich habe das Buch empfohlen = I have recommended the book = я рекомендовал книгу
ich empfahl das Buch = I recommended the book = я рекомендовал книгу
entgegen dem Mann = contrary to the man = вопреки мужчине
zu entschließen = to decide = решаться
er entschließt sich = he decides = он решается
ich habe mich entschlossen = I have decided = я решился
ich entschloss mich = I decided = я решался
entweder … oder … = either … or … = либо … либо …
ob … oder … = whether … or … = ли … или …
erblich = hereditary = наследственный
zu erholen = to recover; relax = отдыхать
er erholt sich = he recovers = он отдыхает
ich habe mich erholt = I have recovered = я отдыхал
ich erholte mich = I recovered = я отдыхал
zu erstellen = to create; to prepare = создавать
er erstellt = he creates = он создаёт
ich habe den Bericht erstellt = I have created the report = я подготовил отчёт
ich erstellte den Bericht = I created the report = я подготовил отчёт
der Erwachsene = the adult = взрослый
Erwachsenen = adults = взрослые
zu eröffnen = to open (a place) = открывать
er eröffnet = he opens = он открывает
ich habe die Ausstellung eröffnet = I have opened the exhibition = я открыл выставку
ich eröffnete die Ausstellung = I opened the exhibition = я открывал выставку
euch = you (plural, accusative; dative) = вам; вас
falls = in case; if = если, в случае если
fast = almost; nearly = почти
zu fertigen = to produce; to manufacture = производить
er fertigt = he produces = он производит
ich habe das gefertigt = I have produced that = я произвёл это
ich fertigte das = I produced that = я производил это
zu finanzieren = to finance = финансировать
er finanziert = he finances = он финансирует
ich habe das finanziert = I have financed that = я финансировал это
ich finanzierte das = I financed that = я финансировал это
zu formulieren = to formulate = формулировать
er formuliert = he formulates = он формулирует
ich habe das formuliert = I have formulated that = я сформулировал это
ich formulierte das = I formulated that = я формулировал это
zu garantieren = to guarantee = гарантировать
er garantiert = he guarantees = он гарантирует
ich habe das garantiert = I have guaranteed that = я гарантировал это
ich garantierte das = I guaranteed that = я гарантировал это
zu gelingen = to succeed = удаваться
es gelingt = it succeeds = это удаётся
es ist gelungen = it has succeeded = это удалось
es gelang = it succeeded = это удавалось
genannt = called; named = названный
zu genießen = to enjoy = наслаждаться
er genießt = he enjoys = он наслаждается
ich habe den Urlaub genossen = I have enjoyed the holiday = я наслаждался отпуском
ich genoss den Urlaub = I enjoyed the holiday = я наслаждался отпуском
zu geraten = to get into; to turn out = попадать; получаться
er gerät = he gets into = он попадает
es ist geraten = it has turned out = это получилось
es geriet = it turned out = это получалось
gespannt auf den Film = excited about the movie = с нетерпением ожидающий фильм
zu grübeln = to ponder = размышлять
er grübelt = he ponders = он размышляет
ich habe viel gegrübelt = I have pondered a lot = я много размышлял
ich grübelte = I pondered = я размышлял
heiß = hot = горячий
heißer = hotter = горячее
am heißesten = hottest = самый горячий
heraus = out; out of = наружу; из
zu herstellen = to produce; to manufacture = производить
er stellt her = he produces = он производит
ich habe das hergestellt = I have produced that = я произвёл это
ich stellte das her = I produced that = я производил это
hinauf = upward; upstairs = вверх
hinein = in; into = внутрь
hingegen = on the other hand; however = однако; напротив
zu hinnehmen = to accept = принимать
er nimmt hin = he accepts = он принимает
ich habe das hingenommen = I have accepted that = я принял это
ich nahm das hin = I accepted that = я принимал это
hinter = behind = за; позади
zu hoffen auf = to hope for = надеяться на
er hofft auf den Erfolg = he hopes for success = он надеется на успех
ich habe auf den Erfolg gehofft = I have hoped for success = я надеялся на успех
ich hoffte auf den Erfolg = I hoped for success = я надеялся на успех
humanitär = humanitarian = гуманитарный
zu informieren = to inform = информировать
er informiert = he informs = он информирует
ich habe dich informiert = I have informed you = я информировал тебя
ich informierte dich = I informed you = я информировал тебя
interessant = interesting = интересный
je = each; per = каждый; на
jedoch = however; but = однако
jährlich = annual; yearly = ежегодный
kalt = cold = холодный
kälter = colder = холоднее
am kältesten = coldest = самый холодный
keinesfalls = by no means; definitely not = ни в коем случае
kirchlich = church-related = церковный
komisch = funny; strange = смешной; странный
konventionell = conventional = традиционный
zu leuchten = to shine; to light = светить
er leuchtet = he shines = он светит
ich habe die Lampe geleuchtet = I have lit the lamp = я зажёг лампу
ich leuchtete die Lampe = I lit the lamp = я зажигал лампу
lieber = rather; preferably = лучше; охотнее
meist = mostly; usually = чаще всего
zu merken = to notice; to remember = замечать; запоминать
er merkt = he notices = он замечает
ich habe es gemerkt = I have noticed that = я заметил это
ich merkte es = I noticed that = я заметил это
modern = modern = современный
morgen = tomorrow = завтра
morgendlich = morning (adjective) = утренний
möglicherweise = possibly; maybe = возможно
na = well; so (colloquial) = ну; так
zu nachlesen = to look up (information) = перечитывать; уточнять
er liest nach = he looks up = он уточняет
ich habe das nachgelesen = I have looked that up = я уточнил это
ich las nach = I looked up = я уточнил
zu notieren = to note = записывать
er notiert = he notes = он записывает
ich habe das notiert = I have noted that = я записал это
ich notierte das = I noted that = я записывал это
per = by; via (Dative) = по; посредством
privat = private = частный
zu prägen = to shape; to imprint = формировать; штамповать
er prägt = he shapes = он формирует
ich habe das geprägt = I have shaped that = я сформировал это
ich prägte das = I shaped that = я формировал это
zu prüfen = to check; to examine = проверять
er prüft = he checks = он проверяет
ich habe das geprüft = I have checked that = я проверил это
ich prüfte das = I checked that = я проверял это
zu reinigen = to clean = очищать
er reinigt = he cleans = он очищает
ich habe das gereinigt = I have cleaned that = я очистил это
ich reinigte das = I cleaned that = я очищал это
zu retten = to rescue; to save = спасать
er rettet = he rescues = он спасает
ich habe das Kind gerettet = I have saved the child = я спас ребёнка
ich rettete das Kind = I saved the child = я спасал ребёнка
zu rufen = to call = звать; кричать
er ruft = he calls = он зовёт
ich habe laut gerufen = I have called loudly = я громко звал
ich rief laut = I called loudly = я кричал
ruhig = quiet; calm = тихий; спокойный
ruhiger = quieter; calmer = тише; спокойнее
am ruhigsten = quietest; calmest = самый тихий; спокойный
zu schalten = to switch; to turn on; off = переключать
er schaltet = he switches = он переключает
ich habe den Fernseher geschaltet = I have switched the TV = я переключил телевизор
ich schaltete den Fernseher = I switched the TV = я переключал телевизор
zu scheiden = to separate; to divorce = разводить; разводиться
er scheidet = he separates = он разводится
ich bin geschieden = I am divorced = я разведен
ich schied = I divorced = я разводился
sicherlich = certainly; surely = конечно; безусловно
siebziger = seventies (decade) = семидесятые
sofort = immediately = сразу
solcher = such = такой
zu sorgen für = to take care of; to provide for = заботиться о
er sorgt für die Kinder = he takes care of the children = он заботится о детях
ich habe für die Kinder gesorgt = I have taken care of the children = я заботился о детях
ich sorgte für die Kinder = I took care of the children = я заботился о детях
sich sorgen um = to worry about = беспокоиться о
er sorgt sich um die Gesundheit = he worries about the health = он беспокоится о здоровье
ich habe mich um die Gesundheit gesorgt = I have worried about the health = я беспокоился о здоровье
ich sorgte mich um die Gesundheit = I worried about the health = я беспокоился о здоровье
sozial = social = социальный
stattdessen = instead; in place of it = вместо этого
stockend = halting; faltering = прерывистый; запинающийся
zu stoppen = to stop = останавливать
er stoppt = he stops = он останавливает
ich habe das Gestoppt = I have stopped that = я остановил это
ich stoppte das = I stopped that = я останавливал это
zu streichen = to cancel; to paint; to stroke = вычеркивать; красить; гладить
er streicht = he cancels; paints = он вычеркивает; красит
ich habe den Termin gestrichen = I have cancelled the appointment = я отменил встречу
ich strich den Termin = I cancelled the appointment = я отменил встречу
streng = strict = строгий
strenger = stricter = строже
am strengsten = strictest = самый строгий
zu stressen = to stress = нервировать; вызывать стресс
er stresst = he stresses = он нервирует
ich habe mich gestresst = I have been stressed = я нервничал
ich stresste mich = I was stressed = я нервничал
super = great; super = супер; великолепно
zu surfen = to surf = заниматься сёрфингом; сидеть в интернете
er surft = he surfs = он занимается сёрфингом; сидит в интернете
ich habe im Internet gesurft = I have surfed the internet = я сидел в интернете
ich surfte im Internet = I surfed the internet = я сидел в интернете
tatkräftig = energetic; active = энергичный
zu teilnehmen an = to participate in = участвовать в
er nimmt an dem Kurs teil = he participates in the course = он участвует в курсе
ich habe an dem Kurs teilgenommen = I have participated in the course = я участвовал в курсе
ich nahm an dem Kurs teil = I participated in the course = я участвовал в курсе
tief = deep; low = глубокий; низкий
tiefer = deeper; lower = глубже; ниже
am tiefsten = deepest; lowest = самый глубокий; низкий
der Tote = the dead person = покойник
die Toten = the dead people = покойники
trennbar = separable (verb) = отделяемый (глагол)
zu trennen = to separate = разделять
er trennt = he separates = он разделяет
ich habe das getrennt = I have separated that = я разделил это
ich trennte das = I separated that = я разделял это
trotzdem = nevertheless; still = тем не менее
zu unterstreichen = to underline = подчеркивать
er unterstreicht = he underlines = он подчеркивает
ich habe das unterstrichen = I have underlined that = я подчёркнул это
ich unterstrich das = I underlined that = я подчеркивал это
zu unterstützen = to support = поддерживать
er unterstützt = he supports = он поддерживает
ich habe ihn unterstützt = I have supported him = я поддержал его
ich unterstützte ihn = I supported him = я поддерживал его
unzufrieden = dissatisfied = недовольный
verantwortlich für den Erfolg = responsible for the success = ответственный за успех
zu verbinden = to connect; to link = связывать
er verbindet = he connects = он связывает
ich habe die Geräte verbunden = I have connected the devices = я связал устройства
ich verband die Geräte = I connected the devices = я связывал устройства
zu verheiraten = to marry (someone off) = выдавать замуж; женить
er verheiratet = he marries = он женит
ich habe sie verheiratet = I have married her off = я выдал её замуж
ich verheiratete sie = I married her off = я выдавал её замуж
zu verlangen = to demand; to require = требовать
er verlangt = he demands = он требует
ich habe mehr verlangt = I have demanded more = я требовал больше
ich verlangte mehr = I demanded more = я требовал
verrückt = crazy = сумасшедший
zu verschieben = to postpone; to move = откладывать; передвигать
er verschiebt = he postpones = он откладывает
ich habe den Termin verschoben = I have postponed the appointment = я отложил встречу
ich verschob den Termin = I postponed the appointment = я откладывал встречу
zu vertagen = to adjourn; to postpone = откладывать (заседание)
er vertagt = he adjourns = он откладывает
ich habe die Sitzung vertagt = I have adjourned the meeting = я отложил заседание
ich vertagte die Sitzung = I adjourned the meeting = я откладывал заседание
zu vertrauen = to trust = доверять
er vertraut = he trusts = он доверяет
ich habe ihm vertraut = I have trusted him = я доверял ему
ich vertraute ihm = I trusted him = я доверял
zu verursachen = to cause = вызывать
er verursacht = he causes = он вызывает
ich habe das verursacht = I have caused that = я вызвал это
ich verursachte das = I caused that = я вызывал это
völlig = completely; totally = полностью; совершенно
wachsen = to grow = расти
er wächst = it grows = он растёт
es ist gewachsen = it has grown = оно выросло
es wuchs = it grew = оно росло
zu warnen vor = to warn against = предупреждать
er warnt vor der Gefahr = he warns against the danger = он предупреждает об опасности
ich habe vor der Gefahr gewarnt = I have warned against the danger = я предупреждал об опасности
ich warnte vor der Gefahr = I warned against the danger = я предупреждал об опасности
weiterhin = furthermore; still = далее; по-прежнему
weltbekannt = world-famous = всемирно известный
wem = to whom (dative) = кому
wild = wild = дикий
wilder = wilder = диче
am wildesten = wildest = самый дикий
woher = from where = откуда
womit = with what = с чем
worüber = about what = о чём
wunderschön = wonderful; beautiful = прекрасный
zu zunehmen = to increase; to gain weight = увеличиваться; набирать вес
er nimmt zu = it increases = он увеличивается
er hat zugenommen = he has gained weight = он набрал вес
er nahm zu = he gained weight = он набирал вес
zu zuordnen = to assign; to classify = относить; классифицировать
er ordnet zu = he assigns = он относит
ich habe das zugeordnet = I have assigned that = я отнес это
ich ordnete das zu = I assigned that = я относил это
zurzeit = currently; at present = в настоящее время
zuständig für den Mann = responsible for the man = ответственный за мужчину
zusätzlich = additionally; in addition = дополнительно
zu zweifeln an dem Plan = to doubt the plan = сомневаться в плане
er zweifelt an dem Plan = he doubts the plan = он сомневается в плане
ich habe an dem Plan gezweifelt = I have doubted the plan = я сомневался в плане
ich zweifelte an dem Plan = I doubted the plan = я сомневался в плане
zu zählen = to count = считать
er zählt = he counts = он считает
ich habe die Stimmen gezählt = I have counted the votes = я подсчитал голоса
ich zählte die Stimmen = I counted the votes = я подсчитывал голоса
das Öl = the oil = масло
Öle = oils = масла
das Österreich = Austria = Австрия
die Übersicht = the overview = обзор
Übersichten = overviews = обзоры
zu öffnen = to open = открывать
er öffnet = he opens = он открывает
ich habe die Tür geöffnet = I have opened the door = я открыл дверь
ich öffnete die Tür = I opened the door = я открыл дверь
zu üben = to practice = тренироваться
er übt = he practices = он тренируется
ich habe das Grammatik geübt = I have practiced the grammar = я практиковал грамматику
ich übte das Grammatik = I practiced the grammar = я практиковал грамматику
zu überleben = to survive = выживать
er überlebt = he survives = он выживает
ich habe die Krise überlebt = I have survived the crisis = я пережил кризис
ich überlebte die Krise = I survived the crisis = я пережил кризис
zu überreden zu dem Plan = to persuade to the plan = уговаривать на план
er überredet den Mann zu dem Plan = he persuades the man to the plan = он уговаривает мужчину на план
ich habe den Mann zu dem Plan überredet = I have persuaded the man to the plan = я уговорил мужчину на план
ich überredete den Mann zu dem Plan = I persuaded the man to the plan = я уговаривал мужчину на план
der Abbau = the reduction; dismantling = сокращение; демонтаж
Abbauten = reductions; dismantlings = сокращения; демонтажи
der Abfall = the waste; garbage = отходы; мусор
Abfälle = wastes; garbages = отходы; мусор
der Absolvent = the graduate = выпускник
Absolventen = graduates = выпускники
die Abteilung = the department = отдел
Abteilungen = departments = отделы
die Achtung = the respect; attention = уважение; внимание
Achtungen = respects; attentions = уважения; внимания
die Adresse = the address = адрес
Adressen = addresses = адреса
das Akkusativsymbol = the accusative symbol = знак винительного падежа
Akkusativsymbole = accusative symbols = знаки винительного падежа
die Aktivität = the activity = деятельность
Aktivitäten = activities = деятельности
die Altsprache = the ancient language = древний язык
Altsprachen = ancient languages = древние языки
der Anbieter = the provider; supplier = поставщик
Anbieter = providers; suppliers = поставщики
der Andrang = the rush; crowd = наплыв; толпа
Andränge = rushes; crowds = наплывы; толпы
der Anfänger = the beginner = начинающий
Anfänger = beginners = начинающие
der Anhang = the attachment; appendix = приложение; вложение
Anhänge = attachments; appendices = приложения; вложения
die Ansage = the announcement = объявление
Ansagen = announcements = объявления
die Anschaffung = the purchase; acquisition = приобретение
Anschaffungen = purchases; acquisitions = приобретения
der Ansprechpartner = the contact person = контактное лицо
Ansprechpartner = contact persons = контактные лица
die Anweisung = the instruction = инструкция
Anweisungen = instructions = инструкции
das Aquajogging = aqua jogging = аквайоггинг
der Arbeitsalltag = the daily work routine = рабочий быт
Arbeitsalltage = daily work routines = рабочие быты
der Arbeitsplatz = the workplace = место работы
Arbeitsplätze = workplaces = места работы
Asien = Asia = Азия
die Atmung = the breathing = дыхание
Atmungen = breathings = дыхания
das Audio = the audio = аудио
Audios = audios = аудиозаписи
der Aufbau = the structure; construction = структура; построение
Aufbauten = structures; constructions = структуры; построения
der Aufenthalt = the stay = пребывание
Aufenthalte = stays = пребывания
das Aufgabenblatt = the worksheet = рабочий лист
Aufgabenblätter = worksheets = рабочие листы
der Aufräumtag = the cleanup day = день уборки
Aufräumtage = cleanup days = дни уборки
der Auftrag = the order; assignment = заказ; задание
Aufträge = orders; assignments = заказы; задания
das Auge = the eye = глаз
Augen = eyes = глаза
die Ausrüstung = the equipment = оборудование
Ausrüstungen = equipments = оборудования
die Ausstellung = the exhibition = выставка
Ausstellungen = exhibitions = выставки
der Bahnhof = the train station = вокзал
Bahnhöfe = train stations = вокзалы
die Bahnstrecke = the railway line = железнодорожная линия
Bahnstrecken = railway lines = железнодорожные линии
der Bauch = the belly; stomach = живот
Bäuche = bellies; stomachs = животы
die Baustelle = the construction site = строительная площадка
Baustellen = construction sites = строительные площадки
die Bedingung = the condition = условие
Bedingungen = conditions = условия
die Bedrohung = the threat = угроза
Bedrohungen = threats = угрозы
die Begegnung = the encounter = встреча
Begegnungen = encounters = встречи
der Bericht = the report = отчёт
Berichte = reports = отчёты
der Berliner = the Berliner (person from Berlin) = берлинец
Berliner = Berliners = берлинцы
die Berufsausbildung = the vocational training = профессиональное образование
Berufsausbildungen = vocational trainings = профессиональные образования
die Beschreibung = the description = описание
Beschreibungen = descriptions = описания
die Betonung = the emphasis; stress = ударение; акцент
Betonungen = emphases; stresses = ударения; акценты
der Betrieb = the company; operation = предприятие; работа
Betriebe = companies; operations = предприятия; работы
der Beweis für den Erfolg = the proof for the success = доказательство успеха
Beweise = proofs = доказательства
die Bewerbung um die Stelle = the application for the position = заявление на должность
Bewerbungen = applications = заявления
die Biokost = organic food = органическая пища
die Biolade = the organic store = магазин органической продукции
Bioladen = organic stores = магазины органической продукции
die Blume = the flower = цветок
Blumen = flowers = цветы
Brasilien = Brazil = Бразилия
der Brenner = the burner; Brenner Pass = горелка; перевал Бреннер
Brenner = burners; Brenner Passes = горелки; перевалы Бреннер
das Brot = the bread = хлеб
Brote = breads = хлеба
der Buddhist = the Buddhist = буддист
Buddhisten = Buddhists = буддисты
das Budget = the budget = бюджет
Budgets = budgets = бюджеты
das Bundesland = the federal state (of Germany) = федеральная земля
Bundesländer = federal states = федеральные земли
die Bundesrepublik = the Federal Republic = Федеративная Республика
Bundesrepubliken = Federal Republics = Федеративные Республики
die Bundesstraße = the federal highway = федеральная дорога
Bundesstraßen = federal highways = федеральные дороги
die Bushaltestelle = the bus stop = автобусная остановка
Bushaltestellen = bus stops = автобусные остановки
die Bühne = the stage = сцена
Bühnen = stages = сцены
der Bürger = the citizen (male) = гражданин
Bürger = citizens = граждане
die Bürgerin = the citizen (female) = гражданка
Bürgerinnen = female citizens = гражданки
die Bürgerinitiative = the citizens' initiative = гражданская инициатива
Bürgerinitiativen = citizens' initiatives = гражданские инициативы
die Charaktereigenschaft = the characteristic trait = черта характера
Charaktereigenschaften = characteristic traits = черты характера
der Chauffeur = the chauffeur = шофёр
Chauffeure = chauffeurs = шофёры
die Choice = the choice = выбор
Choices = choices = выборы
der Code = the code = код
Codes = codes = коды
der Computerkurs = the computer course = курс по компьютерам
Computerkurse = computer courses = курсы по компьютерам
das Computerprogramm = the computer program = компьютерная программа
Computerprogramme = computer programs = компьютерные программы
die Delikatesse = the delicacy = деликатес
Delikatessen = delicacies = деликатесы
das Detail = the detail = деталь
Details = details = детали
der Diener = the servant = слуга
Diener = servants = слуги
die Dienstleistung = the service = услуга
Dienstleistungen = services = услуги
der Dolmetscher = the interpreter = переводчик
Dolmetscher = interpreters = переводчики
der Draht = the wire = провод
Drähte = wires = провода
das Ehepaar = the married couple = супружеская пара
Ehepaare = married couples = супружеские пары
das Eichhörnchen = the squirrel = белка
Eichhörnchen = squirrels = белки
der Eindruck = the impression = впечатление
Eindrücke = impressions = впечатления
die Eingebung = the inspiration; idea = озарение; идея
Eingebungen = inspirations; ideas = озарения; идеи
die Einigung = the agreement = соглашение
Einigungen = agreements = соглашения
die Einlage = the deposit; contribution = вклад
Einlagen = deposits; contributions = вклады
die Einleitung = the introduction = введение
Einleitungen = introductions = введения
der Empfänger = the recipient = получатель
Empfänger = recipients = получатели
die Endposition = the end position = конечная позиция
Endpositionen = end positions = конечные позиции
das Engagement = the commitment; involvement = обязательство; участие
Engagements = commitments; involvements = обязательства; участия
England = England = Англия
der Enthusiasmus = the enthusiasm = энтузиазм
Enthusiasmen = enthusiasms = энтузиазмы
der Entschluss = the decision; resolution = решение
Entschlüsse = decisions; resolutions = решения
die Entschuldigung = the apology; excuse = извинение; оправдание
Entschuldigungen = apologies; excuses = извинения; оправдания
die Entspannung = the relaxation = расслабление
Entspannungen = relaxations = расслабления
die Enttäuschung = the disappointment = разочарование
Enttäuschungen = disappointments = разочарования
das Ereignis = the event = событие
Ereignisse = events = события
der Erfahrungsbericht = the experience report = отчёт о впечатлениях
Erfahrungsberichte = experience reports = отчёты о впечатлениях
das Erfahrungsgedächtnis = the experiential memory = память, основанная на опыте
Erfahrungsgedächtnisse = experiential memories = воспоминания, основанные на опыте
die Ernte = the harvest = урожай
Ernten = harvests = урожаи
das Experiment = the experiment = эксперимент
Experimente = experiments = эксперименты
die Explosion = the explosion = взрыв
Explosionen = explosions = взрывы
der Fachkräftemangel = the shortage of skilled workers = нехватка квалифицированных работников
Fachkräftemängel = shortages of skilled workers = нехватки квалифицированных работников
die Fachsprache = the technical language = специальный язык
Fachsprachen = technical languages = специальные языки
die Fahrkarte = the ticket (for transport) = билет
Fahrkarten = tickets = билеты
die Fahrprüfung = the driving test = экзамен по вождению
Fahrprüfungen = driving tests = экзамены по вождению
der Fahrradstand = the bicycle stand = стойка для велосипедов
Fahrradstände = bicycle stands = стойки для велосипедов
die Fahrt = the ride; trip = поездка
Fahrten = rides; trips = поездки
das Fasching = the carnival = карнавал
Faschinge = carnivals = карнавалы
die Faulheit = the laziness = лень
Faulheiten = lazinesses = лени
das Feld = the field = поле
Felder = fields = поля
das Fett = the fat = жир
Fette = fats = жиры
die Feuerwehr = the fire brigade = пожарная служба
Feuerwehren = fire brigades = пожарные службы
der Filter = the filter = фильтр
Filter = filters = фильтры
der Fisch = the fish = рыба
Fische = fish (plural) = рыбы
die Fitness = the fitness = фитнес
das Fitnessstudio = the fitness studio; gym = фитнес-студия; спортзал
Fitnessstudios = fitness studios; gyms = фитнес-студии; спортзалы
die Fledermaus = the bat = летучая мышь
Fledermäuse = bats = летучие мыши
der Flug = the flight = полёт
Flüge = flights = полёты
das Fragewort = the question word = вопросительное слово
Fragewörter = question words = вопросительные слова
der Frankfurter = the person from Frankfurt = франкфуртец
Frankfurter = people from Frankfurt = франкфуртцы
das Frankreich = France = Франция
der Freitag = Friday = пятница
Freitage = Fridays = пятницы
der Freizeittrend = the leisure trend = тенденция в свободное время
Freizeittrends = leisure trends = тенденции в свободное время
die Fremdsprache = the foreign language = иностранный язык
Fremdsprachen = foreign languages = иностранные языки
der Friede = the peace = мир
das Futur = the future tense (grammar) = будущее время
der Fußball = the football (soccer) = футбол
Fußbälle = footballs = мячи для футбола
die Fünfzehnjährige = the fifteen-year-old (female) = пятнадцатилетняя девочка
Fünfzehnjährigen = fifteen-year-olds (female) = пятнадцатилетние девочки
die Fürstin = the princess; female ruler = княгиня; правительница
Fürstinnen = princesses; female rulers = княгини; правительницы
der Gatte = the spouse (male) = супруг
Gatten = spouses (male) = супруги
das Gebiet = the area; region = область; регион
Gebiete = areas; regions = области; регионы
der Gebrauch = the use; usage = использование
Gebräuche = uses; usages = использования
das Gebäude = the building = здание
Gebäude = buildings = здания
die Gebührenerhöhung = the fee increase = повышение платы; сбора
Gebührenerhöhungen = fee increases = повышения платы; сборов
die Geduld = the patience = терпение
der Gegensatz = the contrast; opposite = противоположность
Gegensätze = contrasts; opposites = противоположности
die Gehirnströme = the brainwaves = мозговые волны
der Geist = the spirit; mind = дух; разум
Geister = spirits; ghosts = духи; призраки
das Gelenk = the joint (anatomy) = сустав
Gelenke = joints = суставы
die Gemeinde = the community = сообщество; община
Gemeinden = communities = сообщества; общины
der Genuss = the enjoyment; pleasure = удовольствие
Genüsse = enjoyments; pleasures = удовольствия
der Geruch nach dem Essen = the smell of the food = запах еды
Gerüche = smells = запахи
die Geschäftsreise = the business trip = командировка
Geschäftsreisen = business trips = командировки
die Gesundheit = the health = здоровье
das Gesundheitsprogramm = the health program = программа по здоровью
Gesundheitsprogramme = health programs = программы по здоровью
der Gesundheitszustand = the state of health = состояние здоровья
Gesundheitszustände = states of health = состояния здоровья
das Gift = the poison = яд
Gifte = poisons = яды
der Glaube = the belief; faith = вера; убеждение
Glauben = beliefs = веры; убеждения
der Grad = the degree = степень
Grade = degrees = степени
das Grammatikkapitel = the grammar chapter = грамматическая глава
Grammatikkapitel = grammar chapters = грамматические главы
die Grenze = the border = граница
Grenzen = borders = границы
Griechenland = Greece = Греция
die Großeltern = the grandparents = бабушки и дедушки
die Grundregel = the basic rule = основное правило
Grundregeln = basic rules = основные правила
die Grundstufe = the basic level = базовый уровень
Grundstufen = basic levels = базовые уровни
die Größe = the size; height = размер; величина
Größen = sizes; heights = размеры; величины
das Halbjahr = the half year; semester = полугодие; семестр
Halbjahre = half years; semesters = полугодия; семестры
die Halle = the hall = зал
Hallen = halls = залы
das Halloween = Halloween = Хэллоуин
der Handel = the trade = торговля
Handels = trades = торговли
die Hauptaussage = the main statement = основное утверждение
Hauptaussagen = main statements = основные утверждения
der Hausbewohner = the house resident = житель дома
Hausbewohner = house residents = жители домов
die Haushaltspflicht = the household duty = обязанность по ведению дома
Haushaltspflichten = household duties = обязанности по ведению дома
die Heimat = the homeland = родина
Heimaten = homelands = родины
die Heizung = the heating = отопление
Heizungen = heatings = отопления
die Helenenstraße = Helenenstraße (name of street) = улица Хеленен
Helenenstraßen = Helenenstraßen (street names) = улицы Хеленен
her = here; towards here = сюда; сюда (направление)
der Herbst = the autumn = осень
Herbste = autumns = осени
das Hindernis = the obstacle = препятствие
Hindernisse = obstacles = препятствия
die Hindus = Hindus = индуисты
der Hit = the hit (song) = хит
Hits = hits = хиты
der Hoax = the hoax = ложная информация
Hoaxes = hoaxes = ложные информация
das Hobby = the hobby = хобби
Hobbys = hobbies = хобби
der Hof = the courtyard; farmyard = двор
Höfe = courtyards; farmyards = дворы
die Hosenträger = the suspenders = подтяжки
der Händler = the dealer; trader = торговец
Händler = dealers; traders = торговцы
die Höflichkeit = the politeness = вежливость
Höflichkeiten = politenesses = вежливости
der Hörtext = the listening text = текст для аудирования
Hörtexte = listening texts = тексты для аудирования
der Impuls = the impulse = импульс
Impulse = impulses = импульсы
das Indefinitpronomen = the indefinite pronoun = неопределённое местоимение
Indefinitpronomen = indefinite pronouns = неопределённые местоимения
der Insasse = the inmate; passenger = заключённый; пассажир
Insassen = inmates; passengers = заключённые; пассажиры
die Integration = the integration = интеграция
Integrationen = integrations = интеграции
das Interphon = the intercom = домофон
Interphone = intercoms = домофоны
das Interview = the interview = интервью
Interviews = interviews = интервью
der Jeck = the carnival fool (Rhineland) = шут карнавала (Рейнская область)
Jecken = carnival fools = шуты карнавала
der Jude = the Jew = еврей
Juden = Jews = евреи
das Kamel = the camel = верблюд
Kamele = camels = верблюды
der Karfreitag = Good Friday = Страстная Пятница
Karfreitage = Good Fridays = Страстные Пятницы
der Kasus = the grammatical case = падеж
Kasus = cases = падежи
der Keller = the cellar; basement = подвал
Keller = cellars; basements = подвалы
der Kerl = the guy; fellow = парень; тип
Kerle = guys; fellows = парни
die Kerze = the candle = свеча
Kerzen = candles = свечи
der Kilometer = the kilometer = километр
Kilometer = kilometers = километры
der Kirchenkritiker = the church critic = критик церкви
Kirchenkritiker = church critics = критики церкви
die Klammer = the bracket; clip = скобка; зажим
Klammern = brackets; clips = скобки; зажимы
das Klavier = the piano = пианино
Klaviere = pianos = пианино (мн.)
das Kleintier = the small animal = маленькое животное
Kleintiere = small animals = маленькие животные
der Knopf = the button; knob = кнопка; пуговица
Knöpfe = buttons; knobs = кнопки; пуговицы
das Koma = the coma (medical) = кома
Komas = comas = комы
der Konditionalsatz = the conditional clause = условное предложение
Konditionalsätze = conditional clauses = условные предложения
der Konditor = the confectioner = кондитер
Konditoren = confectioners = кондитеры
der Konflikt = the conflict = конфликт
Konflikte = conflicts = конфликты
der Konkurrent = the competitor = конкурент
Konkurrenten = competitors = конкуренты
der Konsum = the consumption = потребление
die Kontrolle = the control; check = контроль; проверка
Kontrollen = controls; checks = контроли; проверки
das Konzept = the concept; plan = концепция; план
Konzepte = concepts; plans = концепции; планы
der Konzern = the corporation = корпорация
Konzerne = corporations = корпорации
die Kostenerstattung = the cost reimbursement = возмещение расходов
Kostenerstattungen = cost reimbursements = возмещения расходов
das Kostüm = the costume = костюм
Kostüme = costumes = костюмы
der Kreis = the circle; district = круг; район
Kreise = circles; districts = круги; районы
der Kreislauf = the circulation = циркуляция; кровообращение
Kreisläufe = circulations = циркуляции
das Krokodil = the crocodile = крокодил
Krokodile = crocodiles = крокодилы
die Kulanzregelung = the goodwill arrangement = регулирование по доброй воле
Kulanzregelungen = goodwill arrangements = регулирования по доброй воле
der Kummer = the sorrow; grief = горе; огорчение
die Kundennummer = the customer number = номер клиента
Kundennummern = customer numbers = номера клиентов
der König = the king = король
Könige = kings = короли
die Körnerfresserei = the grain feeding (literal, possibly figurative) = кормление зерном
die Kündigung = the termination; notice = увольнение; уведомление
Kündigungen = terminations; notices = увольнения; уведомления
die Lage = the location; situation = расположение; ситуация
Lagen = locations; situations = расположения; ситуации
die Landstraße = the country road = сельская дорога
Landstraßen = country roads = сельские дороги
das Lebensjahr = the year of life = год жизни
Lebensjahre = years of life = годы жизни
das Lebensmittel = the food; grocery = продукт питания
Lebensmittel = foods; groceries = продукты питания
die Lebensumstände = the living conditions = жизненные обстоятельства
das Leid = the suffering = страдание
Leiden = sufferings = страдания
die Leitung = the line; management = линия; руководство
Leitungen = lines; managements = линии; руководства
das Liebesnest = the love nest = гнездо любви
die Lohnnebenkosten = the ancillary wage costs = дополнительные затраты на заработную плату
der Londoner = the Londoner = житель Лондона
Londoner = Londoners = жители Лондона
das Lotto = the lottery = лотерея
Lottos = lotteries = лотереи
Luxemburg = Luxembourg = Люксембург
der Lärm = the noise = шум
Lärme = noises = шумы
die Lösungsmöglichkeit = the possible solution = возможное решение
Lösungsmöglichkeiten = possible solutions = возможные решения
der Lückentext = the gap text (cloze test) = текст с пропусками
Lückentexte = gap texts = тексты с пропусками
Madrid = Madrid = Мадрид
der Main = the Main (river) = Майн (река)
der Majoran = the marjoram = майоран
Mallorca = Mallorca = Майорка
der Mantel = the coat = пальто
Mäntel = coats = пальто
der Marathon = the marathon = марафон
Marathons = marathons = марафоны
die Marine = the navy = военно-морской флот
Marinen = navies = военно-морские флоты
das Material = the material = материал
Materialien = materials = материалы
der Maurer = the bricklayer = каменщик
Maurer = bricklayers = каменщики
das Meer = the sea = море
Meere = seas = моря
das Meeresufer = the seashore = морской берег
Meeresufer = seashores = морские берега
die Menge = the amount; crowd = количество; толпа
Mengen = amounts; crowds = количества; толпы
die Miete = the rent = аренда
Mieten = rents = аренды
der Mieter = the tenant = арендатор
Mieter = tenants = арендаторы
das Milieu = the milieu; environment = среда; окружение
Milieus = milieus; environments = среды; окружения
die Milliarde = the billion = миллиард
Milliarden = billions = миллиарды
das Mittagessen = the lunch = обед
Mittagessen = lunches = обеды
die Modalpartikel = the modal particle = модальная частица
Modalpartikeln = modal particles = модальные частицы
die Mode = the fashion = мода
Moden = fashions = моды
das Museum = the museum = музей
Museen = museums = музеи
die Musikveranstaltung = the music event = музыкальное мероприятие
Musikveranstaltungen = music events = музыкальные мероприятия
die Muskelkraft = the muscular strength = мышечная сила
die Muskulatur = the musculature = мускулатура
Muskulaturen = musculatures = мускулатуры
die Mühe = the effort = усилие
Mühen = efforts = усилия
die Natur = the nature = природа
Naturen = natures = природы
die Nebenwirkung = the side effect = побочное действие
Nebenwirkungen = side effects = побочные действия
die Nomen = the nouns = существительные
der Notruf = the emergency call = экстренный вызов
Notrufe = emergency calls = экстренные вызовы
das Obst = the fruit = фрукт
das Opfer = the victim; sacrifice = жертва
Opfer = victims; sacrifices = жертвы
die Organisation = the organization = организация
Organisationen = organizations = организации
die Orthopädie = the orthopedics = ортопедия
Orthopädien = orthopedics (plural) = ортопедии
das Osterfest = the Easter festival = пасхальный праздник
die Ostereier = the Easter eggs = пасхальные яйца
das Ostern = Easter = Пасха
der Parkplatz = the parking lot = парковка
Parkplätze = parking lots = парковки
das Pech = the bad luck; misfortune = неудача; невезение
die Pension = the pension; guesthouse = пенсия; пансионат
Pensionen = pensions; guesthouses = пенсии; пансионаты
das Personal = the staff; personnel = персонал
das Pferd = the horse = лошадь
Pferde = horses = лошади
die Pflanze = the plant = растение
Pflanzen = plants = растения
das Pflanzenschutzmittel = the pesticide = средство защиты растений
Pflanzenschutzmittel = pesticides = средства защиты растений
die Pflegekraft = the caregiver; nursing staff = медицинская сестра; ухаживающий персонал
Pflegekräfte = caregivers; nursing staff = медицинские сестры; ухаживающий персонал
die Physik = the physics = физика
Physiken = physics disciplines = разделы физики
das Picknick = the picnic = пикник
Picknicks = picnics = пикники
die Pluralendung = the plural ending = окончание множественного числа
Pluralendungen = plural endings = окончания множественного числа
der Pole = the Pole (person from Poland) = поляк
Polen = Poles = поляки
der Polizeibesuch = the police visit = посещение полиции
Polizeibesuche = police visits = посещения полиции
der Poll = the poll = опрос
Polls = polls = опросы
der Popstar = the pop star = поп-звезда
Popstars = pop stars = поп-звёзды
das Postamt = the post office = почтовое отделение
Postämter = post offices = почтовые отделения
die Produktion = the production = производство
Produktionen = productions = производства
der Professor = the professor = профессор
Professoren = professors = профессора
die Prognose = the prognosis; forecast = прогноз
Prognosen = prognoses; forecasts = прогнозы
das Projekt = the project = проект
Projekte = projects = проекты
das Präfix = the prefix = префикс
Präfixe = prefixes = префиксы
die Präzisionsuhr = the precision watch = точные часы
Präzisionsuhren = precision watches = точные часы
die Qualität = the quality = качество
Qualitäten = qualities = качества
der Rabatt = the discount = скидка
Rabatte = discounts = скидки
das Radiointerview = the radio interview = интервью на радио
Radiointerviews = radio interviews = интервью на радио
der Rasen = the lawn = газон
Rasen = lawns = газоны
das Rathaus = the town hall = ратуша
Rathäuser = town halls = ратуши
die Realität = the reality = реальность
Realitäten = realities = реальности
die Rechnung = the bill; invoice = счёт; счет-фактура
Rechnungen = bills; invoices = счета; счет-фактуры
die Rechtspartei = the right-wing party = правая партия
Rechtsparteien = right-wing parties = правые партии
die Regierung = the government = правительство
Regierungen = governments = правительства
der Reinfall = the flop; failure = провал
Reinfälle = flops; failures = провалы
die Reinigung = the cleaning = уборка
Reinigungen = cleanings = уборки
der Reiseveranstalter = the tour operator = туроператор
Reiseveranstalter = tour operators = туроператоры
der Reporter = the reporter = репортер
Reporter = reporters = репортеры
die Rose = the rose = роза
Rosen = roses = розы
die Ruhe = the quiet; calm = тишина; покой
Ruhen = rests; calms = тишины; покои
das Rätoromanisch = Romansh (language) = ретороманский (язык)
das Rätsel = the riddle; puzzle = загадка
Rätsel = riddles; puzzles = загадки
der Rückgang = the decline; decrease = снижение
Rückgänge = declines; decreases = снижения
Saarland = Saarland (federal state in Germany) = Саар
der Sachverhalt = the fact; circumstance = факт; обстоятельство
Sachverhalte = facts; circumstances = факты; обстоятельства
der Salat = the salad = салат
Salate = salads = салаты
der Samstag = Saturday = суббота
Samstage = Saturdays = субботы
der Sandstrand = the sandy beach = песчаный пляж
Sandstrände = sandy beaches = песчаные пляжи
das Satzende = the end of the sentence = конец предложения
Satzenden = ends of sentences = концы предложений
das Schema = the scheme; pattern = схема
Schemata = schemes; patterns = схемы
der Schiedsrichter = the referee = судья (в спорте)
Schiedsrichter = referees = судьи
das Schlafengehen = the going to sleep = поход ко сну
die Schlagzeile = the headline = заголовок
Schlagzeilen = headlines = заголовки
der Schluss = the end; conclusion = конец; заключение
Schlüsse = ends; conclusions = концы; заключения
der Schmerz = the pain = боль
Schmerzen = pains = боли
die Schnittstelle = the interface; junction = интерфейс; соединение
Schnittstellen = interfaces; junctions = интерфейсы; соединения
der Schokoladennikolaus = the chocolate Santa Claus figure = шоколадный Дед Мороз
Schokoladennikoläuse = chocolate Santa Claus figures = шоколадные Деды Морозы
schriftlich = written = письменный
der Schritt = the step = шаг
Schritte = steps = шаги
das Schuhmodell = the shoe model = модель обуви
Schuhmodelle = shoe models = модели обуви
der Schulfreund = the school friend (male) = школьный друг
Schulfreunde = school friends = школьные друзья
die Schulzeit = the school time; school years = школьное время; годы
Schulzeiten = school times; school years = школьные времена; годы
das Schwimmbad = the swimming pool = бассейн
Schwimmbäder = swimming pools = бассейны
schön = beautiful = красивый
schöner = more beautiful = красивее
am schönsten = most beautiful = самый красивый
die Schönheit = the beauty = красота
Schönheiten = beauties = красоты
die Sehnsucht nach dem Mann = the longing for the man = тоска по мужчине
Sehnsüchte = longings = тоски
das Sekretariat = the secretariat; office = секретариат; офис
Sekretariate = secretariats; offices = секретариаты; офисы
die Sekretärin = the secretary (female) = секретарь (женщина)
Sekretärinnen = secretaries (female) = секретари (женщины)
das Seminar = the seminar = семинар
Seminare = seminars = семинары
der Senior = the senior = пожилой человек
Senioren = seniors = пожилые люди
die Servicezeit = the service time = время обслуживания
Servicezeiten = service times = времена обслуживания
die Show = the show = шоу
Shows = shows = шоу
die Sicherheit = the safety; security = безопасность
Sicherheiten = safeties; securities = безопасности
die Sicht = the view; sight = вид; обзор
Sichten = views = виды; обзоры
das Silbenrätsel = the syllable puzzle = загадка из слогов
Silbenrätsel = syllable puzzles = загадки из слогов
der Sitz = the seat = сидение
Sitze = seats = сиденья
das Smartphone = the smartphone = смартфон
Smartphones = smartphones = смартфоны
die Software = the software = программное обеспечение
Softwares = softwares (rare, plural) = программные обеспечения
der Sohn = the son = сын
Söhne = sons = сыновья
der Spam = the spam = спам
Spams = spams = спамы
Spanien = Spain = Испания
der Spaziergänger = the walker; stroller = пешеход; гуляющий
Spaziergänger = walkers; strollers = пешеходы; гуляющие
der Speicherplatz = the storage space = место для хранения
Speicherplätze = storage spaces = места для хранения
der Sperrmüllservice = the bulky waste service = сервис по вывозу крупногабаритного мусора
Sperrmüllservices = bulky waste services = сервисы по вывозу крупногабаритного мусора
die Spinne = the spider = паук
Spinnen = spiders = пауки
das Sportprogramm = the sports program = спортивная программа
Sportprogramme = sports programs = спортивные программы
der Spracherwerb = the language acquisition = освоение языка
Spracherwerbe = language acquisitions = освоения языков
die Sprachprüfung = the language exam = языковой экзамен
Sprachprüfungen = language exams = языковые экзамены
die Spülmaschine = the dishwasher = посудомоечная машина
Spülmaschinen = dishwashers = посудомоечные машины
das Stadion = the stadium = стадион
Stadien = stadiums = стадионы
die Stadthalle = the city hall; city arena = городская концертная площадка
Stadthallen = city halls; city arenas = городские концертные площадки
der Stadtrat = the city council = городской совет
Stadträte = city councils = городские советы
der Standesbeamter = the registrar = чиновник ЗАГСа
Standesbeamte = registrars = чиновники ЗАГСа
der Start = the start = старт
Starts = starts = старты
die Steinzeitmenschen = the Stone Age people = люди каменного века
der Stellenabbau = the staff reduction = сокращение штатов
Stellenabbauten = staff reductions = сокращения штатов
der Stoff = the material; fabric = материал; ткань
Stoffe = materials; fabrics = материалы; ткани
der Strauß = the bouquet; ostrich = букет; страус
Sträuße = bouquets; ostriches = букеты; страусы
die Straßenbahn = the tram = трамвай
Straßenbahnen = trams = трамваи
der Streik = the strike = забастовка
Streiks = strikes = забастовки
der Streit = the dispute; quarrel = спор; ссора
Streite = disputes; quarrels = споры; ссоры
das Studienfach = the field of study = учебная специальность
Studienfächer = fields of study = учебные специальности
der Studierende = the student (university) = студент
Studierenden = students = студенты
das Studium = the studies; course of study = учёба; обучение
Studien = studies = учёбы
der Superlativ = the superlative = превосходная степень
Superlative = superlatives = превосходные степени
die Szene = the scene = сцена
Szenen = scenes = сцены
die Tante = the aunt = тётя
Tanten = aunts = тёти
der Onkel = the uncle = дядя
Onkel = uncles = дяди
der Enkel = the grandson = внук
Enkel = grandsons = внуки
der Tarifpartner = the collective bargaining partner = сторона в коллективных договорах
Tarifpartner = collective bargaining partners = стороны в коллективных договорах
die Tarifpartnerschaft = the partnership in collective bargaining = партнёрство в коллективных договорах
Tarifpartnerschaften = partnerships in collective bargaining = партнёрства в коллективных договорах
die Taxis = the taxis = такси (множественное)
der Techniker = the technician = техник
Techniker = technicians = техники
der Teig = the dough = тесто
Teige = doughs = теста
die Teigwaren = the pasta = изделия из теста
Teigwaren = pasta; dough products = изделия из теста
der Theaterschuhmacher = the theatrical shoemaker = театральный сапожник
Theaterschuhmacher = theatrical shoemakers = театральные сапожники
die Theorie = the theory = теория
Theorien = theories = теории
die Tierhaltung = the animal husbandry = разведение животных
Tierhaltungen = animal husbandries = разведения животных
der Tod = the death = смерть
Tode = deaths = смерти
der Trend = the trend = тенденция
Trends = trends = тенденции
die Treppe = the stairs = лестница
Treppen = stairs = лестницы
der Tanz = the dance = танец
Tänze = dances = танцы
die Unterkunft = the accommodation = жильё
Unterkünfte = accommodations = жилья
der Unterschied = the difference = разница
Unterschiede = differences = различия
die Variante = the variant = вариант
Varianten = variants = варианты
der Vegetarier = the vegetarian = вегетарианец
Vegetarier = vegetarians = вегетарианцы
der Veranstalter = the organizer = организатор
Veranstalter = organizers = организаторы
die Veranstaltungshinweise = event information = информация о мероприятиях
der Verbstamm = the verb stem = основа глагола
Verbsträmme = verb stems = основы глаголов
die Verfilmung = the film adaptation = экранизация
Verfilmungen = film adaptations = экранизации
der Verkauf = the sale = продажа
Verkäufe = sales = продажи
der Verkäufer = the seller = продавец
Verkäufer = sellers = продавцы
der Verlag = the publishing house = издательство
Verlage = publishing houses = издательства
die Verpflegung = the catering; meals = питание
Verpflegungen = caterings; meals = питания
die Versorgung = the supply; provision = снабжение; обеспечение
Versorgungen = supplies; provisions = снабжения; обеспечения
die Verspätung = the delay = задержка
Verspätungen = delays = задержки
die Verständnisbarriere = the comprehension barrier = барьер понимания
Verständnisbarrieren = comprehension barriers = барьеры понимания
der Vertrag = the contract = договор
Verträge = contracts = договоры
die Volkshochschule = the community college; adult education center = народный университет
Volkshochschulen = community colleges; adult education centers = народные университеты
die Vollpension = the full board = полный пансион
Vollpensionen = full boards = полные пансионы
voraus = ahead; in advance = вперёд; заранее
die Vorbereitung = the preparation = подготовка
Vorbereitungen = preparations = подготовки
das Vorjahr = the previous year = предыдущий год
Vorjahre = previous years = предыдущие годы
die Vorsicht = the caution = осторожность
der Vorverkauf = the presale; advance sale = предпродажа
Vorverkäufe = presales; advance sales = предпродажи
der Wandel = the change; transformation = изменение
Wandel = changes; transformations = изменения
die Ware = the goods; merchandise = товар
Waren = goods; merchandise (plural) = товары
die Wechselpräposition = the two-way preposition = Wechselpräposition
Wechselpräpositionen = two-way prepositions = Wechselpräpositionen
die Weihnachtszeit = the Christmas season = рождественское время
Weihnachtszeiten = Christmas seasons = рождественские времена
der Wein = the wine = вино
Weine = wines = вина
die Wendung = the phrase; idiom = выражение; оборот
Wendungen = phrases; idioms = выражения; обороты
das Werk = the work; factory = произведение; завод
Werke = works; factories = произведения; заводы
der Wert = the value = ценность
Werte = values = ценности
das Wesen = the being; nature = существо; сущность
Wesen = beings; natures = существа; сущности
der Wetterbericht = the weather report = прогноз погоды
Wetterberichte = weather reports = прогнозы погоды
Wien = Vienna = Вена
die Wirklichkeit = the reality = реальность
Wirklichkeiten = realities = реальности
der Wissenschaftler = the scientist = учёный
Wissenschaftler = scientists = учёные
die Wolke = the cloud = облако
Wolken = clouds = облака
das Wortfeld = the semantic field = поле значений
Wortfelder = semantic fields = поля значений
das Yoga = the yoga = йога
Yogas = yogas = йоги
die Zahlenangabe = the numerical data; figure = числовое указание
Zahlenangaben = numerical data; figures = числовые указания
das Zeugnis = the certificate; report card = свидетельство; аттестат
Zeugnisse = certificates; report cards = свидетельства; аттестаты
der Zucker = the sugar = сахар
die Zusammenfassung = the summary = резюме; краткое содержание
Zusammenfassungen = summaries = резюме; краткие содержания
der Zusammenhang = the context; connection = связь; контекст
Zusammenhänge = contexts; connections = связи; контексты
der Zusatzstoff = the additive = добавка
Zusatzstoffe = additives = добавки
der Zweck = the purpose = цель
Zwecke = purposes = цели
die Zweisprachigkeit = the bilingualism = двуязычие
Zweisprachigkeiten = bilingualisms = двуязычия
zu abbauen = to dismantle; to reduce = разбирать; уменьшать
er baut ab = he dismantles; reduces = он разбирает; уменьшает
ich habe das abgebaut = I have dismantled that = я разобрал это
ich baute das ab = I dismantled that = я разбирал это
der Abgeordnete = the deputy; representative = депутат
Abgeordneten = deputies; representatives = депутаты
der Anwalt = the lawyer = адвокат
Anwälte = lawyers = адвокаты
zu ablehnen = to reject = отклонять
er lehnt ab = he rejects = он отклоняет
ich habe den Vorschlag abgelehnt = I have rejected the proposal = я отклонил предложение
ich lehnte den Vorschlag ab = I rejected the proposal = я отклонял предложение
zu abnehmen = to lose weight; to decrease = худеть; уменьшаться
er nimmt ab = he loses weight; decreases = он худеет; уменьшается
ich habe Gewicht abgenommen = I have lost weight = я похудел
ich nahm ab = I lost weight = я худел
abstürzen — stürzt ab — ist abgestürzt — stürzte ab =
zu abstürzen = to crash (e.g., computer, plane) = разбиваться; аварийно падать
er stürzt ab = it crashes = он падает; выходит из строя
es ist abgestürzt = it has crashed = он разбился; сломался
es stürzte ab = it crashed = он падал; ломался
abwertend = derogatory; demeaning = уничижительный
zu achten auf = to pay attention to = обращать внимание на
er achtet auf den Verkehr = he pays attention to the traffic = он обращает внимание на движение
ich habe auf den Verkehr geachtet = I have paid attention to the traffic = я обращал внимание на движение
ich achtete auf den Verkehr = I paid attention to the traffic = я обращал внимание на движение
die Adjektivendung = the adjective ending = окончание прилагательного
Adjektivendungen = adjective endings = окончания прилагательных
alleinerziehend = single parent (adj.) = воспитывающий ребёнка один
altmodisch = old-fashioned = старомодный
zu anbraten = to sauté; to fry a little = обжаривать
er brät an = he sautés = он обжаривает
ich habe das Fleisch angebraten = I have sautéed the meat = я обжарил мясо
ich briet das Fleisch an = I sautéed the meat = я обжаривал мясо
andererseits = on the other hand = с другой стороны
zu angeben = to indicate; to state = указывать
er gibt an = he indicates = он указывает
ich habe die Daten angegeben = I have indicated the data = я указал данные
ich gab die Daten an = I indicated the data = я указывал данные
zu anfertigen = to make; to produce = изготавливать
er fertigt an = he makes = он изготавливает
ich habe das angefertigt = I have made that = я изготовил это
ich fertigte das an = I made that = я изготавливал это
angepasst = adapted; adjusted = адаптированный
zu anhalten = to stop = останавливать
er hält an = he stops = он останавливается
ich habe an der Ampel angehalten = I have stopped at the traffic light = я остановился на светофоре
ich hielt an der Ampel an = I stopped at the traffic light = я останавливался на светофоре
anhand des Beispiels = based on the example = на основании примера
zu anregen = to stimulate; to encourage = побуждать
er regt an = he stimulates = он побуждает
ich habe die Diskussion angeregt = I have stimulated the discussion = я побудил дискуссию
ich regte die Diskussion an = I stimulated the discussion = я побуждал дискуссию
zu anwenden = to apply = применять
er wendet an = he applies = он применяет
ich habe die Methode angewendet = I have applied the method = я применил метод
ich wendete die Methode an = I applied the method = я применял метод
arm = poor = бедный
ärmer = poorer = беднее
am ärmsten = poorest = самый бедный
zu aufbauen = to build up = строить; создавать
er baut auf = he builds up = он строит
ich habe das Vertrauen aufgebaut = I have built the trust = я создал доверие
ich baute das Vertrauen auf = I built the trust = я создавал доверие
auffallen = to stand out; to be noticeable = бросаться в глаза
er fällt auf = he stands out = он выделяется
es ist mir aufgefallen = it has stood out to me = мне это бросилось в глаза
es fiel mir auf = it stood out to me = мне это бросалось в глаза
aufgeregt = excited = взволнованный
aufhören mit = to stop (doing something) = прекращать
er hört mit der Arbeit auf = he stops working = он прекращает работать
ich habe mit der Arbeit aufgehört = I have stopped working = я прекратил работать
ich hörte mit der Arbeit auf = I stopped working = я прекращал работать
aufnehmen = to record; to take in = записывать; принимать
er nimmt auf = he records; takes in = он записывает; принимает
ich habe das Video aufgenommen = I have recorded the video = я записал видео
ich nahm das Video auf = I recorded the video = я записывал видео
aufpassen = to pay attention = присматривать; обращать внимание
er passt auf das Kind auf = he looks after the child = он присматривает за ребёнком
ich habe auf das Kind aufgepasst = I have looked after the child = я присматривал за ребёнком
ich passte auf das Kind auf = I looked after the child = я присматривал за ребёнком
aufregend = exciting = волнующий
aufräumen = to tidy up = убирать
er räumt auf = he tidies up = он убирает
ich habe das Zimmer aufgeräumt = I have tidied up the room = я убрал комнату
ich räumte das Zimmer auf = I tidied up the room = я убирал комнату
aufwachen = to wake up = просыпаться
er wacht auf = he wakes up = он просыпается
ich bin früh aufgewacht = I have woken up early = я проснулся рано
ich wachte früh auf = I woke up early = я просыпался рано
ausführlich = detailed = подробный
zu ausgeben = to spend (money) = тратить
er gibt aus = he spends = он тратит
ich habe viel Geld ausgegeben = I have spent a lot of money = я потратил много денег
ich gab viel Geld aus = I spent a lot of money = я тратил много денег
aushandeln = to negotiate = выторговывать
er handelt aus = he negotiates = он торгует
ich habe den Vertrag ausgehandelt = I have negotiated the contract = я выторговал договор
ich handelte den Vertrag aus = I negotiated the contract = я выторговывал договор
austauschen = to exchange = обменивать
er tauscht aus = he exchanges = он обменивает
ich habe die Informationen ausgetauscht = I have exchanged information = я обменялся информацией
ich tauschte die Informationen aus = I exchanged information = я обменивался информацией
auswendig = by heart; memorized = наизусть
auszeichnen = to honor; to distinguish = награждать
er zeichnet aus = he honors = он награждает
ich habe ihn mit einem Preis ausgezeichnet = I have honored him with a prize = я наградил его премией
ich zeichnete ihn aus = I honored him = я награждал его
außerhalb des Hauses = outside the house = вне дома; снаружи дома
zu bedauern = to regret = сожалеть
er bedauert = he regrets = он сожалеет
ich habe das zutiefst bedauert = I have deeply regretted that = я глубоко сожалел об этом
ich bedauerte das = I regretted that = я сожалел об этом
zu bedürfen = to require; to need = нуждаться
es bedarf = it requires = это требует
es hat bedurft = it has required = это требовало
es bedurfte = it required = это требовало
beeinflussen = to influence = влиять
er beeinflusst = he influences = он влияет
ich habe die Entscheidung beeinflusst = I have influenced the decision = я повлиял на решение
ich beeinflusste die Entscheidung = I influenced the decision = я влиял на решение
beeinträchtigen = to impair; to affect adversely = ухудшать
er beeinträchtigt = he impairs = он ухудшает
ich habe die Entwicklung beeinträchtigt = I have impaired the development = я ухудшил развитие
ich beeinträchtigte die Entwicklung = I impaired the development = я ухудшал развитие
begeistert = enthusiastic = в восторге; воодушевлённый
zu begreifen = to comprehend = понимать
er begreift = he comprehends = он понимает
ich habe das Konzept begriffen = I have comprehended the concept = я понял концепцию
ich begriff das Konzept = I comprehended the concept = я понимал концепцию
zu begründen = to justify = обосновывать
er begründet = he justifies = он обосновывает
ich habe meine Entscheidung begründet = I have justified my decision = я обосновал своё решение
ich begründete meine Entscheidung = I justified my decision = я обосновывал своё решение
behalten = to keep = сохранять
er behält = he keeps = он сохраняет
ich habe das Dokument behalten = I have kept the document = я сохранил документ
ich behielt das Dokument = I kept the document = я сохранял документ
beilegen = to enclose; to settle = прилагать; урегулировать
er legt bei = he encloses = он прилагает
ich habe den Brief beigelegt = I have enclosed the letter = я приложил письмо
ich legte den Brief bei = I enclosed the letter = я прилал приложение
zu bekennen = to confess = признаваться
er bekennt = he confesses = он признаётся
ich habe meine Schuld bekannt = I have confessed my guilt = я признал свою вину
ich bekannte meine Schuld = I confessed my guilt = я признавал свою вину
belaufen = to amount to = составлять
er beläuft sich = it amounts to = это составляет
es hat sich auf 100 Euro belaufen = it has amounted to 100 euros = это составляло 100 евро
es belief sich auf 100 Euro = it amounted to 100 euros = это составляло 100 евро
beliebt = popular = популярный
zu bellen = to bark = лаять
er bellt = he barks = он лает
ich habe den Hund gebellt gehört = I have heard the dog bark = я слышал, как лает собака
ich bellte = I barked = я лаял
bemalt = painted = раскрашенный
beobachten = to observe = наблюдать
er beobachtet = he observes = он наблюдает
ich habe den Vogel beobachtet = I have observed the bird = я наблюдал за птицей
ich beobachtete den Vogel = I observed the bird = я наблюдал за птицей
zu beraten = to advise = советовать
er berät = he advises = он советует
ich habe ihn beraten = I have advised him = я советовал ему
ich beriet ihn = I advised him = я советовал ему
bereiten = to prepare = готовить
er bereitet vor = he prepares = он готовит
ich habe das Essen bereitet = I have prepared the food = я приготовил еду
ich bereitete das Essen = I prepared the food = я готовил еду
bereuen = to regret = сожалеть
er bereut = he regrets = он сожалеет
ich habe die Entscheidung bereut = I have regretted the decision = я сожалел о решении
ich bereute die Entscheidung = I regretted the decision = я сожалел о решении
beruflich = professional; occupational = профессиональный
zu beruhigen = to calm down = успокаивать
er beruhigt = he calms = он успокаивает
ich habe das Kind beruhigt = I have calmed the child = я успокоил ребёнка
ich beruhigte das Kind = I calmed the child = я успокаивал ребёнка
zu beschließen = to decide = решать
er beschließt = he decides = он решает
ich habe das beschlossen = I have decided that = я решил это
ich beschloss das = I decided that = я решал это
zu beschreiben = to describe = описывать
er beschreibt = he describes = он описывает
ich habe das Bild beschrieben = I have described the picture = я описал картину
ich beschrieb das Bild = I described the picture = я описывал картину
zu beschädigen = to damage = повреждать
er beschädigt = he damages = он повреждает
ich habe das Auto beschädigt = I have damaged the car = я повредил машину
ich beschädigte das Auto = I damaged the car = я повреждал машину
sich beschäftigen mit = to be occupied with; to deal with = заниматься
er beschäftigt sich mit der Arbeit = he is occupied with the work = он занимается работой
ich habe mich mit dem Thema beschäftigt = I have dealt with the topic = я занимался этой темой
ich beschäftigte mich mit dem Thema = I dealt with the topic = я занимался темой
zu besichtigen = to visit (a place) = осматривать
er besichtigt = he visits = он осматривает
ich habe das Museum besichtigt = I have visited the museum = я осмотрел музей
ich besichtigte das Museum = I visited the museum = я осматривал музей
besonders = special; especially = особенно
zu bestellen = to order = заказывать
er bestellt = he orders = он заказывает
ich habe das Essen bestellt = I have ordered the food = я заказал еду
ich bestellte das Essen = I ordered the food = я заказывал еду
zu bestimmen = to determine; to decide = определять
er bestimmt = he determines = он определяет
ich habe die Regeln bestimmt = I have determined the rules = я определил правила
ich bestimmte die Regeln = I determined the rules = я определял правила
zu betonen = to emphasize = подчеркивать
er betont = he emphasizes = он подчеркивает
ich habe das betont = I have emphasized that = я подчеркнул это
ich betonte das = I emphasized that = я подчеркивал это
zu bevorzugen = to prefer = предпочитать
er bevorzugt = he prefers = он предпочитает
ich habe ihn bevorzugt = I have preferred him = я предпочёл его
ich bevorzugte ihn = I preferred him = я предпочитал его
zu beweisen = to prove = доказывать
er beweist = he proves = он доказывает
ich habe es bewiesen = I have proved it = я доказал это
ich bewies es = I proved it = я доказывал это
zu beziehen = to obtain; to relate = получать; относиться
er bezieht = he obtains; relates = он получает; относится
ich habe das bezogen = I have obtained; related that = я получил; относился к этому
ich bezog das = I obtained; related that = я получал; относился к этому
bilingual = bilingual = двуязычный
billig = cheap = дешёвый
billiger = cheaper = дешевле
am billigsten = cheapest = самый дешёвый
bisher = so far; until now = до сих пор
bisschen = a little; bit = немного
beißen = to bite = кусать
er beißt = he bites = он кусает
ich habe gebissen = I have bitten = я кусал
ich biss = I bit = я кусал
blau = blue = синий; пьяный (разг.)
zu brechen = to break = ломать
er bricht = he breaks = он ломает
ich habe das gebrochen = I have broken that = я сломал это
ich brach das = I broke that = я ломал это
bunt = colorful = разноцветный
bunter = more colorful = ярче
am buntesten = most colorful = самый яркий
die CD = the CD = компакт-диск
CDs = CDs = компакт-диски
dennoch = nevertheless; however = тем не менее
zu dienen = to serve = служить
er dient = he serves = он служит
ich habe gedient = I have served = я служил
ich diente = I served = я служил
die Doppelkonnektoren = double connectors = двойные союзы
dramatisch = dramatic = драматичный
dreimal = three times = три раза
durchgegangen = gone through; reviewed = пройденный; просмотренный
dänisch = Danish = датский
eingeschlafen = fallen asleep = уснувший; заснувший
zu einigen = to agree = соглашаться
er einigt sich = he agrees = он соглашается
ich habe mich geeinigt = I have agreed = я согласился
ich einigte mich = I agreed = я соглашался
zu einkaufen = to shop = делать покупки
er kauft ein = he shops = он покупает
ich habe eingekauft = I have shopped = я сделал покупки
ich kaufte ein = I shopped = я делал покупки
zu einliefern = to admit (to hospital) = госпитализировать
er liefert ein = he admits = он госпитализирует
ich habe eingeliefert = I have admitted = я госпитализировал
ich lieferte ein = I admitted = я госпитализировал
zu einnehmen = to take (medicine; position) = принимать
er nimmt ein = he takes = он принимает
ich habe eingenommen = I have taken = я принял
ich nahm ein = I took = я принимал
zu einsetzen = to deploy; to use = применять
er setzt ein = he deploys = он применяет
ich habe eingesetzt = I have used = я применил
ich setzte ein = I used = я применял
einzeln = individual; single = отдельный; единичный
elektrisch = electric = электрический
zu empfangen = to receive = принимать
er empfängt = he receives = он принимает
ich habe empfangen = I have received = я принял
ich empfing = I received = я принимал
zu entdecken = to discover = обнаруживать
er entdeckt = he discovers = он обнаруживает
ich habe entdeckt = I have discovered = я обнаружил
ich entdeckte = I discovered = я обнаруживал
zu entsprechen = to correspond = соответствовать
es entspricht = it corresponds = это соответствует
es hat entsprochen = it has corresponded = это соответствовало
es entsprach = it corresponded = это соответствовало
entsprechend = corresponding; according to = соответствующий; согласно
zu entwerfen = to design; to draft = разрабатывать
er entwirft = he designs = он разрабатывает
ich habe entworfen = I have designed = я разработал
ich entwarf = I designed = я разрабатывал
zu erfinden = to invent = изобретать
er erfindet = he invents = он изобретает
ich habe erfunden = I have invented = я изобрёл
ich erfand = I invented = я изобретал
zu erlernen = to learn = изучать
er erlernt = he learns = он изучает
ich habe erlernt = I have learned = я выучил
ich erlernte = I learned = я изучал
zu erläutern = to explain; to clarify = объяснять
er erläutert = he explains = он объясняет
ich habe erläutert = I have explained = я объяснил
ich erläuterte = I explained = я объяснял
erneut = again; anew = вновь; заново
ernst = serious = серьёзный
ernster = more serious = более серьёзный
am ernstesten = most serious = самый серьёзный
erreichbar = reachable; accessible = достижимый; доступный
erschrocken = frightened; shocked = испуганный
zu ersetzen = to replace = заменять
er ersetzt = he replaces = он заменяет
ich habe ersetzt = I have replaced = я заменил
ich ersetzte = I replaced = я заменял
zu erteilen = to grant; to give = выдавать; давать
er erteilt = he grants = он выдаёт
ich habe erteilt = I have granted = я выдал
ich erteilte = I granted = я выдавал
zu erwachen = to wake up = просыпаться
er ist erwacht = he has woken = он проснулся
ich bin erwacht = I have woken up = я проснулся
ich erwachte = I woke up = я просыпался
zu erziehen = to raise; to educate = воспитывать
er erzieht = he raises = он воспитывает
ich habe erzogen = I have raised = я воспитал
ich erzog = I raised = я воспитывал
familiär = familial; family-related = семейный
faul = lazy = ленивый
fauler = lazier = ленивее
am faulsten = laziest = самый ленивый
fehlen = to lack; to be missing = отсутствовать
er fehlt = he lacks = его нет
ich habe gefehlt = I have missed = меня не было
ich fehlte = I missed; was absent = меня не было
ferner = furthermore; moreover = кроме того
zu fernsehen = to watch TV = смотреть телевизор
er sieht fern = he watches TV = он смотрит телевизор
ich habe ferngesehen = I have watched TV = я смотрел телевизор
ich fernsah = I watched TV = я смотрел телевизор
zu fliehen vor = to flee from = спасаться от
er flieht vor dem Feuer = he flees from the fire = он убегает от огня
ich bin vor dem Feuer geflohen = I have fled from the fire = я сбежал от огня
ich floh vor dem Feuer = I fled from the fire = я сбегал от огня
französisch = French = французский
friedlich = peaceful = мирный
fundiert = well-founded = обоснованный
zu fügen = to add; to insert = добавлять
er fügt hinzu = he adds = он добавляет
ich habe hinzugefügt = I have added = я добавил
ich fügte hinzu = I added = я добавлял
fünfzehnjährig = fifteen years old = пятнадцатилетний
zu füttern = to feed = кормить
er füttert = he feeds = он кормит
ich habe gefüttert = I have fed = я кормил
ich fütterte = I fed = я кормил
gefährlich = dangerous = опасный
gehörend = belonging; related = принадлежащий
geistig = mental; intellectual = умственный
genug = enough; sufficient = достаточно
zu geschehen = to happen = происходить
es geschieht = it happens = это происходит
es ist geschehen = it has happened = это произошло
es geschah = it happened = это случилось
gewählt = chosen = выбранный
zu gratulieren zu = to congratulate on = поздравлять с
er gratuliert zu dem Erfolg = he congratulates on the success = он поздравляет с успехом
ich habe zu dem Erfolg gratuliert = I have congratulated on the success = я поздравил с успехом
ich gratulierte zu dem Erfolg = I congratulated on the success = я поздравлял с успехом
die Gratulation = the congratulations = поздравление
Gratulationen = congratulations = поздравления
grün = green = зелёный
zu gründen = to found; to establish = основывать
er gründet = he founds = он основывает
ich habe gegründet = I have founded = я основал
ich gründete = I founded = я основывал
gründlich = thorough; careful = тщательный; основательный
hektisch = hectic = суетливый; лихорадочный
herein = into here = сюда (внутрь)
herum = around = вокруг; около
hierbei = in this context = при этом
hinunter = down; downhill = вниз
hinweg = over; past = за; мимо
zu hinzugeben = to add (something) = добавлять
er gibt hinzu = he adds = он добавляет
ich habe hinzugegeben = I have added = я добавил
ich gab hinzu = I added = я добавлял
höflich = polite = вежливый
ideal = ideal = идеальный
indem = by; while (introducing a way of doing something) = тем, что; посредством того, что
inklusive = including = включая
innen = inside; indoors = внутри; в помещении
irgendwas = anything; something (colloquial) = что-нибудь; что-то
irgendwo = anywhere; somewhere = где-нибудь; где-то
jedenfalls = in any case; anyway = во всяком случае
jeglicher = any; every = любой; всякий
jetzig = current; present = нынешний; текущий
kabarettistisch = cabaret-like = кабаре (стиль)
zu kennenlernen = to get to know = знакомиться
er lernt kennen = he gets to know = он знакомится
ich habe kennengelernt = I have gotten to know = я познакомился
ich lernte kennen = I got to know = я знакомился
zu klappen = to work out; to succeed = удаваться
es klappt = it works out = это получается
es hat geklappt = it has worked out = это получилось
es klappte = it worked out = это получалось
zu klettern = to climb = лазать
er klettert = he climbs = он лазит
ich bin geklettert = I have climbed = я лазил
ich kletterte = I climbed = я лазил
zu klopfen = to knock = стучать
er klopft = he knocks = он стучит
ich habe geklopft = I have knocked = я постучал
ich klopfte = I knocked = я стучал
kommend = upcoming; coming = грядущий; следующий
komplett = complete = полный; полный по содержанию
korrekt = correct = правильный
krank = sick = больной
kränker = sicker = больнее
am kränksten = sickest = самый больной
zu kriegen = to get; to receive = получать
er kriegt = he gets = он получает
ich habe gekriegt = I have gotten = я получил
ich kriegte = I got = я получал
zu hinkriegen = to manage; to pull off (colloquial) = справляться
er kriegt hin = he manages = он справляется
ich habe hingekriegt = I have managed = я справился
ich kriegte hin = I managed = я справлялся
kritisch = critical = критический
künstlich = artificial = искусственный
zu laden = to load; to charge = грузить; заряжать
er lädt = he loads = он грузит
ich habe geladen = I have loaded = я загрузил
ich lud = I loaded = я грузил
zu landen = to land = приземляться
er landet = he lands = он приземляется
ich bin gelandet = I have landed = я приземлился
ich landete = I landed = я приземлялся
laufend = running; ongoing = текущий; непрерывный
zu lauten = to sound; to be (word; form) = звучать; быть
er lautet = it sounds; it is = оно звучит; это есть
ich habe das gelautet = I have sounded; it has been = я звучал; это было
ich lautete = I sounded; it was = я звучал; это было
lecker = tasty; delicious = вкусный
zu lehren = to teach = учить
er lehrt = he teaches = он учит
ich habe das gelehrt = I have taught that = я учил это
ich lehrte das = I taught that = я учил это
zu leisten = to perform; to accomplish = выполнять
er leistet = he performs = он выполняет
ich habe die Arbeit geleistet = I have accomplished the work = я выполнил работу
ich leistete die Arbeit = I accomplished the work = я выполнял работу
zu leiten = to lead; to manage = руководить
er leitet = he leads = он руководит
ich habe das Team geleitet = I have led the team = я руководил командой
ich leitete das Team = I led the team = я руководил командой
zu liefern = to deliver = доставлять
er liefert = he delivers = он доставляет
ich habe die Ware geliefert = I have delivered the goods = я доставил товар
ich lieferte die Ware = I delivered the goods = я доставлял товар
links = left = левый; слева
logisch = logical = логичный
zu meistern = to master = овладевать
er meistert = he masters = он овладевает
ich habe die Aufgabe gemeistert = I have mastered the task = я справился с заданием
ich meisterte die Aufgabe = I mastered the task = я справлялся с заданием
zu melden = to report; to announce = сообщать
er meldet = he reports = он сообщает
ich habe mich gemeldet = I have reported myself = я объявился
ich meldete mich = I reported myself = я объявлялся
zu messen = to measure = измерять
er misst = he measures = он измеряет
ich habe das gemessen = I have measured that = я измерил это
ich maß das = I measured that = я измерял это
zu mitbringen = to bring along = приносить с собой
er bringt mit = he brings along = он приносит с собой
ich habe das mitgebracht = I have brought that along = я принес это с собой
ich brachte das mit = I brought that along = я приносил это с собой
miteinander = together = вместе
zu mitkommen = to come along = идти вместе
er kommt mit = he comes along = он идёт вместе
ich bin mitgekommen = I have come along = я пошёл вместе
ich kam mit = I came along = я ходил вместе
zu mitnehmen = to take along = брать с собой
er nimmt mit = he takes along = он берёт с собой
ich habe das mitgenommen = I have taken that along = я взял это с собой
ich nahm das mit = I took that along = я брал это с собой
neben dem Mann = beside the man = рядом с мужчиной
negativ = negative = отрицательный
nett = nice; kind = милый; приятный
normal = normal = нормальный
notwendig = necessary = необходимый
zu nutzen = to use = использовать
er nutzt = he uses = он использует
ich habe das genutzt = I have used that = я использовал это
ich nutzte das = I used that = я использовал это
nötig = needed; necessary = нужный; необходимый
offen = open = открытый
offener = more open = более открытый
am offensten = most open = самый открытый
offiziell = official = официальный
optimal = optimal = оптимальный
pausenlos = without pause = без перерыва
perfekt = perfect; perfect tense = идеальный; перфект (время)
zu pflanzen = to plant = сажать
er pflanzt = he plants = он сажает
ich habe den Baum gepflanzt = I have planted the tree = я посадил дерево
ich pflanzte den Baum = I planted the tree = я сажал дерево
politisch = political = политический
positiv = positive = положительный
zu probieren = to try; to taste = пробовать
er probiert = he tries; tastes = он пробует
ich habe das probiert = I have tried; tasted that = я пробовал это
ich probierte das = I tried; tasted that = я пробовал это
zu raten zu = to advise to = советовать
er rät zu dem Plan = he advises the plan = он советует план
ich habe zu dem Plan geraten = I have advised the plan = я советовал план
ich riet zu dem Plan = I advised the plan = я советовал план
zu rauben = to rob = грабить
er raubt = he robs = он грабит
ich habe das geraubt = I have robbed that = я ограбил это
ich raubte das = I robbed that = я грабил это
zu rauchen = to smoke = курить
er raucht = he smokes = он курит
ich habe geraucht = I have smoked = я курил
ich rauchte = I smoked = я курил
regelmäßig = regular; regularly = регулярный; регулярно
zu regnen = to rain = идти (о дожде)
es regnet = it rains = идёт дождь
es hat geregnet = it has rained = шёл дождь
es regnete = it rained = шёл дождь
reif = ripe = зрелый
reifer = riper = более зрелый
am reifsten = ripest = самый зрелый
zu riechen nach = to smell like = пахнуть чем-то
er riecht nach dem Essen = it smells of the food = он пахнет едой
ich habe gerochen = I have smelled = я нюхал
ich roch = I smelled = я нюхал
rosarot = pink = розовый
rund = round = круглый
runder = rounder = более круглый
am rundesten = roundest = самый круглый
zu räumen = to clear; to vacate = убирать; освобождать
er räumt = he clears = он убирает
ich habe das Zimmer geräumt = I have cleared the room = я убрал комнату
ich räumte das Zimmer = I cleared the room = я убирал комнату
zu rühren = to stir = мешать
er rührt = he stirs = он мешает
ich habe gerührt = I have stirred = я мешал
ich rührte = I stirred = я мешал
scharf = sharp; spicy = острый
schärfer = sharper; spicier = острее
am schärfsten = sharpest; spiciest = самый острый
zu schauen = to look; to watch = смотреть
er schaut = he looks = он смотрит
ich habe geschaut = I have looked = я смотрел
ich schaute = I looked = я смотрел
zu scheitern = to fail = терпеть неудачу
er scheitert = he fails = он терпит неудачу
es ist gescheitert = it has failed = это провалилось
es scheiterte = it failed = это проваливалось
schief = crooked; wrong = кривой; неправильно
zu schlagen = to beat; to hit = бить
er schlägt = he beats = он бьёт
ich habe geschlagen = I have beaten = я бил
ich schlug = I beat = я бил
schlimm = bad; serious = плохой; серьёзный
schlimmer = worse = хуже
am schlimmsten = worst = самый плохой
zu Schlittschuhlaufen = to ice skate = кататься на коньках
er läuft Schlittschuh = he ice skates = он катается на коньках
ich bin Schlittschuh gelaufen = I have ice skated = я катался на коньках
ich lief Schlittschuh = I ice skated = я катался на коньках
schuld = guilty; fault = виноватый; вина
zu schwimmen = to swim = плавать
er schwimmt = he swims = он плавает
ich bin geschwommen = I have swum = я плавал
ich schwamm = I swam = я плавал
zu schwitzen = to sweat = потеть
er schwitzt = he sweats = он потеет
ich habe geschwitzt = I have sweated = я потел
ich schwitzte = I sweated = я потел
zu schätzen = to estimate; to appreciate = оценивать; ценить
er schätzt = he estimates; appreciates = он оценивает; ценит
ich habe geschätzt = I have estimated; appreciated = я оценил; ценю
ich schätzte = I estimated; appreciated = я оценивал; ценил
zu schützen = to protect = защищать
er schützt = he protects = он защищает
ich habe geschützt = I have protected = я защитил
ich schützte = I protected = я защищал
sich sehnen nach dem Mann = to long for the man = тосковать по мужчине
er sehnt sich nach dem Mann = he longs for the man = он тоскует по мужчине
ich habe nach ihm gesehnt = I have longed for him = я тосковал по нему
ich sehnte mich nach ihm = I longed for him = я тосковал по нему
zu sinken = to sink = тонуть; опускаться
es sinkt = it sinks = оно тонет; опускается
es ist gesunken = it has sunk = оно утонуло; опустилось
es sank = it sank = оно тонуло; опускалось
sogar = even = даже
somit = thus; therefore = таким образом
sommerlich = summery = летний
sonst = otherwise; else = иначе; ещё
spannend = exciting; thrilling = захватывающий
zu speichern = to save (data) = сохранять (данные)
er speichert = he saves = он сохраняет
ich habe gespeichert = I have saved = я сохранил
ich speicherte = I saved = я сохранял
spießig = stuffy; narrow-minded = помпезный; узколобый
sprachlich = linguistic = языковой
zu sterben = to die = умирать
er stirbt = he dies = он умирает
er ist gestorben = he has died = он умер
er starb = he died = он умирал
zu stoßen = to push; to bump = толкать; сталкиваться
er stößt = he pushes = он толкает
ich bin gestoßen = I have bumped = я толкнулся
ich stieß = I pushed; bumped = я толкал; толкался
zu streiten = to argue = спорить
er streitet = he argues = он спорит
ich habe gestritten = I have argued = я спорил
ich stritt = I argued = я спорил
städtisch = urban = городской
subjektiv = subjective = субъективный
zu tanzen = to dance = танцевать
er tanzt = he dances = он танцует
ich habe getanzt = I have danced = я танцевал
ich tanzte = I danced = я танцевал
teilweise = partially = частично
zu telefonieren = to telephone; to call = звонить
er telefoniert = he telephones = он звонит
ich habe telefoniert = I have called = я звонил
ich telefonierte = I called = я звонил
total = totally; completely = полностью; совсем
traurig = sad = грустный
zu treiben = to push; to drive; to do (sports) = гнать; заниматься
er treibt = he pushes; drives; does = он гонит; занимается
ich habe getrieben = I have done (sports) = я занимался
ich trieb = I did (sports) = я занимался
zu töten = to kill = убивать
er tötet = he kills = он убивает
ich habe getötet = I have killed = я убил
ich tötete = I killed = я убивал
türkisch = Turkish = турецкий
umfangreich = extensive; comprehensive = обширный
zu umleiten = to divert = перенаправлять
er leitet um = he diverts = он перенаправляет
ich habe umgeleitet = I have diverted = я перенаправил
ich leitete um = I diverted = я перенаправлял
zu umsatteln = to change (job; horse) = менять вид деятельности; перевешивать седло
er sattelt um = he changes = он меняет
ich habe umgesattelt = I have changed = я поменял
ich sattelte um = I changed = я менял
ungarisch = Hungarian = венгерский
unglaublich = unbelievable = невероятный
unpersönlich = impersonal = безличный
unpopulär = unpopular = непопулярный
unschätzbar = inestimable; priceless = неисчислимый; бесценный
unten = below; down = внизу
zu unterhalten = to entertain; to talk = развлекать; разговаривать
er unterhält = he entertains; talks = он развлекает; разговаривает
ich habe mich unterhalten = I have entertained myself; talked = я развлекался; разговаривал
ich unterhielt mich = I entertained myself; talked = я развлекался; разговаривал
unterschiedlich = different; various = разный; различный
unvergesslich = unforgettable = незабываемый
unüblich = unusual = необычный
zu verbessern = to improve = улучшать
er verbessert = he improves = он улучшает
ich habe verbessert = I have improved = я улучшил
ich verbesserte = I improved = я улучшал
zu verbrauchen = to consume = потреблять
er verbraucht = he consumes = он потребляет
ich habe verbraucht = I have consumed = я потребил
ich verbrauchte = I consumed = я потреблял
zu verbreiten = to spread = распространять
er verbreitet = he spreads = он распространяет
ich habe verbreitet = I have spread = я распространил
ich verbreitete = I spread = я распространял
zu vereinen = to unite = объединять
er vereint = he unites = он объединяет
ich habe vereint = I have united = я объединил
ich vereinte = I united = я объединял
zu verfügen = to have at one's disposal = распоряжаться
er verfügt = he has at his disposal = он располагает
ich habe verfügt = I have disposed = я распорядился
ich verfügte = I disposed = я распоряжался
vergangen = past = прошедший
sich verhalten = to behave = вести себя
er verhält sich = he behaves = он ведёт себя
ich habe mich verhalten = I have behaved = я вел себя
ich verhielt mich = I behaved = я вел себя
zu verletzen = to injure; to offend = ранить; нарушать
er verletzt = he injures = он ранит
ich habe verletzt = I have injured = я ранил
ich verletzte = I injured = я ранил
zu vermeiden = to avoid = избегать
er vermeidet = he avoids = он избегает
ich habe vermieden = I have avoided = я избегал
ich vermied = I avoided = я избегал
zu vermuten = to suppose; to assume = предполагать
er vermutet = he supposes = он предполагает
ich habe vermutet = I have supposed = я предполагал
ich vermutete = I supposed = я предполагал
zu verneinen = to deny = отрицать
er verneint = he denies = он отрицает
ich habe verneint = I have denied = я отрицал
ich verneinte = I denied = я отрицал
vernichten = to destroy = уничтожать
er vernichtet = he destroys = он уничтожает
ich habe das vernichtet = I have destroyed that = я уничтожил это
ich vernichtete das = I destroyed that = я уничтожал это
versetzen = to transfer; to move = переводить; перемещать
er versetzt = he transfers; moves = он переводит; перемещает
ich habe ihn versetzt = I have transferred him = я перевёл его
ich versetzte ihn = I transferred him = я переводил его
vertreiben = to expel; to drive out = изгонять; выгонять
er vertreibt = he expels = он изгоняет
ich habe ihn vertrieben = I have expelled him = я изгнал его
ich vertrieb ihn = I expelled him = я изгонял его
verärgert = annoyed; upset = рассерженный; раздражённый
vorbehalten = to reserve; to withhold = оставлять за собой
er behält das vor = he reserves it = он оставляет это за собой
ich habe das vorbehalten = I have reserved that = я оставил это за собой
ich behielt das vor = I reserved that = я оставлял это за собой
sich vorbereiten auf (Akkusativ) = to prepare oneself for = готовиться к
er bereitet sich auf die Prüfung vor = he prepares for the exam = он готовится к экзамену
ich habe mich auf die Prüfung vorbereitet = I have prepared for the exam = я подготовился к экзамену
ich bereitete mich auf die Prüfung vor = I prepared for the exam = я готовился к экзамену
vorher = before; previously = прежде; до этого
vorlesen = to read aloud = читать вслух
er liest vor = he reads aloud = он читает вслух
ich habe den Text vorgelesen = I have read the text aloud = я читал текст вслух
ich las den Text vor = I read the text aloud = я читал текст вслух
wachsend = growing = растущий
wahr = true = истинный
wahrer = truer; more true = более истинный
am wahrsten = truest; most true = самый истинный
wechseln = to change; to switch = менять; переключать
er wechselt = he changes = он меняет
ich habe gewechselt = I have changed = я сменил
ich wechselte = I changed = я менял
wehren = to defend; to resist = защищаться; сопротивляться
er wehrt sich = he defends himself = он защищается
ich habe mich gewehrt = I have defended myself = я защищался
ich wehrte mich = I defended myself = я защищался
weisen = to point; to indicate = указывать
er weist = he points = он указывает
ich habe darauf gewiesen = I have pointed that out = я указал на это
ich wies darauf = I pointed that out = я указывал на это
weiterführen = to continue; to carry on = продолжать
er führt weiter = he continues = он продолжает
ich habe weitergeführt = I have continued = я продолжил
ich führte weiter = I continued = я продолжал
wert = valuable; worthy = ценный; достойный
werter = more valuable = более ценный
am wertesten = most valuable = самый ценный
wiedergeben = to reproduce; to render = воспроизводить; передавать
er gibt wieder = he reproduces = он воспроизводит
ich habe es wiedergegeben = I have reproduced it = я воспроизвёл это
ich gab es wieder = I reproduced it = я воспроизводил это
wiederholen = to repeat = повторять
er wiederholt = he repeats = он повторяет
ich habe das wiederholt = I have repeated that = я повторил это
ich wiederholte das = I repeated that = я повторял это
wozu = for what purpose = для чего
würzen = to season; to spice = приправлять
er würzt = he seasons = он приправляет
ich habe das gewürzt = I have seasoned that = я приправил это
ich würzte das = I seasoned that = я приправлял это
ziemlich = quite; fairly = довольно; достаточно
zuhören = to listen to = слушать
er hört zu = he listens = он слушает
ich habe zugehört = I have listened = я слушал
ich hörte zu = I listened = я слушал
zustellen = to deliver = доставлять
er stellt zu = he delivers = он доставляет
ich habe das zugestellt = I have delivered that = я доставил это
ich stellte das zu = I delivered that = я доставлял это
zweimal = twice = дважды
zwingen = to force; to compel = заставлять
er zwingt = he forces = он заставляет
ich habe gezwungen = I have forced = я заставил
ich zwang = I forced = я заставлял
die Älteren = the elders; older people = пожилые; старшие
die Ölrechnung = the oil bill = счёт за нефть; топливо
Ölrechnungen = oil bills = счета за нефть; топливо
äußerst = extremely = чрезвычайно
ökologisch = ecological = экологический
überlebt = survived = выживший; переживший
überraschen = to surprise = удивлять
er überrascht = he surprises = он удивляет
ich habe überrascht = I have surprised = я удивил
ich überraschte = I surprised = я удивлял
überraschend = surprising = неожиданный; удивительный
übertreffen = to surpass; to exceed = превосходить
er übertrifft = he surpasses = он превосходит
ich habe übertroffen = I have surpassed = я превзошёл
ich übertraf = I surpassed = я превзошёл
ebenso wie = as well as = так же как; равно как и
schüchtern = shy = робкий; застенчивый
gucken = to look (colloquial) = смотреть
er guckt = he looks = он смотрит
ich habe geguckt = I looked = я смотрел
ich guckte = I looked = я смотрел
abhängen von (Dativ) = to depend on = зависеть от
es hängt von dir ab = it depends on you = это зависит от тебя
es hat davon abgehängt = it has depended on that = это зависело от этого
es hing davon ab = it depended on that = это зависело от этого
sich erkundigen bei (Dativ) = to inquire at; with = осведомляться у
er erkundigt sich bei der Lehrerin = he inquires at the teacher = он спрашивает у учителя
ich habe mich bei der Lehrerin erkundigt = I have inquired at the teacher = я спросил у учителя
ich erkundigte mich bei der Lehrerin = I inquired at the teacher = я спрашивал у учителя
sich unterscheiden in (Dativ) von (Dativ) = to differ in … from … = различаться в … от …
er unterscheidet sich in Farbe von ihrem Kleid = he differs in color from her dress = он отличается цветом от её платья
ich habe mich in den Eigenschaften von dir unterschieden = I have differed in qualities from you = я отличался по качествам от тебя
ich unterschied mich in der Meinung von ihm = I differed in opinion from him = я отличался во мнении от него
liegen an (Dativ) = to be because of; to be due to = зависеть от; быть обусловленным
es liegt am Wetter = it is due to the weather = это из-за погоды
es hat am Wetter gelegen = it was due to the weather = это было из-за погоды
es lag am Wetter = it was due to the weather = это было из-за погоды
sich verlassen auf (Akkusativ) = to rely on = полагаться на
er verlässt sich auf dich = he relies on you = он полагается на тебя
ich habe mich auf ihn verlassen = I have relied on him = я полагался на него
ich verließ mich auf ihn = I relied on him = я полагался на него
nachfragen bei (Dativ) = to inquire at = уточнять у
er fragt bei der Firma nach = he inquires at the company = он уточняет у фирмы
ich habe bei der Firma nachgefragt = I have inquired at the company = я уточнил у фирмы
ich fragte bei der Firma nach = I inquired at the company = я уточнял у фирмы
sich wundern über (Akkusativ) = to wonder about = удивляться
er wundert sich über das Ergebnis = he wonders about the result = он удивляется результату
ich habe mich darüber gewundert = I have wondered about that = я удивился этому
ich wunderte mich darüber = I wondered about that = я удивлялся этому
das Heimweh nach (Dativ) = homesickness for = тоска по дому; по …
Heimweh = homesickness = тоска по дому
die Bereitschaft zu (Dativ) = willingness to = готовность к
Bereitschaften = willingness (plural) = готовности
die Hoffnung auf (Akkusativ) = hope for = надежда на
Hoffnungen = hopes = надежды
die Erinnerung an (Akkusativ) = memory of = воспоминание о
Erinnerungen = memories = воспоминания
das Zeichen für (Akkusativ) = sign; symbol for = знак для; символ чего-то
Zeichen = signs; symbols = знаки; символы
bekannt für (Akkusativ) = known for = известный чем-то
beteiligt an (Dativ) = involved in = участвующий в; вовлечённый в
enttäuscht von (Dativ) = disappointed by = разочарованный в
geschieden von (Dativ) = divorced from = разведённый с
getrennt von (Dativ) = separated from = раздельно от
scharf auf (Akkusativ) = keen on; eager for = сильно желающий; заинтересованный в
überzeugt von (Dativ) = convinced of = убеждённый в
verheiratet mit (Dativ) = married to = женатый на; замужняя за
zornig auf (Akkusativ) = angry at = злой на
bei = at; with = у; при
zu = to; for; at = к; для; на
nach = after; to; according to = после; к; согласно
in = in; into = в; внутри
an = at; on; to = на; у; к
auf = on; upon; at = на; при; в
Auf der einen (anderen) Seite, ... = on the one (other) hand, ... = с одной (другой) стороны, ...
Von meiner (deiner) Seite, ... = from my (your) side, ... = с моей (твоей) стороны, ...