sein — ist gewesen — war — wäre = to be — has been — was — would be  
und = and  
in = in  
ein = a  
haben — er hat — gehabt — hatte — hätte = to have — he has — had — had — would have  
zu = to  
es = it  
auch = also  
werden — er wird — ist geworden = to become — he becomes — has become  
ich = I  
nicht = not  
mit = with  
sie = she/they  
sich = oneself  
für = for  
von = of/from  
auf = on  
so = so  
wir = we  
können — ich/er kann — konnte — könnte = can — I/he can — could — would be able to  
dass = that  
hier = here  
an = at  
wie = how  
man = one  
dieser = this  
aber = but  
er = he  
dann = then  
als = as  
ihr = her/your  
aus = out  
das Jahr = year  
noch = still  
bei = at  
machen — gemacht = to make — made  
wenn = if  
mehr = more  
geben — er gibt — gegeben = to give — he gives — given  
nur = only  
da = there  
also = so  
ganz = whole  
ja = yes  
oder = or  
immer = always  
jetzt = now  
gut = good  
kommen — ist gekommen = to come — has come  
schon = already  
alle = all  
nach = after  
gehen — ist gegangen = to go — has gone  
um = around  
wollen — ich/er will — wollte = to want — I/he want — wanted  
vor = before  
was = what  
sehr = very  
jeder = everyone  
groß = big  
einfach = simple  
mal = times  
der Mensch = human  
der andere = other  
kein = no  
Deutschland = Germany  
mein = my  
sagen — gesagt = to say — said  
doch = yet  
viel = much  
sehen — er sieht — gesehen = to see — he sees — seen  
wieder = again  
über = over  
wer = who  
weil = because  
sollen — ich/er soll — sollte — sollte = should — I/he should — should — should  
bis = until  
müssen — ich/er muss — musste — müsste = must — I/he must — had to — would have to  
neu = new  
heute = today  
natürlich = naturally  
uns = us  
finden — gefunden = to find — found  
unser = our  
denn = because  
aller = all  
mir = me  
wirklich = really  
eigentlich = actually  
durch = through  
der erste = first  
die Stadt = city  
seit = since  
deutsch = German  
wo = where  
die Welt = world  
die Leute = people  
der Tag = day  
stehen — gestanden = to stand — stood  
die Zeit = time  
damit = with it  
mich = me  
wissen — gewusst = to know — known  
arbeiten — gearbeitet = to work — worked  
klein = small  
leben — gelebt = to live — lived  
alt = old  
wichtig = important  
das Kind = child  
eben = just  
erst = first  
etwas = something  
rund = round  
sondern = but  
halt = stop  
das Haus = house  
dafür = for that  
das Beispiel = example  
selbst = self  
schön = beautiful  
nehmen — er nimmt — genommen = to take — he takes — taken  
denken an {Akk.} — gedacht = to think about — thought  
bekommen — bekommen = to get — got  
ohne = without  
das Leben = life  
bleiben — ist geblieben = to stay — has stayed  
heißen — geheißen = to be called — called  
du = you  
eigen = own  
dabei = with it  
unter = under  
liegen — gelegen = to lie — lay  
vielleicht = maybe  
zeigen — gezeigt = to show — showed  
gerade = just  
das Land = country  
der Euro = euro  
weniger = less  
hoch = high  
glauben an {Akk.} — geglaubt = to believe in — believed  
drei = three  
brauchen — gebraucht = to need — needed  
richtig = correct  
die Frau = woman  
lang = long  
gar = at all  
tun — getan = to do — done  
schaffen — geschafft = to manage — managed  
fast = almost  
dürfen — ich/er darf — durfte — dürfte = to be allowed to — I/he may — was allowed to — would be allowed to  
ob = whether  
weit = far  
dazu = to that  
ihn = him  
möchten — ich/er möchte = to want — I/he would like  
der Teil = part  
schnell = fast  
genau = exactly  
bauen — gebaut = to build — built  
die Million = million  
gehören zu {Dat.} — gehört = to belong to — belonged  
lassen — er lässt — gelassen = to let — he lets — let  
sogar = even  
das Prozent = percent  
fahren — er fährt — ist gefahren = to drive — he drives — has driven  
jung = young  
die Familie = family  
das Problem = problem  
bringen — gebracht = to bring — brought  
der letzte = last  
der Ort = place  
weiter = further  
die Idee = idea  
das Wasser = water  
der Berliner = Berliner  
nie = never  
der nächste = next  
ab = from  
haben — er hat — gehabt = to have — he has — had  
das Auto = car  
nichts = nothing  
das Geld = money  
dort = there  
einmal = once  
weltweit = worldwide  
das Ende = end  
ihnen = them  
oft = often  
vier = four  
der Mann = man  
besonders = especially  
ein bisschen = a bit  
die Woche = week  
irgendwie = somehow  
lernen — gelernt = to learn — learned  
versuchen — versucht = to try — tried  
spielen — gespielt = to play — played  
die Geschichte = history  
zurück = back  
die Arbeit = work
Europa = Europe  
davon = of it  
kennen — gekannt = to know — known  
der Meter = meter  
einiger = some  
gegen = against  
die Stunde = hour  
schwer = heavy  
zusammen = together  
der Fall = case  
die Straße = street  
der Weg = way  
entstehen — ist entstanden = to arise — has arisen  
der Monat = month  
halten — er hält — gehalten = to hold — he holds — held  
das Mal = time  
setzen {sich} — gesetzt = to sit down — sat down  
spät = late  
anders = different  
beide = both  
ihm = him  
stellen — gestellt = to place — placed  
die Musik = music  
deshalb = therefore  
echt = real  
fünf = five  
gleich = equal  
pro = per  
das Bild = picture  
das Tier = animal  
führen — geführt = to lead — led  
stark = strong  
tatsächlich = actually  
treffen {sich} — er trifft — getroffen = to meet — he meets — met  
die Sache = thing  
die Schule = school  
warum = why  
solcher = such  
sprechen — er spricht — gesprochen = to speak — he speaks — spoken  
zehn = ten  
helfen — er hilft — geholfen = to help — he helps — helped  
verkaufen — verkauft = to sell — sold  
früh = early  
der Meister = master  
das Unternehmen = company  
fühlen {sich} — gefühlt = to feel — felt  
manchmal = sometimes  
überhaupt = at all  
der Kunde = customer  
entwickeln {sich} — entwickelt = to develop — developed  
etwa = approximately  
mancher = some  
ein paar = a few  
zwischen = between  
die Art = kind  
das Jahrhundert = century  
bereits = already  
kaum = hardly  
klar = clear  
lang = long  
ne = right  
nutzen — genutzt = to use — used  
die Region = region  
bissch = bit  
deswegen = therefore  
erleben — erlebt = to experience — experienced  
toll = great  
der Freund = friend  
die Zukunft = future  
essen — er isst — gegessen = to eat — he eats — eaten  
der Platz = place  
der Spaß = fun  
schwierig = difficult  
nun = now  
beginnen — begonnen = to begin — begun  
deutsch = German  
sogenannter = so-called  
suchensuchen nach {Akk.} — gesucht = to search for — searched  
zwar = indeed  
die Grenze = border  
das Team = team  
damals = back then  
darauf = on it  
selber = self  
welcher = which  
ziehen — gezogen = to pull — pulled  
der Anfang = beginning  
passieren — ist passiert = to happen — happened  
verschieden = different  
das Gefühl = feeling  
der Raum = room  
erreichen — erreicht = to reach — reached  
gerne = gladly  
sonst = otherwise  
kaufen — gekauft = to buy — bought  
laufen — er läuft — ist gelaufen = to run — he runs — ran  
produzieren — produziert = to produce — produced  
trotzdem = nevertheless  
der Besucher = visitor  
das Ding = thing  
die Firma = company  
die Hand = hand  
der Kilometer = kilometer  
euch = you  
leicht = easy  
möglich = possible  
verändern {sich} — verändert = to change — changed  
der Moment = moment  
während = during  
die Angst = fear  
mittlerweile = meanwhile  
die Natur = nature  
allein = alone  
dadurch = thereby  
gelten — gegolten = to apply — applied  
die Generation = generation  
der Grund = reason  
eher = rather  
fallen — er fällt — ist gefallen = to fall — he falls — fell  
funktionieren — funktioniert = to function — functioned  
das Stück = piece  
am = at the  
sitzen — ist gesessen = to sit — sat  
unterwegs = on the way  
wenig = little  
wohl = well  
die Herausforderung = challenge  
der Kopf = head  
die Seite = page  
das Thema = topic  
fertig = ready  
fragen — gefragt = to ask — asked  
der Gast = guest  
das Ziel = goal  
darüber = about it  
direkt = directly  
komplett = complete  
schauen — geschaut = to look — looked  
die Form = form  
das Projekt = project  
die Wohnung = apartment  
her = here  
sechs = six  
sorgen für {Akk.} — gesorgt = to take care of — taken care of  
bewegen {sich} — bewegt = to move — moved  
bieten — geboten = to offer — offered  
kosten — gekostet = to cost — cost  
rein = pure  
sicher = safe  
überall = everywhere  
hinter = behind  
kurz = short  
tragen — er trägt — getragen = to carry — he carries — carried  
voll = full  
der Baum = tree  
die Eltern = parents  
die Mutter = mother  
die Tradition = tradition  
herstellen — hergestellt = to produce — produced  
je = ever  
lieben — geliebt = to love — loved  
oben = above  
sozusagen = so to speak  
steigen — ist gestiegen = to climb — climbed  
wegen = because of  
der Krieg = war  
die Kunst = art  
allerdings = however  
dauern — gedauert = to last — lasted  
hören — gehört = to hear — heard  
meinen — gemeint = to mean — meant  
merken — gemerkt = to notice — noticed  
das Dorf = village  
das Museum = museum  
aussehen — ausgesehen = to look — looked  
beliebt = popular  
daran = on it  
extrem = extreme  
gemeinsam = together  
insgesamt = overall  
modern = modern  
verlieren — verloren = to lose — lost  
das Fleisch = meat  
die Frage = question  
teuer = expensive  
verstehen — verstanden = to understand — understood  
der zweite = second  
der Berg = mountain  
der Job = job  
okay = okay  
der Vater = father  
darum = therefore  
einzig = only  
erzählen — erzählt = to tell — told  
mögen — ich/er mag — mochte = to like — I/he likes — liked  
die Minute = minute  
der Mitarbeiter = employee  
der Winter = winter  
bekannt = known  
besonder = special
erkennen — erkannt = to recognize — recognized  
international = international  
nennen — genannt = to name — named  
normal = normal  
die Erfahrung = experience  
die Heimat = homeland  
die Technik = technology  
hin = there  
jemand = someone  
statt = instead  
der Grad = degree  
der Künstler = artist  
der Markt = market  
der Tourist = tourist  
kriegen — gekriegt = to get — got  
raus = out  
wachsen — ist gewachsen = to grow — has grown  
ziemlich = quite  
die Energie = energy  
das Foto = photo  
die Richtung = direction  
alle = all  
bestimmt = certain  
europäisch = European  
irgendwann = sometime  
verbinden — verbunden = to connect — connected  
der Blick = look  
das Buch = book  
die Möglichkeit = possibility  
der Name = name  
knapp = tight  
los = go  
mehrere = several  
quasi = quasi  
schlecht = bad  
der Alltag = everyday life  
das Geschäft = business  
frei = free  
freuen {sich} über / auf {Akk.} — gefreut = to be happy about / look forward to — happy  
gucken — geguckt = to look — looked  
inzwischen = meanwhile  
schreiben — geschrieben = to write — wrote  
stecken — gesteckt = to stick — stuck  
verdienen — verdient = to earn — earned  
wohnen — gewohnt = to live — lived  
die Hilfe = help  
der Preis = price  
das Produkt = product  
das Restaurant = restaurant  
das Schloss = castle  
der Schüler = student  
die USA = USA  
die Ukraine = Ukraine  
das Video = video  
digital = digital  
erhalten — erhalten = to receive — received  
genießen — genossen = to enjoy — enjoyed  
kämpfen — gekämpft = to fight — fought  
persönlich = personal  
tanzen — getanzt = to dance — danced  
das Licht = light  
der Sport = sport  
bedeuten — bedeutet = to mean — meant  
berühmt = famous  
bevor = before  
drin = inside  
egal = doesn't matter  
entdecken — entdeckt = to discover — discovered  
gleichzeitig = simultaneously  
neben = next to  
sieben = seven  
vorher = before  
ändern — geändert = to change — changed  
die Situation = situation  
die Uhr = clock  
bald = soon  
bezahlen — bezahlt = to pay — paid  
einige = some  
irgendwo = somewhere  
offen = open  
ungefähr = approximately  
das Bier = beer  
das Gebäude = building  
das Jahrzehnt = decade  
die Nähe = proximity  
die Person = person  
der Schweizer = Swiss  
der Wald = forest  
aktuell = current  
fehlen — gefehlt = to miss — missed  
genauso = just as  
gewinnen — gewonnen = to win — won  
hoffen auf {Akk.} — gehofft = to hope for — hoped  
sozial = social  
stammen — gestammt = to originate — originated  
vergangen = past  
zumindest = at least  
öffentlich = public  
die Farbe = color  
das Glück = luck  
die Menge = amount  
die Rolle = role  
draußen = outside  
erfolgreich = successful  
frisch = fresh  
holen — geholt = to fetch — fetched  
kümmern sich — gekümmert = to take care of — took care of  
laut = loud  
perfekt = perfect  
reichen — gereicht = to suffice — sufficed  
scheinen — geschienen = to shine — shone  
schützen — geschützt = to protect — protected  
selten = rare  
traditionell = traditional  
vorstellen sich — vorgestellt = to introduce oneself — introduced  
warten auf {Akk.} — gewartet = to wait for — waited  
die Gruppe = group  
die Hauptstadt = capital  
der Kollege = colleague  
der Traum = dream  
anfangen — angefangen = to start — started  
bisher = so far  
daraus = from it  
deutlich = clear  
dir = you  
gern = gladly  
passen zu {Dat.} — gepasst = to fit — fitted  
relativ = relatively  
schmecken — geschmeckt = to taste — tasted  
täglich = daily  
wirken — gewirkt = to act — acted  
wünschen — gewünscht = to wish — wished  
der Boden = ground  
die Chance = chance  
China = China  
die Figur = figure  
das Holz = wood  
der Punkt = point  
die Regel = rule  
acht = eight  
bestehen — bestanden = to exist — existed  
hart = hard  
klassisch = classic  
nein = no  
weg = away  
zahlen — gezahlt = to pay — paid  
das Auge = eye  
die Gesellschaft = society  
die Höhe = height  
das Medium = medium  
die Politik = politics  
der Sinn = sense  
die Tonne = ton  
der Wiener = Viennese  
der Zug = train  
dich = you  
gesamt = total  
lassen — er lässt — gelassen = to let — he lets — let  
schließen — geschlossen = to close — closed  
wahrscheinlich = probably  
die Ausstellung = exhibition  
die Marke = brand  
der Schnee = snow  
die Sprache = language  
alleine = alone  
bayerisch = Bavarian  
daher = therefore  
danach = afterwards  
drehen — gedreht = to turn — turned  
entscheiden — entschieden = to decide — decided  
fest = firm  
genug = enough  
schlagen — geschlagen = to hit — hit  
schließlich = finally  
sofort = immediately  
vorbei = over  
zusätzlich = additional  
die Alpen = Alps  
das Brot = bread  
das Internet = internet  
die Miete = rent  
die Mitte = middle  
die Nacht = night  
das Schiff = ship  
die Weise = way  
betreiben — betrieben = to operate — operated  
eng = tight  
erfahren — erfahren = to experience — experienced  
feiern — gefeiert = to celebrate — celebrated  
lesen — er liest — gelesen = to read — he reads — read  
miteinander = with each other  
nah = close  
regelmäßig = regularly  
verlassen — er verlässt — verlassen = to leave — he leaves — left  
die Information = information  
absolut = absolutely  
außerdem = moreover  
beobachten — beobachtet = to observe — observed  
nachhaltig = sustainable  
neun = nine
obwohl = although  
riesig = huge  
tief = deep  
total = total  
unterschiedlich = different  
völlig = completely  
der Bereich = area  
der Bewohner = resident  
der Dom = cathedral  
das Eis = ice  
das Fahrzeug = vehicle  
Gott = God  
die Kirche = church  
die Kultur = culture  
das Modell = model  
das Netz = net  
die Reise = trip  
die Schweiz = Switzerland  
der Strom = current  
Venedig = Venice  
Wien = Vienna  
aufgrund = due to  
drauf = on it  
ehemalig = former  
erklären — erklärt = to explain — explained  
gelingen — gelungen = to succeed — succeeded  
gründen — gegründet = to found — founded  
halb = half  
legen — gelegt = to lay — laid  
sagen — gesagt = to say — said  
der Beruf = profession  
der König = king  
Paris = Paris  
die Regierung = government  
die Stelle = place  
der Trend = trend  
erinnern {sich} an {Akk.} — erinnert = to remember — remembered  
hängen — gehangen = to hang — hung  
langsam = slow  
liefern — geliefert = to deliver — delivered  
mindestens = at least  
na = well  
niemand = nobody  
politisch = political  
unterstützen — unterstützt = to support — supported  
zerstören — zerstört = to destroy — destroyed  
zunächst = first  
die Aufgabe = task  
der Betrieb = company  
der Bus = bus  
das Gericht = court  
das Material = material  
die Ruhe = peace  
der Schritt = step  
die Studie = study  
bereit = ready  
besonders = especially  
gewiss = certain  
leiten — geleitet = to lead — led  
meist = most  
meistens = mostly  
mitten = in the middle  
neu = new  
seitdem = since then  
speziell = special  
spüren — gespürt = to feel — felt  
umgehen — umgegangen = to handle — handled  
verwenden — verwendet = to use — used  
vorbereiten — vorbereitet = to prepare — prepared  
zählen — gezählt = to count — counted  
übernehmen — übernommen = to take over — taken over  
der Arzt = doctor  
die Bevölkerung = population  
die Bewegung = movement  
die Bühne = stage  
der Einsatz = use  
der Einwohner = inhabitant  
die Hälfte = half  
die Landschaft = landscape  
die Meinung = opinion  
die Pandemie = pandemic  
die Pause = break  
der Sommer = summer  
die Türkei = Turkey  
ankommen — ist angekommen = to arrive — arrived  
backen — gebacken = to bake — baked  
bitte = please  
dagegen = against it  
darunter = under it  
einst = once  
gefährlich = dangerous  
grün = green  
heutzutage = nowadays  
innerhalb = within  
klingen — geklungen = to sound — sounded  
leisten — geleistet = to achieve — achieved  
planen — geplant = to plan — planned  
plötzlich = suddenly  
reden — geredet = to talk — talked  
starten — gestartet = to start — started  
sterben — er stirbt — ist gestorben = to die — he dies — died  
stolz = proud  
technisch = technical  
treten — getreten = to step — stepped  
unglaublich = incredible  
wahr = true  
überlegen — überlegt = to consider — considered  
die App = app  
der Beton = concrete  
das Datum = date  
der Druck = pressure  
die Entscheidung = decision  
die Erde = earth  
der Erfolg = success  
der Fisch = fish  
die Folge = consequence  
der Geschmack = taste  
das Instrument = instrument  
der Kontakt = contact  
die Lösung = solution  
das Muss = must  
die Produktion = production  
das Schnitzel = schnitzel  
beschäftigen — beschäftigt = to employ — employed  
einzeln = individually  
entsprechend = accordingly  
historisch = historical  
häufig = frequently  
leider = unfortunately  
längst = long since  
möglichst = as much as possible  
teilweise = partially  
trotz = despite  
typisch = typical  
öffnen — geöffnet = to open — opened  
das Fenster = window  
der Film = film  
das Gesicht = face  
der Lehrer = teacher  
die Liebe = love  
das Spiel = game  
das Werk = work  
anschauen — angeschaut = to look at — looked at  
besuchen — besucht = to visit — visited  
britisch = British  
ganz = whole  
lieb = dear  
lieber = rather  
nachdem = after  
privat = private  
sammeln — gesammelt = to collect — collected  
schwarz = black  
testen — getestet = to test — tested  
ähnlich = similar  
die Ausbildung = education  
das Bauwerk = building  
der Chef = boss  
der Döner = doner kebab  
der Fan = fan  
Frankreich = France  
das Hotel = hotel  
die Kamera = camera  
die Kuh = cow  
die Küche = kitchen  
die Leidenschaft = passion  
die Pflanze = plant  
der Sohn = son  
die Sorge = worry  
der Spargel = asparagus  
der Star = star  
der Wert = value  
der Westen = west  
das Wort = word  
die Zahl = number  
bunt = colorful  
derzeit = currently  
ehrlich = honest  
endlich = finally  
erfinden — erfunden = to invent — invented  
fangen — gefangen = to catch — caught  
fliegen — ist geflogen = to fly — flew  
fotografieren — fotografiert = to photograph — photographed  
gebären — geboren = to give birth — born  
handeln — gehandelt = to act — acted  
interessant = interesting  
per = per  
rufen — gerufen = to call — called  
stattfinden — stattgefunden = to take place — took place  
teilen — geteilt = to share — shared  
vergessen — er vergisst — vergessen = to forget — he forgets — forgot  
vermitteln — vermittelt = to mediate — mediated  
weiß = white  
die Anlage = facility  
Bayern = Bavaria  
die Behörde = authority  
die Brücke = bridge  
die Entwicklung = development  
Hallo = hello  
der Herr = gentleman  
das Herz = heart
die Karriere = career  
das Kilo = kilo  
die Milch = milk  
die Milliarde = billion  
der Morgen = morning  
München = Munich  
Russland = Russia  
der Vorteil = advantage  
Weihnachten = Christmas  
das Zentrum = center  
das Zuhause = home  
aufbauen — aufgebaut = to build up — built up  
dritter = third  
entfernen — entfernt = to remove — removed  
eröffnen — eröffnet = to open — opened  
gering = low  
momentan = currently  
normalerweise = normally  
positiv = positive  
praktisch = practical  
russisch = Russian  
studieren — studiert = to study — studied  
ständig = constantly  
verbringen — verbracht = to spend — spent  
Österreich = Austria  
überzeugen — überzeugt = to convince — convinced  
Corona = Corona  
Deutsch = German  
das Essen = food  
der Experte = expert  
das Fahrrad = bicycle  
die Fahrt = trip  
der Fuß = foot  
das Gesetz = law  
die Größe = size  
die Maschine = machine  
die Mode = fashion  
die Polizei = police  
der Schutz = protection  
der Stoff = fabric  
die Tour = tour  
die Wahl = election  
der Weihnachtsbaum = Christmas tree  
bestimmen — bestimmt = to determine — determined  
bewusst = conscious  
folgen — gefolgt = to follow — followed  
französisch = French  
glücklich = happy  
günstig = favorable  
reagieren auf {Akk.} — reagiert = to react to — reacted  
retten — gerettet = to save — saved  
spannend = exciting  
trinken — getrunken = to drink — drank  
wunderbar = wonderful  
zwölf = twelve  
der Bau = construction  
die Branche = industry  
der Bruder = brother  
der Club = club  
das Dach = roof  
das Ergebnis = result  
Italien = Italy  
der Körper = body  
der Landwirt = farmer  
das Lebensmittel = food  
das Meer = sea  
das Motiv = motive  
der Nachbar = neighbor  
die Qualität = quality  
die Strecke = distance  
super = super  
das System = system  
der Tisch = table  
der Unterschied = difference  
die Verbindung = connection  
das Vorbild = role model  
der Wunsch = wish  
die Zutat = ingredient  
bilden — gebildet = to form — formed  
eins = one  
erwarten — erwartet = to expect — expected  
finden — gefunden = to find — found  
fällen — gefällt = to decide — decided  
gestalten — gestaltet = to design — designed  
global = global  
interessieren für {Akk.} — interessiert = to be interested in — interested  
investieren — investiert = to invest — invested  
lösen — gelöst = to solve — solved  
offiziell = official  
organisieren — organisiert = to organize — organized  
probieren — probiert = to try — tried  
streng = strict  
tausend = thousand  
türkisch = Turkish  
vegan = vegan  
verarbeiten — verarbeitet = to process — processed  
verbessern — verbessert = to improve — improved  
wesentlich = essential  
wirtschaftlich = economic  
zahlreich = numerous  
der Bauer = farmer  
der Besuch = visit  
die Botschaft = embassy  
die Freiheit = freedom  
die Gefahr = danger  
das Konzept = concept  
das Kostüm = costume  
die Luft = air  
der Mieter = tenant  
die Moschee = mosque  
das Mädchen = girl  
der Norden = north  
der Park = park  
die Pizza = pizza  
die Schokolade = chocolate  
die Show = show  
der Staat = state  
der Stein = stone  
die Stimme = voice  
Tausend = thousand  
der Tourismus = tourism  
der Urlaub = vacation  
der Weihnachtsmann = Santa Claus  
der Weltkrieg = world war  
anbieten — angeboten = to offer — offered  
begeistert = enthusiastic  
bereiten — vorbereitet = to prepare — prepared  
betreffen — betroffen = to affect — affected  
davor = before  
dein = your  
dran = on it  
einsetzen — eingesetzt = to use — used  
erzeugen — erzeugt = to produce — produced  
faszinierend = fascinating  
gut = good  
hierher = here  
kalt = cold  
landen — gelandet = to land — landed  
morgens = in the morning  
nämlich = namely  
stimmen — gestimmt = to vote — voted  
unbedingt = absolutely  
verteilen — verteilt = to distribute — distributed  
warm = warm  
weiterhin = furthermore  
wählen — gewählt = to choose — chosen  
zuerst = first  
überleben — überlebt = to survive — survived  
das Alter = age  
das Angebot = offer  
der Auftrag = order  
Belgien = Belgium  
Großbritannien = Great Britain  
das Handy = mobile phone  
das Insekt = insect  
der Kauf = purchase  
die Kosten = costs  
das Model = model  
der Musiker = musician  
die Plattform = platform  
der Protest = protest  
der Quadratmeter = square meter  
das Recht = right  
das Rezept = recipe  
der Schuh = shoe  
die Spur = trace  
der Tanz = dance  
der Ton = sound  
das Tor = goal  
das Training = training  
die Umwelt = environment  
der Vergleich = comparison  
das Wetter = weather  
aktiv = active  
aufwachsen — ist aufgewachsen = to grow up — grew up  
entfernt = remote  
füllen — gefüllt = to fill — filled  
greifen — gegriffen = to grab — grabbed  
irgendwas = something  
jedoch = however  
jährlich = annually  
kennenlernen — kennengelernt = to get to know — got to know  
lohnen — gelohnt = to be worth — was worth  
profitieren — profitiert = to profit — profited  
schlimm = bad  
sparen — gespart = to save — saved  
verschwinden — ist verschwunden = to disappear — disappeared  
wandern — ist gewandert = to hike — hiked  
wechseln — gewechselt = to change — changed  
üben — geübt = to practice — practiced  
die Architektur = architecture  
Asien = Asia  
der Auftritt = appearance  
der Brite = Briton  
das Büro = office  
das Erlebnis = experience  
die Flasche = bottle  
das Gegenteil = opposite  
das Geheimnis = secret  
Indien = India
die Insel = island  
das Interesse = interest  
die Lage = situation  
die Leistung = performance  
die Masse = mass  
der Nationalpark = national park  
der Patient = patient  
Polen = Poland  
der Roman = novel  
der Salat = salad  
die Seele = soul  
der Song = song  
die Steuer = tax  
die Unterstützung = support  
das Zimmer = room  
aufnehmen — aufgenommen = to record — recorded  
sich befinden — sich befunden = to be located — been located  
entwerfen — entworfen = to design — designed  
fordern — gefordert = to demand — demanded  
hinten = at the back  
hinterher = afterwards  
integrieren — integriert = to integrate — integrated  
jugendliche = youthful  
lustig = funny  
mitnehmen — mitgenommen = to take along — took along  
nahe = close  
nötig = necessary  
rauchen — geraucht = to smoke — smoked  
rot = red  
schlafen — er schläft — geschlafen = to sleep — he sleeps — slept  
schätzen — geschätzt = to estimate — estimated  
super = super  
ukrainisch = Ukrainian  
unabhängig = independent  
unten = below  
verantwortlich = responsible  
vertrauen — vertraut = to trust — trusted  
wann = when  
zweimal = twice  
übrig = remaining  
die Alternative = alternative  
die Altstadt = old town  
die Antwort = answer  
die Behinderung = disability  
die Brezel = pretzel  
der Bürger = citizen  
der Computer = computer  
das Detail = detail  
das Element = element  
der Engel = angel  
das Feld = field  
die Fläche = area  
der Gedanke = thought  
das Gemüse = vegetable  
das Gespräch = conversation  
das Handwerk = craft  
die Industrie = industry  
die Kraft = force  
der Käse = cheese  
der Laden = shop  
der Liter = liter  
die Mauer = wall  
die Nachfrage = demand  
die Nummer = number  
der Passagier = passenger  
das Patent = patent  
der Plan = plan  
das Ruhrgebiet = Ruhr area  
die Schwester = sister  
der See = lake  
die Sicherheit = safety  
das Umfeld = environment  
der Unterricht = lesson  
das Virus = virus  
der Wanderer = hiker  
der Wasserstoff = hydrogen  
die Werkstatt = workshop  
abends = in the evening  
ausprobieren — ausprobiert = to try out — tried out  
bedrohen — bedroht = to threaten — threatened  
beispielsweise = for example  
dahinter = behind it  
definitiv = definitely  
dienen — gedient = to serve — served  
einzigartig = unique  
falsch = wrong  
fein = fine  
froh = glad  
heraus = out  
inspirieren — inspiriert = to inspire — inspired  
kreativ = creative  
rechnen — gerechnet = to calculate — calculated  
schicken — geschickt = to send — sent  
sicherlich = certainly  
stoßen — gestoßen = to push — pushed  
verbieten — verboten = to forbid — forbidden  
verhindern — verhindert = to prevent — prevented  
vermutlich = presumably  
verrückt = crazy  
zuvor = before  
österreichisch = Austrian  
der Abend = evening  
der Arbeitsplatz = workplace  
der Architekt = architect  
der Brandenburger = Brandenburgian  
der Brief = letter  
Celsius = Celsius  
der Designer = designer  
das Fest = festival  
das Feuer = fire  
der Flughafen = airport  
der Garten = garden  
der Golf = golf  
die Haut = skin  
der Inhalt = content  
der Karneval = carnival  
das Klima = climate  
das Konzert = concert  
die Krise = crisis  
die Maske = mask  
die Oberfläche = surface  
das Paar = pair  
der Partner = partner  
der Politiker = politician  
der Rohstoff = raw material  
die Runde = round  
das Schwein = pig  
der Stress = stress  
der Student = student  
der Teilnehmer = participant  
der Test = test  
die Tochter = daughter  
die Tür = door  
die Variante = variant  
die Vielfalt = diversity  
der Walzer = waltz  
die Wand = wall  
die Wolle = wool  
die Wurzel = root  
ausschließlich = exclusively  
begeistern — begeistert = to inspire — inspired  
begleiten — begleitet = to accompany — accompanied  
brechen — er bricht — gebrochen = to break — he breaks — broke  
chinesisch = Chinese  
darin = in it  
derselbe = same  
desto = more  
durchaus = quite  
ersetzen — ersetzt = to replace — replaced  
festhalten — festgehalten = to hold on — held on  
feststellen — festgestellt = to determine — determined  
heben — gehoben = to lift — lifted  
heimisch = native  
klappen — geklappt = to work out — worked out  
kochen — gekocht = to cook — cooked  
kreieren — kreiert = to create — created  
leiden — gelitten = to suffer — suffered  
niederländisch = Dutch  
nördlich = northern  
professionell = professional  
servieren — serviert = to serve — served  
tot = dead  
trainieren — trainiert = to train — trained  
versorgen — versorgt = to provide — provided  
warnen — gewarnt = to warn — warned  
weder = neither  
wär = would be  
übrigens = by the way  
das Alphorn = alphorn  
das Ausland = foreign country  
das Bett = bed  
die Börse = stock exchange  
die DDR = GDR  
die Erfindung = invention  
das Flugzeug = airplane  
das Gas = gas  
die Gegend = area  
das Geräusch = noise  
die Großstadt = big city  
Hamburg = Hamburg  
der Junge = boy  
die Kleidung = clothing  
das Kunstwerk = artwork  
der Kölner = Cologne resident  
der Lauf = run  
der Lebkuchen = gingerbread  
der Motor = motor  
der Mut = courage  
die Möbel = furniture  
nee = no  
die Niederlande = Netherlands  
das Phänomen = phenomenon  
der Rest = rest  
das Salz = salt  
die Sicht = view  
die Szene = scene  
der Süden = south  
die Temperatur = temperature  
der Tunnel = tunnel  
der Verein = club  
die Verfügung = provision  
die Wirtschaft = economy  
anlegen — angelegt = to invest — invested  
anstrengend = exhausting  
außen = outside  
beruflich = professional  
bestellen — bestellt = to order — ordered  
billig = cheap  
bislang = so far  
dennoch = nevertheless  
drinnen = inside  
ernst = serious  
früher = earlier  
gegenüber = opposite  
gemütlich = cozy  
heutig = today's  
irgendein = any  
kontrollieren — kontrolliert = to control — controlled  
malen — gemalt = to paint — painted  
mischen — gemischt = to mix — mixed  
nachts = at night  
präsentieren — präsentiert = to present — presented  
reduzieren — reduziert = to reduce — reduced  
singen — gesungen = to sing — sang  
ungewöhnlich = unusual  
verfolgen — verfolgt = to pursue — pursued  
verzichten — verzichtet = to do without — did without  
virtuell = virtual  
wunderschön = beautiful  
zuständig = responsible  
das Bein = leg  
das Blatt = leaf  
die Bäckerei = bakery  
cool = cool  
die Currywurst = currywurst  
das Dirndl = dirndl  
die Ecke = corner  
der Eindruck = impression  
die Erinnerung = memory  
der Fehler = mistake  
der Flüchtling = refugee  
die Fotografie = photography  
die Gemeinde = community  
die Gesundheit = health  
das Glas = glass  
der Glühwein = mulled wine  
das Haar = hair  
der Hintergrund = background  
das Hobby = hobby  
die Hoffnung = hope  
der Händler = trader  
der Impfstoff = vaccine  
der Kaiser = emperor  
der Kampf = fight  
das Kilogramm = kilogram  
die Klasse = class  
die Kohle = coal  
das Krankenhaus = hospital  
die Krankheit = disease  
der Kurs = course  
die Lust = desire  
das Mitglied = member  
das Mittel = means  
das Objekt = object  
online = online  
die Partei = party  
das Prinzip = principle  
das Publikum = audience  
die Realität = reality  
die Ressource = resource  
die Sammlung = collection  
das Schweden = Sweden  
die Sekunde = second  
das Smartphone = smartphone  
die Spende = donation  
das Stroh = straw  
das Studium = study  
die Technologie = technology  
die Verantwortung = responsibility  
der Verkehr = traffic  
das Vorurteil = prejudice  
die Ware = goods  
die Welle = wave  
die Werbung = advertising  
der Wind = wind  
der Wissenschaftler = scientist  
das Wochenende = weekend  
der Wolf = wolf  
der Zucker = sugar  
angehen — angegangen = to tackle — tackled  
anschließend = afterwards  
ansonsten = otherwise  
aufgeben — aufgegeben = to give up — gave up  
aufstellen — aufgestellt = to set up — set up  
außerhalb = outside  
beibringen — beigebracht = to teach — taught  
beitragen — beigetragen = to contribute — contributed  
belgisch = Belgian  
benutzen — benutzt = to use — used  
circa = approximately  
dahin = there  
entscheidend = decisive  
erforschen — erforscht = to research — researched  
errichten — errichtet = to erect — erected  
extra = extra  
gesund = healthy  
herrschen — geherrscht = to rule — ruled  
krank = sick  
langfristig = long-term  
letztendlich = ultimately  
links = left  
motivieren — motiviert = to motivate — motivated  
mussten — gemusst = had to  
nebenan = next door  
niedrig = low  
niemals = never  
ruhig = quiet  
sauber = clean  
scharf = sharp  
scheitern — gescheitert = to fail — failed  
selbstverständlich = of course  
sichtbar = visible  
süß = sweet  
transportieren — transportiert = to transport — transported  
treiben — getrieben = to drive — driven  
trocken = dry  
veröffentlichen — veröffentlicht = to publish — published  
vorne = in front  
öfter = more often  
der Abstand = distance  
das Album = album  
der Alkohol = alcohol  
die Aussicht = view  
die Band = band  
die Basis = basis  
die Bedingung = condition  
das Bewusstsein = consciousness  
das Bord = board  
Brasilien = Brazil  
die Burg = castle  
der Cent = cent  
der Dank = thanks  
der Dollar = dollar  
das Drittel = third  
das Ei = egg  
der Fahrer = driver  
der Finger = finger  
die Freude = joy  
das Geschenk = gift  
der Hersteller = manufacturer  
die Herstellung = production  
der Hof = yard  
Indonesien = Indonesia  
die Institution = institution  
die KI (Künstliche Intelligenz) = AI (Artificial Intelligence)  
der Kaugummi = chewing gum  
der King = king  
der Klang = sound  
der Klimawandel = climate change  
Köln = Cologne  
die Lehrerin = teacher  
der Look = look  
der Mythos = myth  
das Oktoberfest = Oktoberfest  
das Original = original  
der Post = post  
das Risiko = risk  
der Rücken = back  
der Schaden = damage  
der Schnitt = cut  
der Schwarzwald = Black Forest  
das Ski = ski  
der Stil = style  
das Studio = studio  
das Symbol = symbol  
der Teig = dough  
der Tod = death  
die Umfrage = survey  
der Umsatz = turnover  
der Ursprung = origin  
das Viertel = quarter  
die Vorstellung = performance  
der Wagen = car  
das Wahrzeichen = landmark  
der Weihnachtsmarkt = Christmas market  
der Wein = wine  
achten — geachtet = to respect — respected  
analog = analog  
anderthalb = one and a half  
aufmerksam = attentive  
bearbeiten — bearbeitet = to edit — edited  
behaupten — behauptet = to claim — claimed  
benötigen — benötigt = to need — needed  
dank = thanks to  
derjenige = that one  
dokumentieren — dokumentiert = to document — documented  
einstellen — eingestellt = to hire — hired  
elf = eleven  
entspannen — entspannt = to relax — relaxed  
entweder = either  
ermöglichen — ermöglicht = to enable — enabled  
faszinieren — fasziniert = to fascinate — fascinated  
fertigen — gefertigt = to manufacture — manufactured  
fliehen — ist geflohen = to flee — fled  
fürchten — gefürchtet = to fear — feared  
geraten — geraten = to advise — advised  
gewöhnen — gewöhnt = to get used to — got used to  
heiß = hot  
hinaus = out  
hundert = hundred  
immerhin = after all  
interessiert = interested  
konzentrieren sich — konzentriert = to concentrate — concentrated  
laden — geladen = to load — loaded  
leer = empty  
magisch = magical  
maximal = maximum  
mitmachen — mitgemacht = to participate — participated  
mobil = mobile  
passend = fitting  
real = real  
recht = right  
reich = rich  
reisen — gereist = to travel — traveled  
rennen — ist gerannt = to run — ran  
runter = down  
schneiden — geschnitten = to cut — cut  
schön = beautiful  
sodass = so that  
stören — gestört = to disturb — disturbed  
trauen — getraut = to dare — dared  
träumen von {Dat.} — geträumt = to dream of — dreamed  
ursprünglich = originally  
verletzen — verletzt = to injure — injured  
werfen — er wirft — geworfen = to throw — he throws — threw  
wertvoll = valuable  
zeichnen — gezeichnet = to draw — drew  
zukünftig = future  
überraschen — überrascht = to surprise — surprised  
Afrika = Africa  
die Agentur = agency  
der Arbeitgeber = employer  
die Bahn = train  
der Bahnhof = train station  
die Baustelle = construction site  
das Bulgarien = Bulgaria  
der Bundestag = Bundestag  
das Dia = slide  
der Durchschnitt = average  
die EU = EU  
der Effekt = effect  
einfach = simple  
das Erbe = inheritance  
der Februar = February  
der Flug = flight  
die Forschung = research  
das Frankfurt = Frankfurt  
die Gemeinschaft = community  
das Grundeinkommen = basic income  
die Haltung = attitude  
der Hamburger = hamburger  
der Handwerker = craftsman  
die Heimatstadt = hometown  
die Identität = identity  
die Innenstadt = city center  
Japan = Japan  
der Kanal = channel  
der Kebab = kebab  
die Kollektion = collection  
der Krebs = cancer  
Leipzig = Leipzig  
die Lokomotive = locomotive  
die Macht = power  
das Mehl = flour  
der Müll = garbage  
die Nachricht = news  
der Oldtimer = vintage car  
Pakistan = Pakistan  
der Pariser = Parisian  
die Party = party  
Potsdam = Potsdam  
das Programm = program  
der Rock = rock  
die Schicht = layer  
die Spezialität = specialty  
die Sportart = sport  
die Spree = Spree  
der Start = start  
die Suche = search  
das Tal = valley  
der Teller = plate  
der Termin = appointment  
der Turm = tower  
der Tänzer = dancer  
der User = user  
der VW = VW  
die Vergangenheit = past  
der Verkauf = sale  
die Veränderung = change  
der Volkswagen = Volkswagen  
die Weihnachtsgurke = Christmas pickle  
das Wohnzimmer = living room  
die Zeichnung = drawing  
der Zirkus = circus  
der Zustand = condition  
der Abgeordnete = representative  
anpassen sich — angepasst = to adapt — adapted  
austauschen — ausgetauscht = to exchange — exchanged  
bedienen — bedient = to serve — served  
beeindrucken — beeindruckt = to impress — impressed  
beeindruckend = impressive  
beeinflussen — beeinflusst = to influence — influenced  
behalten — behalten = to keep — kept  
der Bekannte = acquaintance  
berühren — berührt = to touch — touched  
beweisen — bewiesen = to prove — proved  
diskutieren — diskutiert = to discuss — discussed  
erstmal = first  
erwachsen = adult  
ewig = eternal  
exportieren — exportiert = to export — exported  
genügend = enough  
herkommen — gekommen = to come from — came from  
indem = by  
innen = inside  
insbesondere = especially  
insofern = insofar  
kaputt = broken  
offensichtlich = obvious  
recyceln — recycelt = to recycle — recycled  
schwimmen — geschwommen = to swim — swam  
sowohl = both  
spanisch = Spanish  
treu = loyal  
umsetzen — umgesetzt = to implement — implemented  
verwandeln — verwandelt = to transform — transformed  
vorhanden = available  
wahrnehmen — wahrgenommen = to perceive — perceived  
weitergehen — weitergegangen = to continue — continued  
wert = worth  
wiederum = in turn  
willkommen = welcome  
das Abenteuer = adventure  
die Anerkennung = recognition  
die Armee = army  
der Artikel = article  
die Auswirkung = effect  
die Bank = bank  
der Bauch = belly  
der Beginn = beginning  
der Beitrag = contribution  
die Belastung = burden  
die Beziehung = relationship  
der Bezug = reference  
die Blüte = blossom  
die Brauerei = brewery  
das Bundesland = federal state  
der Bürgermeister = mayor  
die Community = community  
das Design = design  
die Diagnose = diagnosis  
der Diesel = diesel  
Düsseldorf = Düsseldorf  
die Ehre = honor  
die Emotion = emotion  
das Ensemble = ensemble  
der Esel = donkey  
das Experiment = experiment  
der Follower = follower  
die Freundschaft = friendship  
die Fähigkeit = ability  
das Gebiet = area  
das Gerät = device  
das Getreide = grain  
die Gewalt = violence  
Grönland = Greenland  
der Handel = trade  
die Initiative = initiative  
die Inspiration = inspiration  
der Investor = investor  
der Keller = cellar  
der Kredit = credit  
das Kreuzfahrtschiff = cruise ship  
die Kugel = ball  
die Kulisse = backdrop  
der Käufer = buyer  
der Köhler = charcoal burner  
die Landwirtschaft = agriculture  
der Lohn = wage  
der Müller = miller  
der Oktober = October  
der Pist = pistol  
der Planet = planet  
die Pommes = fries  
der Rattenfänger = rat catcher  
der Reichstag = Reichstag  
die Reihe = row  
der Rhein = Rhine  
der Sand = sand  
der Schluss = end  
die Schwierigkeit = difficulty  
die Schönheit = beauty  
das Social = social  
die Spitze = tip  
die Staatsbürgerschaft = citizenship  
die Station = station  
die Stiftung = foundation  
die Stimmung = mood  
der Supermarkt = supermarket  
der Trainer = trainer  
der Verbraucher = consumer  
die Version = version  
das Volk = people  
die Vorbereitung = preparation  
der West = west  
die Wildkräuter = wild herbs  
das Wunder = wonder  
die Wärme = warmth  
das Zeichen = sign  
der Zufall = coincidence  
der Zuschauer = viewer  
ansagen — angesagt = to announce — announced  
ansehen — angesehen = to watch — watched  
anziehen — angezogen = to put on — put on  
arm = poor  
aufregend = exciting  
aussterben — ausgestorben = to go extinct — went extinct  
automatisch = automatic  
außergewöhnlich = extraordinary  
behandeln — behandelt = to treat — treated  
beziehen — bezogen = to relate — related  
blau = blue  
bloß = only  
buchen — gebucht = to book — booked  
diverser = more diverse  
doppelt = double  
drüber = over it  
dunkel = dark  
durchschnittlich = average  
dünn = thin  
effizient = efficient  
eingehen — eingegangen = to enter — entered  
einheimisch = local  
elektrisch = electric  
empfinden — empfunden = to feel — felt  
erfüllen — erfüllt = to fulfill — fulfilled  
ergeben — ergeben = to result — resulted  
erledigen — erledigt = to complete — completed  
erschaffen — erschaffen = to create — created  
fantastisch = fantastic  
finanziell = financial  
fördern — gefördert = to promote — promoted  
gelangen — gelangt = to reach — reached  
gestern = yesterday  
gigantisch = gigantic  
grundsätzlich = fundamentally  
haben — er hat — gehabt = to have — he has — had  
hauptsächlich = mainly  
herausfinden — herausgefunden = to find out — found out  
herkömmlich = conventional  
hinein = into  
hinzu = in addition  
hochwertig = high-quality  
hoffentlich = hopefully  
ideal = ideal  
irgendwelcher = any  
italienisch = Italian  
jahrelang = for years  
kleben — geklebt = to stick — stuck  
kompliziert = complicated  
künftig = future  
künstlich = artificial  
lebend = alive  
lecker = delicious  
lenken — gelenkt = to steer — steered  
letztlich = ultimately  
olympisch = Olympic  
regional = regional  
schießen — geschossen = to shoot — shot  
sichern — gesichert = to secure — secured  
sinken — gesenkt = to sink — sank  
sportlich = sporty  
trennen — getrennt = to separate — separated  
umso = all the more  
unterscheiden — unterschieden = to distinguish — distinguished  
verbreiten — verbreitet = to spread — spread  
vereinen — vereint = to unite — united  
vertreiben — vertrieben = to drive away — drove away  
weich = soft  
widmen — gewidmet = to dedicate — dedicated  
zentral = central  
ökologisch = ecological  
die Ahnung = idea  
der Anteil = share  
der Arbeitnehmer = employee  
die Aufmerksamkeit = attention  
die Aufnahme = recording  
der Ausflug = excursion  
die Autobahn = highway  
der Autor = author  
der Ball = ball  
die Bedeutung = meaning  
der Bunker = bunker  
die Butter = butter  
der Charakter = character  
die Diversität = diversity  
das Dutzend = dozen  
die Ebene = level  
die Fashion = fashion  
die Fassade = facade  
der Forscher = researcher  
der Franzose = Frenchman  
das Frühstück = breakfast  
das Gefängnis = prison  
das Gehalt = salary  
das Gehirn = brain  
das Gewicht = weight  
der Gletscher = glacier  
das Gold = gold  
der Großteil = majority  
der Großvater = grandfather  
das Gut = good  
die Handarbeit = handicraft  
hey = hey  
das Highlight = highlight  
der Himmel = sky  
der Holzmarkt = timber market  
die Innovation = innovation  
die Intelligenz = intelligence  
der Juli = July  
die Kartoffel = potato  
die Katastrophe = catastrophe  
die Kindheit = childhood  
der Klassiker = classic  
der Kontinent = continent  
die Koralle = coral  
der Kranich = crane  
die Kräuter = herbs  
das Kurzem = short term  
der Mauerfall = fall of the wall  
die Maßnahme = measure  
das Mittelalter = Middle Ages  
das Münster = minster  
das Ohr = ear  
die Oma = grandma  
das Opfer = victim  
die Option = option  
der Ost = east  
das Papier = paper  
die Perspektive = perspective  
das Preußen = Prussia  
der Rassismus = racism  
der Respekt = respect  
die Schneekugel = snow globe  
die Schulter = shoulder  
das Spanien = Spain  
der Spieler = player  
der Stadtteil = district  
der Strand = beach  
die Struktur = structure  
der Tipp = tip  
der Titel = title  
der Trick = trick  
die Tänzerin = dancer  
die Universität = university  
die Veranstaltung = event  
das Verkehrsmittel = means of transport  
der Versuch = attempt  
das Wachstum = growth  
das Weingut = winery  
der Weizen = wheat  
das Werkzeug = tool  
der Wettbewerb = competition  
der Zoo = zoo  
abbauen — abgebaut = to dismantle — dismantled  
der Angestellte = employee  
ausgehen — ausgegangen = to go out — went out  
auskommen — ausgekommen = to get along — got along  
ausstatten — ausgestattet = to equip — equipped  
beschreiben — beschrieben = to describe — described  
besetzen — besetzt = to occupy — occupied  
beteiligen — beteiligt = to participate — participated  
betrachten — betrachtet = to consider — considered  
breit = wide  
brennen — gebrannt = to burn — burned  
dankbar = grateful  
darstellen — dargestellt = to represent — represented  
dauerhaft = permanent  
dick = thick  
diesmal = this time  
ebenfalls = also  
ebenso = equally  
einerseits = on the one hand  
einladen — eingeladen = to invite — invited  
enden — geendet = to end — ended  
enorm = enormous  
enthalten — enthalten = to contain — contained  
entsorgen — entsorgt = to dispose — disposed  
erkunden — erkundet = to explore — explored  
erlauben — erlaubt = to allow — allowed  
erneuerbar = renewable  
erscheinen — erschienen = to appear — appeared  
exklusiv = exclusive  
finanzieren — finanziert = to finance — financed  
freiwillig = voluntary  
geheim = secret  
geil = cool  
gewaltig = huge  
großartig = great  
grün = green  
herum = around  
jedenfalls = anyway  
kehren — gekehrt = to return — returned  
mehrfach = multiple  
melden — gemeldet = to report — reported  
mutig = brave  
nachdenken — nachgedacht = to think — thought  
nachher = afterwards  
nix = nothing  
nähen — genäht = to sew — sewed  
polnisch = Polish  
ran = to it  
reinigen — gereinigt = to clean — cleaned  
richten — gerichtet = to direct — directed  
schade = too bad  
senken — gesenkt = to lower — lowered  
sowieso = anyway  
traurig = sad  
unmöglich = impossible  
unterrichten — unterrichtet = to teach — taught  
von = from  
verdanken — verdankt = to owe — owed  
verhalten — verhalten = to behave — behaved  
vorsichtig = careful  
wachsend = growing  
wahnsinnig = insane  
wenigstens = at least  
zugleich = at the same time  
übersetzen — übersetzt = to translate — translated  
die Aktion = action  
der Antrieb = drive  
die Anzahl = number  
der Apfelstrudel = apple strudel  
der April = April  
der Arbeiter = worker  
das Atelier = studio  
der Ausblick = view  
das Baujahr = year of construction  
der Bayer = Bavarian  
der Besitzer = owner  
das Brandenburg = Brandenburg  
das Brotbier = bread beer  
der Bäcker = baker  
das Chaos = chaos  
der Chinese = Chinese  
das Christkind = Christ child  
die Demokratie = democracy  
das Eiweiß = protein  
die Emission = emission  
die Etage = floor  
der Fahrgast = passenger  
die Faszination = fascination  
die Flucht = escape  
der Fokus = focus  
der Fortschritt = progress  
der Fotograf = photographer  
die Freizeit = leisure time  
der Fund = find  
der Fußball = soccer  
die Galerie = gallery  
der Geburtstag = birthday  
der Gegner = opponent  
die Gelegenheit = opportunity  
das Gewürz = spice  
der Hafen = harbor  
die Hast = haste  
der Haushalt = household  
die Haustür = front door  
der Hund = dog  
das Immunsystem = immune system  
das Island = Iceland  
der Jakobsweg = Camino de Santiago  
der Journalist = journalist  
jung = young  
der Kaffee = coffee  
die Kasse = cash register  
die Kinderarbeit = child labor  
das Kino = cinema  
der Klotz = block  
die Konkurrenz = competition  
der Konzern = corporation  
die Kälte = cold  
das Label = label  
der Ladepunkt = charging point  
der Lebensraum = habitat  
das Leder = leather  
die Linie = line  
der Macher = maker  
die Media = media  
der Migrant = migrant