sein — ist gewesen — war — wäre = بودن — بوده است — بود — می‌بود  
und = و  
in = در  
ein = یک  
haben — er hat — gehabt — hatte — hätte = داشتن — او دارد — داشته — داشت — می‌داشت  
zu = به  
es = آن  
auch = نیز  
werden — er wird — ist geworden = شدن — او می‌شود — شده است  
ich = من  
nicht = نه  
mit = با  
sie = او / آنها  
sich = خود  
für = برای  
von = از  
auf = روی  
so = بنابراین  
wir = ما  
können — ich/er kann — konnte — könnte = توانستن — من/او می‌تواند — می‌توانست — می‌توانست  
dass = که  
hier = اینجا  
an = در  
wie = چگونه  
man = انسان / یکی  
dieser = این  
aber = اما  
er = او  
dann = سپس  
als = وقتی که  
ihr = شما / آنها  
aus = از  
das Jahr = سال  
noch = هنوز  
bei = نزد  
machen — gemacht = ساختن — ساخته  
wenn = اگر  
mehr = بیشتر  
geben — er gibt — gegeben = دادن — او می‌دهد — داده  
nur = فقط  
da = آنجا  
also = بنابراین  
ganz = کاملاً  
ja = بله  
oder = یا  
immer = همیشه  
jetzt = حالا  
gut = خوب  
kommen — ist gekommen = آمدن — آمده است  
schon = قبلاً  
alle = همه  
nach = بعد  
gehen — ist gegangen = رفتن — رفته است  
um = حدود  
wollen — ich/er will — wollte = خواستن — من/او می‌خواهد — می‌خواست  
vor = قبل  
was = چه  
sehr = بسیار  
jeder = هر کس  
groß = بزرگ  
einfach = ساده  
mal = یک بار  
der Mensch = انسان  
der andere = دیگری  
kein = هیچ  
Deutschland = آلمان  
mein = من  
sagen — gesagt = گفتن — گفته  
doch = اما  
viel = زیاد  
sehen — er sieht — gesehen = دیدن — او می‌بیند — دیده  
wieder = دوباره  
über = درباره  
wer = چه کسی  
weil = چون  
sollen — ich/er soll — sollte — sollte = باید — من/او باید — باید — باید  
bis = تا  
müssen — ich/er muss — musste — müsste = مجبور بودن — من/او مجبور است — مجبور بود — مجبور بود  
neu = جدید  
heute = امروز  
natürlich = البته  
uns = ما  
finden — gefunden = پیدا کردن — پیدا شده  
unser = ما  
denn = زیرا  
aller = همه  
mir = من  
wirklich = واقعاً  
eigentlich = در واقع  
durch = از طریق  
der erste = اول  
die Stadt = شهر  
seit = از  
deutsch = آلمانی  
wo = کجا  
die Welt = جهان  
die Leute = مردم  
der Tag = روز  
stehen — gestanden = ایستادن — ایستاده  
die Zeit = زمان  
damit = با آن  
mich = من  
wissen — gewusst = دانستن — دانسته  
arbeiten — gearbeitet = کار کردن — کار کرده  
klein = کوچک  
leben — gelebt = زندگی کردن — زندگی کرده  
alt = قدیمی  
wichtig = مهم  
das Kind = کودک  
eben = دقیقاً  
erst = اول  
etwas = چیزی  
rund = دور  
sondern = بلکه  
halt = نگه داشتن  
das Haus = خانه  
dafür = برای آن  
das Beispiel = مثال  
selbst = خود  
schön = زیبا  
nehmen — er nimmt — genommen = گرفتن — او می‌گیرد — گرفته  
denken an {Akk.} — gedacht = فکر کردن — فکر کرده  
bekommen — bekommen = گرفتن — گرفته  
ohne = بدون  
das Leben = زندگی  
bleiben — ist geblieben = ماندن — مانده  
heißen — geheißen = نامیدن — نامیده  
du = تو  
eigen = خود  
dabei = در آنجا  
unter = زیر  
liegen — gelegen = دراز کشیدن — دراز کشیده  
vielleicht = شاید  
zeigen — gezeigt = نشان دادن — نشان داده  
gerade = دقیقاً  
das Land = کشور  
der Euro = یورو  
weniger = کمتر  
hoch = بالا  
glauben an {Akk.} — geglaubt = باور کردن — باور کرده  
drei = سه  
brauchen — gebraucht = نیاز داشتن — نیاز داشته  
richtig = درست  
die Frau = زن  
lang = طولانی  
gar = اصلاً  
tun — getan = انجام دادن — انجام داده  
schaffen — geschafft = ایجاد کردن — ایجاد کرده  
fast = تقریباً  
dürfen — ich/er darf — durfte — dürfte = اجازه داشتن — من/او اجازه دارد — اجازه داشت — اجازه داشت  
ob = آیا  
weit = دور  
dazu = به آن  
ihn = او  
möchten — ich/er möchte = خواستن — من/او می‌خواهد  
der Teil = بخش  
schnell = سریع  
genau = دقیقاً  
bauen — gebaut = ساختن — ساخته  
die Million = میلیون  
gehören zu {Dat.} — gehört = متعلق بودن — متعلق بوده  
lassen — er lässt — gelassen = گذاشتن — او می‌گذارد — گذاشته  
sogar = حتی  
das Prozent = درصد  
fahren — er fährt — ist gefahren = راندن — او می‌راند — رانده  
jung = جوان  
die Familie = خانواده  
das Problem = مشکل  
bringen — gebracht = آوردن — آورده  
der letzte = آخرین  
der Ort = مکان  
weiter = بیشتر  
die Idee = ایده  
das Wasser = آب  
der Berliner = برلینی  
nie = هرگز  
der nächste = بعدی  
ab = از  
haben — er hat — gehabt = داشتن — او دارد — داشته  
das Auto = ماشین  
nichts = هیچ چیز  
das Geld = پول  
dort = آنجا  
einmal = یک بار  
weltweit = جهانی  
das Ende = پایان  
ihnen = آنها  
oft = اغلب  
vier = چهار  
der Mann = مرد  
besonders = مخصوصاً  
ein bisschen = کمی  
die Woche = هفته  
irgendwie = به هر حال  
lernen — gelernt = یاد گرفتن — یاد گرفته  
versuchen — versucht = تلاش کردن — تلاش کرده  
spielen — gespielt = بازی کردن — بازی کرده  
die Geschichte = تاریخ  
zurück = عقب  
die Arbeit = کار
Europa = اروپا  
davon = از آن  
kennen — gekannt = شناختن — شناخته  
der Meter = متر  
einiger = برخی  
gegen = علیه  
die Stunde = ساعت  
schwer = سخت  
zusammen = با هم  
der Fall = مورد  
die Straße = خیابان  
der Weg = راه  
entstehen — ist entstanden = به وجود آمدن — به وجود آمده  
der Monat = ماه  
halten — er hält — gehalten = نگه داشتن — او نگه می‌دارد — نگه داشته  
das Mal = بار  
setzen {sich} — gesetzt = نشستن — نشسته  
spät = دیر  
anders = متفاوت  
beide = هر دو  
ihm = او  
stellen — gestellt = قرار دادن — قرار داده  
die Musik = موسیقی  
deshalb = بنابراین  
echt = واقعی  
fünf = پنج  
gleich = برابر  
pro = در هر  
das Bild = تصویر  
das Tier = حیوان  
führen — geführt = رهبری کردن — رهبری کرده  
stark = قوی  
tatsächlich = در واقع  
treffen {sich} — er trifft — getroffen = ملاقات کردن — او ملاقات می‌کند — ملاقات کرده  
die Sache = چیز  
die Schule = مدرسه  
warum = چرا  
solcher = چنین  
sprechen — er spricht — gesprochen = صحبت کردن — او صحبت می‌کند — صحبت کرده  
zehn = ده  
helfen — er hilft — geholfen = کمک کردن — او کمک می‌کند — کمک کرده  
verkaufen — verkauft = فروختن — فروخته  
früh = زود  
der Meister = استاد  
das Unternehmen = شرکت  
fühlen {sich} — gefühlt = احساس کردن — احساس کرده  
manchmal = گاهی  
überhaupt = اصلاً  
der Kunde = مشتری  
entwickeln {sich} — entwickelt = توسعه دادن — توسعه داده  
etwa = حدود  
mancher = برخی  
ein paar = چند تا  
zwischen = بین  
die Art = نوع  
das Jahrhundert = قرن  
bereits = قبلاً  
kaum = به سختی  
klar = واضح  
lang = طولانی  
ne = نه  
nutzen — genutzt = استفاده کردن — استفاده کرده  
die Region = منطقه  
bisschen = کمی  
deswegen = به همین دلیل  
erleben — erlebt = تجربه کردن — تجربه کرده  
toll = عالی  
der Freund = دوست  
die Zukunft = آینده  
essen — er isst — gegessen = خوردن — او می‌خورد — خورده  
der Platz = جایگاه  
der Spaß = تفریح  
schwierig = سخت  
nun = حالا  
beginnen — begonnen = شروع کردن — شروع کرده  
deutsch = آلمانی  
sogenannter = به اصطلاح  
suchensuchen nach {Akk.} — gesucht = جستجو کردن — جستجو کرده  
zwar = البته  
die Grenze = مرز  
das Team = تیم  
damals = آن زمان  
darauf = روی آن  
selber = خود  
welcher = کدام  
ziehen — gezogen = کشیدن — کشیده  
der Anfang = شروع  
passieren — ist passiert = اتفاق افتادن — اتفاق افتاده  
verschieden = مختلف  
das Gefühl = احساس  
der Raum = فضا  
erreichen — erreicht = رسیدن — رسیده  
gerne = با علاقه  
sonst = وگرنه  
kaufen — gekauft = خریدن — خریده  
laufen — er läuft — ist gelaufen = دویدن — او می‌دود — دویده  
produzieren — produziert = تولید کردن — تولید کرده  
trotzdem = با این حال  
der Besucher = بازدیدکننده  
das Ding = چیز  
die Firma = شرکت  
die Hand = دست  
der Kilometer = کیلومتر  
euch = شما  
leicht = آسان  
möglich = ممکن  
verändern {sich} — verändert = تغییر دادن — تغییر داده  
der Moment = لحظه  
während = در حالی که  
die Angst = ترس  
mittlerweile = در این میان  
die Natur = طبیعت  
allein = تنها  
dadurch = از این طریق  
gelten — gegolten = معتبر بودن — معتبر بوده  
die Generation = نسل  
der Grund = دلیل  
eher = بیشتر  
fallen — er fällt — ist gefallen = افتادن — او می‌افتد — افتاده  
funktionieren — funktioniert = کار کردن — کار کرده  
das Stück = قطعه  
am = در  
sitzen — ist gesessen = نشستن — نشسته  
unterwegs = در راه  
wenig = کم  
wohl = احتمالاً  
die Herausforderung = چالش  
der Kopf = سر  
die Seite = صفحه  
das Thema = موضوع  
fertig = آماده  
fragen — gefragt = پرسیدن — پرسیده  
der Gast = مهمان  
das Ziel = هدف  
darüber = درباره  
direkt = مستقیم  
komplett = کامل  
schauen — geschaut = نگاه کردن — نگاه کرده  
die Form = فرم  
das Projekt = پروژه  
die Wohnung = آپارتمان  
her = به اینجا  
sechs = شش  
sorgen für {Akk.} — gesorgt = مراقبت کردن — مراقبت کرده  
bewegen {sich} — bewegt = حرکت کردن — حرکت کرده  
bieten — geboten = ارائه دادن — ارائه داده  
kosten — gekostet = هزینه کردن — هزینه کرده  
rein = داخل  
sicher = مطمئن  
überall = همه جا  
hinter = پشت  
kurz = کوتاه  
tragen — er trägt — getragen = حمل کردن — او حمل می‌کند — حمل کرده  
voll = پر  
der Baum = درخت  
die Eltern = والدین  
die Mutter = مادر  
die Tradition = سنت  
herstellen — hergestellt = تولید کردن — تولید کرده  
je = هرگز  
lieben — geliebt = دوست داشتن — دوست داشته  
oben = بالا  
sozusagen = به اصطلاح  
steigen — ist gestiegen = بالا رفتن — بالا رفته  
wegen = به دلیل  
der Krieg = جنگ  
die Kunst = هنر  
allerdings = البته  
dauern — gedauert = طول کشیدن — طول کشیده  
hören — gehört = شنیدن — شنیده  
meinen — gemeint = منظور داشتن — منظور داشته  
merken — gemerkt = متوجه شدن — متوجه شده  
das Dorf = روستا  
das Museum = موزه  
aussehen — ausgesehen = به نظر رسیدن — به نظر رسیده  
beliebt = محبوب  
daran = به آن  
extrem = بسیار  
gemeinsam = مشترک  
insgesamt = در کل  
modern = مدرن  
verlieren — verloren = گم کردن — گم کرده  
das Fleisch = گوشت  
die Frage = سوال  
teuer = گران  
verstehen — verstanden = فهمیدن — فهمیده  
der zweite = دوم  
der Berg = کوه  
der Job = کار  
okay = خوب  
der Vater = پدر  
darum = به همین دلیل  
einzig = تنها  
erzählen — erzählt = تعریف کردن — تعریف کرده  
mögen — ich/er mag — mochte = دوست داشتن — من/او دوست دارد — دوست داشت  
die Minute = دقیقه  
der Mitarbeiter = همکار  
der Winter = زمستان  
bekannt = معروف  
besonder = خاص  
erkennen — erkannt = تشخیص دادن — تشخیص داده  
international = بین‌المللی  
nennen — genannt = نامیدن — نامیده  
normal = معمولی  
die Erfahrung = تجربه  
die Heimat = وطن  
die Technik = فناوری  
hin = به آنجا  
jemand = کسی  
statt = به جای  
der Grad = درجه  
der Künstler = هنرمند  
der Markt = بازار  
der Tourist = توریست  
kriegen — gekriegt = گرفتن — گرفته  
raus = بیرون  
wachsen — ist gewachsen = رشد کردن — رشد کرده  
ziemlich = نسبتاً  
die Energie = انرژی  
das Foto = عکس  
die Richtung = جهت  
alle = همه  
bestimmt = قطعاً  
europäisch = اروپایی  
irgendwann = زمانی  
verbinden — verbunden = وصل کردن — وصل کرده  
der Blick = نگاه  
das Buch = کتاب  
die Möglichkeit = امکان  
der Name = نام  
knapp = کم  
los = شروع  
mehrere = چندین  
quasi = به نوعی  
schlecht = بد  
der Alltag = زندگی روزمره  
das Geschäft = کسب‌وکار  
frei = آزاد  
freuen {sich} über / auf {Akk.} — gefreut = خوشحال شدن — خوشحال شده  
gucken — geguckt = نگاه کردن — نگاه کرده  
inzwischen = در این میان  
schreiben — geschrieben = نوشتن — نوشته  
stecken — gesteckt = فرو کردن — فرو کرده  
verdienen — verdient = درآمد داشتن — درآمد داشته  
wohnen — gewohnt = زندگی کردن — زندگی کرده  
die Hilfe = کمک  
der Preis = قیمت  
das Produkt = محصول  
das Restaurant = رستوران  
das Schloss = قلعه  
der Schüler = دانش‌آموز  
die USA = ایالات متحده  
die Ukraine = اوکراین  
das Video = ویدیو  
digital = دیجیتال  
erhalten — erhalten = دریافت کردن — دریافت کرده  
genießen — genossen = لذت بردن — لذت برده  
kämpfen — gekämpft = جنگیدن — جنگیده  
persönlich = شخصی  
tanzen — getanzt = رقصیدن — رقصیده  
das Licht = نور  
der Sport = ورزش  
bedeuten — bedeutet = معنی دادن — معنی داده  
berühmt = معروف  
bevor = قبل از  
drin = داخل  
egal = مهم نیست  
entdecken — entdeckt = کشف کردن — کشف کرده  
gleichzeitig = همزمان  
neben = کنار  
sieben = هفت  
vorher = قبل  
ändern — geändert = تغییر دادن — تغییر داده  
die Situation = وضعیت  
die Uhr = ساعت  
bald = به زودی  
bezahlen — bezahlt = پرداخت کردن — پرداخت کرده  
einige = برخی  
irgendwo = جایی  
offen = باز  
ungefähr = حدود  
das Bier = آبجو  
das Gebäude = ساختمان  
das Jahrzehnt = دهه  
die Nähe = نزدیکی  
die Person = شخص  
der Schweizer = سوئیسی  
der Wald = جنگل  
aktuell = فعلی  
fehlen — gefehlt = کمبود داشتن — کمبود داشته  
genauso = دقیقاً  
gewinnen — gewonnen = بردن — برده  
hoffen auf {Akk.} — gehofft = امیدوار بودن — امیدوار بوده  
sozial = اجتماعی  
stammen — gestammt = سرچشمه گرفتن — سرچشمه گرفته  
vergangen = گذشته  
zumindest = حداقل  
öffentlich = عمومی  
die Farbe = رنگ  
das Glück = خوشبختی  
die Menge = مقدار  
die Rolle = نقش  
draußen = بیرون  
erfolgreich = موفق  
frisch = تازه  
holen — geholt = آوردن — آورده  
kümmern sich — gekümmert = مراقبت کردن — مراقبت کرده  
laut = بلند  
perfekt = کامل  
reichen — gereicht = کافی بودن — کافی بوده  
scheinen — geschienen = به نظر رسیدن — به نظر رسیده  
schützen — geschützt = محافظت کردن — محافظت کرده  
selten = نادر  
traditionell = سنتی  
vorstellen sich — vorgestellt = معرفی کردن — معرفی کرده  
warten auf {Akk.} — gewartet = منتظر بودن — منتظر بوده  
die Gruppe = گروه  
die Hauptstadt = پایتخت  
der Kollege = همکار  
der Traum = رویا  
anfangen — angefangen = شروع کردن — شروع کرده  
bisher = تاکنون  
daraus = از آن  
deutlich = واضح  
dir = تو  
gern = با علاقه  
passen zu {Dat.} — gepasst = مناسب بودن — مناسب بوده  
relativ = نسبی  
schmecken — geschmeckt = مزه دادن — مزه داده  
täglich = روزانه  
wirken — gewirkt = اثر گذاشتن — اثر گذاشته  
wünschen — gewünscht = آرزو کردن — آرزو کرده  
der Boden = زمین  
die Chance = فرصت  
China = چین  
die Figur = شکل  
das Holz = چوب  
der Punkt = نقطه  
die Regel = قانون  
acht = هشت  
bestehen — bestanden = تشکیل دادن — تشکیل داده  
hart = سخت  
klassisch = کلاسیک  
nein = نه  
weg = دور  
zahlen — gezahlt = پرداخت کردن — پرداخت کرده  
das Auge = چشم  
die Gesellschaft = جامعه  
die Höhe = ارتفاع  
das Medium = رسانه  
die Politik = سیاست  
der Sinn = معنی  
die Tonne = تن  
der Wiener = وینری  
der Zug = قطار  
dich = تو  
gesamt = کل  
lassen — er lässt — gelassen = گذاشتن — او می‌گذارد — گذاشته  
schließen — geschlossen = بستن — بسته  
wahrscheinlich = احتمالاً  
die Ausstellung = نمایشگاه  
die Marke = برند  
der Schnee = برف  
die Sprache = زبان  
alleine = تنها  
bayerisch = باواریایی  
daher = از این رو  
danach = بعد از آن  
drehen — gedreht = چرخاندن — چرخانده  
entscheiden — entschieden = تصمیم گرفتن — تصمیم گرفته  
fest = محکم  
genug = کافی  
schlagen — geschlagen = زدن — زده  
schließlich = در نهایت  
sofort = فوراً  
vorbei = تمام  
zusätzlich = اضافی  
die Alpen = آلپ  
das Brot = نان  
das Internet = اینترنت  
die Miete = اجاره  
die Mitte = وسط  
die Nacht = شب  
das Schiff = کشتی  
die Weise = روش  
betreiben — betrieben = اداره کردن — اداره کرده  
eng = تنگ  
erfahren — erfahren = تجربه کردن — تجربه کرده  
feiern — gefeiert = جشن گرفتن — جشن گرفته  
lesen — er liest — gelesen = خواندن — او می‌خواند — خوانده  
miteinander = با هم  
nah = نزدیک  
regelmäßig = منظم  
verlassen — er verlässt — verlassen = ترک کردن — او ترک می‌کند — ترک کرده  
die Information = اطلاعات  
absolut = مطلق  
außerdem = علاوه بر این  
beobachten — beobachtet = مشاهده کردن — مشاهده کرده  
nachhaltig = پایدار  
neun = نه  
obwohl = با وجود اینکه  
riesig = عظیم  
tief = عمیق  
total = کامل  
unterschiedlich = متفاوت  
völlig = کاملاً  
der Bereich = حوزه  
der Bewohner = ساکن  
der Dom = کلیسای جامع  
das Eis = یخ  
das Fahrzeug = وسیله نقلیه  
Gott = خدا  
die Kirche = کلیسا  
die Kultur = فرهنگ  
das Modell = مدل  
das Netz = شبکه  
die Reise = سفر  
die Schweiz = سوئیس  
der Strom = جریان  
Venedig = ونیز  
Wien = وین  
aufgrund = به دلیل  
drauf = روی آن  
ehemalig = سابق  
erklären — erklärt = توضیح دادن — توضیح داده  
gelingen — gelungen = موفق شدن — موفق شده  
gründen — gegründet = تأسیس کردن — تأسیس کرده  
halb = نیم  
legen — gelegt = گذاشتن — گذاشته  
sagen — gesagt = گفتن — گفته  
der Beruf = شغل  
der König = پادشاه  
Paris = پاریس  
die Regierung = دولت  
die Stelle = موقعیت  
der Trend = روند  
erinnern {sich} an {Akk.} — erinnert = یادآوری کردن — یادآوری کرده  
hängen — gehangen = آویزان بودن — آویزان بوده  
langsam = آهسته  
liefern — geliefert = تحویل دادن — تحویل داده  
mindestens = حداقل  
na = خوب  
niemand = هیچ‌کس  
politisch = سیاسی  
unterstützen — unterstützt = حمایت کردن — حمایت کرده  
zerstören — zerstört = نابود کردن — نابود کرده  
zunächst = ابتدا  
die Aufgabe = وظیفه  
der Betrieb = شرکت  
der Bus = اتوبوس  
das Gericht = دادگاه  
das Material = ماده  
die Ruhe = آرامش  
der Schritt = قدم  
die Studie = مطالعه  
bereit = آماده  
besonders = مخصوصاً  
gewiss = قطعاً  
leiten — geleitet = هدایت کردن — هدایت کرده  
meist = بیشتر  
meistens = معمولاً  
mitten = وسط  
neu = جدید  
seitdem = از آن زمان  
speziell = خاص  
spüren — gespürt = احساس کردن — احساس کرده  
umgehen — umgegangen = برخورد کردن — برخورد کرده  
verwenden — verwendet = استفاده کردن — استفاده کرده  
vorbereiten — vorbereitet = آماده کردن — آماده کرده  
zählen — gezählt = شمارش کردن — شمارش کرده  
übernehmen — übernommen = به عهده گرفتن — به عهده گرفته  
der Arzt = پزشک  
die Bevölkerung = جمعیت  
die Bewegung = حرکت  
die Bühne = صحنه  
der Einsatz = استفاده  
der Einwohner = ساکن  
die Hälfte = نیمه  
die Landschaft = منظره  
die Meinung = نظر  
die Pandemie = همه‌گیری  
die Pause = استراحت  
der Sommer = تابستان  
die Türکی = ترکیه  
ankommen — ist angekommen = رسیدن — رسیده  
backen — gebacken = پختن — پخته  
bitte = لطفاً  
dagegen = برعکس  
darunter = زیر آن  
einst = زمانی  
gefährlich = خطرناک  
grün = سبز  
heutzutage = امروزه  
innerhalb = درون  
klingen — geklungen = به نظر رسیدن — به نظر رسیده  
leisten — geleistet = انجام دادن — انجام داده  
planen — geplant = برنامه‌ریزی کردن — برنامه‌ریزی کرده  
plötzlich = ناگهانی  
reden — geredet = صحبت کردن — صحبت کرده  
starten — gestartet = شروع کردن — شروع کرده  
sterben — er stirbt — ist gestorben = مردن — او می‌میرد — مرده  
stolz = مغرور  
technisch = فنی  
treten — getreten = قدم گذاشتن — قدم گذاشته  
unglaublich = باورنکردنی  
wahr = واقعی  
überlegen — überlegt = فکر کردن — فکر کرده  
die App = اپلیکیشن  
der Beton = بتن  
das Datum = تاریخ  
der Druck = فشار  
die Entscheidung = تصمیم  
die Erde = زمین  
der Erfolg = موفقیت  
der Fisch = ماهی  
die Folge = نتیجه  
der Geschمack = طعم  
das Instrument = ابزار  
der Kontakt = تماس  
die Lösung = راه‌حل  
das Muss = ضرورت  
die Produktion = تولید  
das Schnitzel = اسنیتزل  
beschäftigen — beschäftigt = مشغول کردن — مشغول کرده  
einzeln = تک‌تک  
entsprechend = متناسب  
historisch = تاریخی  
häufig = مکرر  
leider = متأسفانه  
längst = مدتهاست  
möglichst = تا حد امکان  
teilweise = جزئی  
trotz = با وجود  
typisch = معمولی  
öffnen — geöffnet = باز کردن — باز کرده  
das Fenster = پنجره  
der Film = فیلم  
das Gesicht = صورت  
der Lehrer = معلم  
die Liebe = عشق  
das Spiel = بازی  
das Werk = اثر  
anschauen — angeschaut = نگاه کردن — نگاه کرده  
besuchen — besucht = بازدید کردن — بازدید کرده  
britisch = بریتانیایی  
ganz = کامل  
lieb = دوست‌داشتنی  
lieber = ترجیحاً  
nachdem = بعد از  
privat = خصوصی  
sammeln — gesammelt = جمع‌آوری کردن — جمع‌آوری کرده  
schwarz = سیاه  
testen — getestet = آزمایش کردن — آزمایش کرده  
ähnlich = مشابه  
die Ausbildung = آموزش  
das Bauwerk = ساختمان  
der Chef = رئیس  
der Döner = دونر  
der Fan = طرفدار  
Frankreich = فرانسه  
das Hotel = هتل  
die Kamera = دوربین  
die Kuh = گاو  
die Küche = آشپزخانه  
die Leidenschaft = اشتیاق  
die Pflanze = گیاه  
der Sohn = پسر  
die Sorge = نگرانی  
der Spargel = مارچوبه  
der Star = ستاره  
der Wert = ارزش  
der Westen = غرب  
das Wort = کلمه  
die Zahl = عدد  
bunt = رنگارنگ  
derzeit = در حال حاضر  
ehrlich = صادقانه  
endlich = بالاخره  
erfinden — erfunden = اختراع کردن — اختراع کرده  
fangen — gefangen = گرفتن — گرفته  
fliegen — ist geflogen = پرواز کردن — پرواز کرده  
fotografieren — fotografiert = عکاسی کردن — عکاسی کرده  
gebären — geboren = زاییدن — زاییده  
handeln — gehandelt = عمل کردن — عمل کرده  
interessant = جالب  
per = در هر  
rufen — gerufen = صدا زدن — صدا زده  
stattfinden — stattgefunden = برگزار شدن — برگزار شده  
teilen — geteilt = تقسیم کردن — تقسیم کرده  
vergessen — er vergisst — vergessen = فراموش کردن — او فراموش می‌کند — فراموش کرده  
vermitteln — vermittelt = انتقال دادن — انتقال داده  
weiß = سفید  
die Anlage = تأسیسات  
Bayern = بایرن  
die Behörde = اداره  
die Brücke = پل  
die Entwicklung = توسعه  
Hallo = سلام  
der Herr = آقا  
das Herz = قلب  
die Karriere = شغل  
das Kilo = کیلو  
die Milch = شیر  
die Milliarde = میلیارد  
der Morgen = صبح  
München = مونیخ  
Russland = روسیه  
der Vorteil = مزیت  
Weihnachten = کریسمس  
das Zentrum = مرکز  
das Zuhause = خانه  
aufbauen — aufgebaut = ساخت‌و‌ساز کردن — ساخت‌و‌ساز کرده  
dritter = سوم  
entfernen — entfernt = حذف کردن — حذف کرده  
eröffن — eröffnet = افتتاح کردن — افتتاح کرده  
gering = کم  
momentan = در حال حاضر  
normalerweise = معمولاً  
positiv = مثبت  
praktisch = عملی  
russisch = روسی  
studieren — studiert = تحصیل کردن — تحصیل کرده  
ständig = دائمی  
verbringen — verbracht = گذراندن — گذرانده  
Österreich = اتریش  
überzeugen — überzeugt = متقاعد کردن — متقاعد کرده  
Corona = کرونا  
Deutsch = آلمانی  
das Essen = غذا  
der Experte = متخصص  
das Fahrrad = دوچرخه  
die Fahrt = سفر  
der Fuß = پا  
das Gesetz = قانون  
die Größe = اندازه  
die Maschine = ماشین  
die Mode = مد  
die Polizei = پلیس  
der Schutz = محافظت  
der Stoff = ماده  
die Tour = تور  
die Wahl = انتخاب  
der Weihnachtsbaum = درخت کریسمس  
bestimmen — bestimmt = تعیین کردن — تعیین کرده  
bewusst = آگاهانه  
folgen — gefolgt = دنبال کردن — دنبال کرده  
französisch = فرانسوی  
glücklich = خوشحال  
günstig = مناسب  
reagieren auf {Akk.} — reagiert = واکنش نشان دادن — واکنش نشان داده  
retten — gerettet = نجات دادن — نجات داده  
spannend = جذاب  
trinken — getrunken = نوشیدن — نوشیده  
wunderbar = فوق‌العاده  
zwölf = دوازده  
der Bau = ساخت‌و‌ساز  
die Branche = صنعت  
der Bruder = برادر  
der Club = باشگاه  
das Dach = سقف  
das Ergebnis = نتیجه  
Italien = ایتالیا  
der Körper = بدن  
der Landwirt = کشاورز  
das Lebensmittel = مواد غذایی  
das Meer = دریا  
das Motiv = انگیزه  
der Nachbar = همسایه  
die Qualität = کیفیت  
die Strecke = مسیر  
super = عالی  
das System = سیستم  
der Tisch = میز  
der Unterschied = تفاوت  
die Verbindung = ارتباط  
das Vorbild = الگو  
der Wunsch = آرزو  
die Zutat = ماده تشکیل‌دهنده  
bilden — gebildet = تشکیل دادن — تشکیل داده  
eins = یک  
erwarten — erwartet = انتظار داشتن — انتظار داشته  
finden — gefunden = پیدا کردن — پیدا کرده  
fällen — gefällt = تصمیم گرفتن — تصمیم گرفته  
gestalten — gestaltet = طراحی کردن — طراحی کرده  
global = جهانی  
interessieren für {Akk.} — interessiert = علاقه‌مند بودن — علاقه‌مند بوده  
investieren — investiert = سرمایه‌گذاری کردن — سرمایه‌گذاری کرده  
lösen — gelöst = حل کردن — حل کرده  
offiziell = رسمی  
organisieren — organisiert = سازمان‌دهی کردن — سازمان‌دهی کرده  
probieren — probiert = امتحان کردن — امتحان کرده  
streng = سختگیر  
tausend = هزار  
türkisch = ترکی  
vegan = وگان  
verarbeiten — verarbeitet = پردازش کردن — پردازش کرده  
verbessern — verbessert = بهبود دادن — بهبود داده  
wesentlich = اساسی  
wirtschaftlich = اقتصادی  
zahlreich = فراوان  
der Bauer = کشاورز  
der Besuch = بازدید  
die Botschaft = سفارت  
die Freiheit = آزادی  
die Gefahr = خطر  
das Konzept = مفهوم  
das Kostüm = لباس  
die Luft = هوا  
der Mieter = مستأجر  
die Moschee = مسجد  
das Mädchen = دختر  
der Norden = شمال  
der Park = پارک  
die Pizza = پیتزا  
die Schokolade = شکلات  
die Show = نمایش  
der Staat = دولت  
der Stein = سنگ  
die Stimme = صدا  
Tausend = هزار  
der Tourismus = گردشگری  
der Urlaub = تعطیلات  
der Weihnachtsmann = بابانوئل  
der Weltkrieg = جنگ جهانی  
anbieten — angeboten = پیشنهاد دادن — پیشنهاد داده  
begeistert = هیجان‌زده  
bereiten — vorbereitet = آماده کردن — آماده کرده  
betreffen — betroffen = مربوط بودن — مربوط بوده  
davor = قبل از آن  
dein = تو  
dran = روی آن  
einsetzen — eingesetzt = استفاده کردن — استفاده کرده  
erzeugen — erzeugt = تولید کردن — تولید کرده  
faszinierend = جذاب  
gut = خوب  
hierher = به اینجا  
kalt = سرد  
landen — gelandet = فرود آمدن — فرود آمده  
morgens = صبح‌ها  
nämlich = یعنی  
stimmen — gestimmt = موافق بودن — موافق بوده  
unbedingت = حتماً  
verteilen — verteilt = توزیع کردن — توزیع کرده  
warm = گرم  
weiterhin = همچنان  
wählen — gewählt = انتخاب کردن — انتخاب کرده  
zuerst = اول  
überleben — überlebt = زنده ماندن — زنده مانده  
das Alter = سن  
das Angebot = پیشنهاد  
der Auftrag = سفارش  
Belgien = بلژیک  
Großbritannien = بریتانیای کبیر  
das Handy = تلفن همراه  
das Insekt = حشره  
der Kauf = خرید  
die Kosten = هزینه‌ها  
das Model = مدل  
der Musiker = موسیقیدان  
die Plattform = پلتفرم  
der Protest = اعتراض  
der Quadratmeter = متر مربع  
das Recht = حق  
das Rezept = دستور غذا  
der Schuh = کفش  
die Spur = رد  
der Tanz = رقص  
der Ton = صدا  
das Tor = دروازه  
das Training = تمرین  
die Umwelt = محیط زیست  
der Vergleich = مقایسه  
das Wetter = هوا  
aktiv = فعال  
aufwachsen — ist aufgewachsen = بزرگ شدن — بزرگ شده  
entfernt = دور  
füllen — gefüllt = پر کردن — پر کرده
greifen — gegriffen = گرفتن — گرفته  
irgendwas = هر چیزی  
jedoch = با این حال  
jährlich = سالانه  
kennenlernen — kennengelernt = آشنا شدن — آشنا شده  
lohnen — gelohnt = ارزش داشتن — ارزش داشته  
profitieren — profitiert = سود بردن — سود برده  
schlimم = بد  
sparen — gespart = صرفه‌جویی کردن — صرفه‌جویی کرده  
verschwinden — ist verschwunden = ناپدید شدن — ناپدید شده  
wandern — ist gewandert = پیاده‌روی کردن — پیاده‌روی کرده  
wechselن — gewechselt = تغییر دادن — تغییر داده  
üben — geübt = تمرین کردن — تمرین کرده  
die Architektur = معماری  
Asien = آسیا  
der Auftritt = اجرا  
der Brite = بریتانیایی  
das Büro = دفتر  
das Erlebnis = تجربه  
die Flasche = بطری  
das Gegenteil = مخالف  
das Geheimnis = راز  
Indien = هند  
die Insel = جزیره  
das Interesse = علاقه  
die Lage = موقعیت  
die Leistung = عملکرد  
die Masse = جرم  
der Nationalpark = پارک ملی  
der Patient = بیمار  
Polen = لهستان  
der Roman = رمان  
der Salat = سالاد  
die Seele = روح  
der Song = آهنگ  
die Steuer = مالیات  
die Unterstützung = حمایت  
das Zimmer = اتاق  
aufnehmen — aufgenommen = ضبط کردن — ضبط کرده  
sich befinden — sich befunden = قرار داشتن — قرار داشته  
entwerfen — entworfen = طراحی کردن — طراحی کرده  
fordern — gefordert = درخواست کردن — درخواست کرده  
hinten = پشت  
hinterher = بعد از آن  
integrieren — integriert = ادغام کردن — ادغام کرده  
jugendliche = جوان  
lustig = خنده‌دار  
mitnehmen — mitgenommen = همراه بردن — همراه برده  
nahe = نزدیک  
nötig = لازم  
rauchen — geraucht = سیگار کشیدن — سیگار کشیده  
rot = قرمز  
schlafen — er schläft — geschlafen = خوابیدن — او می‌خوابد — خوابیده  
schätzen — geschätzt = تخمین زدن — تخمین زده  
super = عالی  
ukrainisch = اوکراینی  
unabhängig = مستقل  
unten = پایین  
verantwortlich = مسئول  
vertrauen — vertraut = اعتماد کردن — اعتماد کرده  
wann = کی  
zweimal = دو بار  
übrig = باقی‌مانده  
die Alternative = جایگزین  
die Altstadt = شهر قدیمی  
die Antwort = پاسخ  
die Behinderung = معلولیت  
die Brezel = نان سوخاری  
der Bürger = شهروند  
der Computer = کامپیوتر  
das Detail = جزئیات  
das Element = عنصر  
der Engel = فرشته  
das Feld = زمین  
die Fläche = سطح  
der Gedanke = فکر  
das Gemüse = سبزیجات  
das Gespräch = گفتگو  
das Handwerk = صنایع دستی  
die Industrie = صنعت  
die Kraft = نیرو  
der Käse = پنیر  
der Laden = مغازه  
der Liter = لیتر  
die Mauer = دیوار  
die Nachfrage = تقاضا  
die Nummer = شماره  
der Passagier = مسافر  
das Patent = حق اختراع  
der Plan = برنامه  
das Ruhrgebiet = منطقه رور  
die Schwester = خواهر  
der See = دریاچه  
die Sicherheit = امنیت  
das Umfeld = محیط  
der Unterricht = درس  
das Virus = ویروس  
der Wanderer = پیاده‌رو  
der Wasserstoff = هیدروژن  
die Werkstatt = کارگاه  
abends = عصرها  
ausprobieren — ausprobiert = امتحان کردن — امتحان کرده  
bedrohen — bedroht = تهدید کردن — تهدید کرده  
beispielsweise = مثلاً  
dahinter = پشت آن  
definitiv = قطعاً  
dienen — gedient = خدمت کردن — خدمت کرده  
einzigartig = منحصربه‌فرد  
falsch = غلط  
fein = خوب  
froh = خوشحال  
heraus = بیرون  
inspirieren — inspiriert = الهام بخشیدن — الهام بخشیده  
kreativ = خلاق  
rechnen — gerechnet = محاسبه کردن — محاسبه کرده  
schicken — geschickt = فرستادن — فرستاده  
sicherlich = قطعاً  
stoßen — gestoßen = برخورد کردن — برخورد کرده  
verbieten — verboten = ممنوع کردن — ممنوع کرده  
verhindern — verhindert = جلوگیری کردن — جلوگیری کرده  
vermutlich = احتمالاً  
verrückt = دیوانه  
zuvor = قبل از آن  
österreichisch = اتریشی  
der Abend = عصر  
der Arbeitsplatz = محل کار  
der Architekt = معمار  
der Brandenburger = براندنبورگی  
der Brief = نامه  
Celsius = سانتی‌گراد  
der Designer = طراح  
das Fest = جشن  
das Feuer = آتش  
der Flughafen = فرودگاه  
der Garten = باغ  
der Golf = گلف  
die Haut = پوست  
der Inhalt = محتوا  
der Karneval = کارناوال  
das Klima = آب‌وهوا
das Konzert = کنسرت  
die Krise = بحران  
die Maske = ماسک  
die Oberfläche = سطح  
das Paar = زوج  
der Partner = شریک  
der Politiker = سیاستمدار  
der Rohstoff = ماده خام  
die Runde = دور  
das Schwein = خوک  
der Stress = استرس  
der Student = دانشجو  
der Teilnehmer = شرکت‌کننده  
der Test = آزمون  
die Tochter = دختر  
die Tür = در  
die Variante = نوع  
die Vielfalt = تنوع  
der Walzer = والس  
die Wand = دیوار  
die Wolle = پشم  
die Wurzel = ریشه  
ausschließlich = منحصراً  
begeistern — begeistert = هیجان‌زده کردن — هیجان‌زده کرده  
begleiten — begleitet = همراهی کردن — همراهی کرده  
brechen — er bricht — gebrochen = شکستن — او می‌شکند — شکسته  
chinesisch = چینی  
darin = در آن  
derselbe = همان  
desto = هر چه  
durchaus = کاملاً  
ersetzen — ersetzt = جایگزین کردن — جایگزین کرده  
festhalten — festgehalten = نگه داشتن — نگه داشته  
feststellen — festgestellt = تشخیص دادن — تشخیص داده  
heben — gehoben = بلند کردن — بلند کرده  
heimisch = محلی  
klappen — geklappt = موفق شدن — موفق شده  
kochen — gekocht = پختن — پخته  
kreieren — kreiert = ایجاد کردن — ایجاد کرده  
leiden — gelitten = رنج بردن — رنج برده  
niederländisch = هلندی  
nördlich = شمالی  
professionell = حرفه‌ای  
servieren — serviert = سرو کردن — سرو کرده  
tot = مرده  
trainieren — trainiert = تمرین کردن — تمرین کرده  
versorgen — versorgt = مراقبت کردن — مراقبت کرده  
warnen — gewarnt = هشدار دادن — هشدار داده  
weder = نه  
wär = گرم  
übrigens = به هر حال  
das Alphorn = آلفورن  
das Ausland = خارج  
das Bett = تخت  
die Börse = بورس  
die DDR = آلمان شرقی  
die Erfindung = اختراع  
das Flugzeug = هواپیما  
das Gas = گاز  
die Gegend = منطقه  
das Geräusch = صدا  
die Großstadt = شهر بزرگ  
Hamburg = هامبورگ  
der Junge = پسر  
die Kleidung = لباس  
das Kunstwerk = اثر هنری  
der Kölner = کلنی  
der Lauf = دویدن  
der Lebkuchen = نان زنجبیلی  
der Motor = موتور  
der Mut = شجاعت  
die Möbel = مبلمان  
nee = نه  
die Niederlande = هلند  
das Phänomen = پدیده  
der Rest = باقی‌مانده  
das Salz = نمک  
die Sicht = دید  
die Szene = صحنه  
der Süden = جنوب  
die Temperatur = دما  
der Tunnel = تونل  
der Verein = انجمن
die Verfügung = دسترسی  
die Wirtschaft = اقتصاد  
anlegen — angelegt = سرمایه‌گذاری کردن — سرمایه‌گذاری کرده  
anstrengend = خسته‌کننده  
außen = بیرون  
beruflich = حرفه‌ای  
bestellen — bestellt = سفارش دادن — سفارش داده  
billig = ارزان  
bislang = تاکنون  
dennoch = با این حال  
drinnen = داخل  
ernst = جدی  
früher = قبلاً  
gegenüber = مقابل  
gemütlich = دنج  
heutig = امروزی  
irgendein = هر کدام  
kontrollieren — kontrolliert = کنترل کردن — کنترل کرده  
malen — gemalt = نقاشی کردن — نقاشی کرده  
mischen — gemischt = مخلوط کردن — مخلوط کرده  
nachts = شب‌ها  
präsentieren — präsentiert = ارائه دادن — ارائه داده  
reduzieren — reduziert = کاهش دادن — کاهش داده  
singen — gesungen = خواندن — خوانده  
ungewöhnlich = غیرمعمول  
verfolgen — verfolgt = دنبال کردن — دنبال کرده  
verzichten — verzichtet = چشم‌پوشی کردن — چشم‌پوشی کرده  
virtuell = مجازی  
wunderschön = بسیار زیبا  
zuständig = مسئول  
das Bein = پا  
das Blatt = برگ  
die Bäckerei = نانوایی  
cool = جالب  
die Currywurst = کوری‌وورست  
das Dirndl = دیرندل  
die Ecke = گوشه  
der Eindruck = تأثیر  
die Erinnerung = خاطره  
der Fehler = اشتباه  
der Flüchtling = پناهنده  
die Fotografie = عکاسی  
die Gemeinde = جامعه  
die Gesundheit = سلامتی  
das Glas = لیوان  
der Glühwein = گلوواین  
das Haar = مو  
der Hintergrund = پس‌زمینه  
das Hobby = سرگرمی  
die Hoffnung = امید  
der Händler = فروشنده  
der Impfstoff = واکسن  
der Kaiser = امپراتور  
der Kampf = مبارزه  
das Kilogramm = کیلوگرم  
die Klasse = کلاس  
die Kohle = زغال‌سنگ  
das Krankenhaus = بیمارستان  
die Krankheit = بیماری  
der Kurs = دوره  
die Lust = میل  
das Mitglied = عضو  
das Mittel = وسیله  
das Objekt = شیء  
online = آنلاین  
die Partei = حزب  
das Prinzip = اصل  
das Publikum = مخاطب  
die Realität = واقعیت  
die Ressource = منبع  
die Sammlung = مجموعه  
das Schweden = سوئد  
die Sekunde = ثانیه  
das Smartphone = تلفن همراه  
die Spende = کمک مالی  
das Stroh = کاه  
das Studium = تحصیل  
die Technologie = فناوری  
die Verantwortung = مسئولیت  
der Verkehr = ترافیک  
das Vorurteil = پیش‌داوری  
die Ware = کالا  
die Welle = موج  
die Werbung = تبلیغات  
der Wind = باد  
der Wissenschaftler = دانشمند  
das Wochenende = آخر هفته  
der Wolf = گرگ  
der Zucker = شکر  
angehen — angegangen = شروع کردن — شروع کرده  
anschließend = پس از آن  
ansonsten = در غیر این صورت  
aufgeben — aufgegeben = تسلیم شدن — تسلیم شده  
aufstellen — aufgestellt = تنظیم کردن — تنظیم کرده  
außerhalb = خارج از  
beibringen — beigebracht = آموزش دادن — آموزش داده  
beitragen — beigetragen = مشارکت کردن — مشارکت کرده  
belgisch = بلژیکی  
benutzen — benutzt = استفاده کردن — استفاده کرده  
circa = حدود  
dahin = به آنجا  
entscheidend = تعیین‌کننده  
erforschen — erforscht = تحقیق کردن — تحقیق کرده  
errichten — errichtet = ساخت‌و‌ساز کردن — ساخت‌و‌ساز کرده  
extra = اضافی  
gesund = سالم  
herrschen — geherrscht = حکومت کردن — حکومت کرده  
krank = بیمار  
langfristig = بلندمدت  
letztendlich = در نهایت  
links = چپ  
motivieren — motiviert = انگیزه دادن — انگیزه داده  
mussten — gemusst = مجبور بودن — مجبور بوده  
nebenan = کنار  
niedrig = پایین  
niemals = هرگز  
ruhig = آرام  
sauber = تمیز  
scharf = تند  
scheitern — gescheitert = شکست خوردن — شکست خورده  
selbstverständlich = بدیهی  
sichtbar = قابل مشاهده  
süß = شیرین  
transportieren — transportiert = حمل کردن — حمل کرده  
treiben — getrieben = راندن — رانده  
trocken = خشک  
veröffentlichen — veröffentlicht = منتشر کردن — منتشر کرده  
vorne = جلو  
öfter = بیشتر  
der Abstand = فاصله  
das Album = آلبوم  
der Alkohol = الکل  
die Aussicht = چشم‌انداز  
die Band = گروه موسیقی  
die Basis = پایه  
die Bedingung = شرط  
das Bewusstsein = آگاهی  
das Bord = کشتی  
Brasilien = برزیل  
die Burg = قلعه  
der Cent = سنت  
der Dank = تشکر  
der Dollar = دلار  
das Drittel = یک سوم  
das Ei = تخم‌مرغ  
der Fahrer = راننده  
der Finger = انگشت  
die Freude = شادی  
das Geschenk = هدیه  
der Hersteller = تولیدکننده  
die Herstellung = تولید  
der Hof = حیاط  
Indonesien = اندونزی  
die Institution = مؤسسه  
die KI (Künstliche Intelligenz) = هوش مصنوعی  
der Kaugummi = آدامس  
der King = پادشاه  
der Klang = صدا  
der Klimawandel = تغییرات آب‌وهوایی  
Köln = کلن  
die Lehrerin = معلم زن  
der Look = ظاهر  
der Mythos = افسانه  
das Oktoberfest = فستیوال اکتبر  
das Original = نسخه اصلی  
der Post = پست  
das Risiko = خطر  
der Rücken = کمر  
der Schaden = آسیب  
der Schnitt = برش  
der Schwarzwald = جنگل سیاه  
das Ski = اسکی  
der Stil = سبک  
das Studio = استودیو  
das Symbol = نماد  
der Teig = خمیر  
der Tod = مرگ  
die Umfrage = نظرسنجی  
der Umsatz = فروش  
der Ursprung = منشأ  
das Viertel = یک چهارم  
die Vorstellung = نمایش  
der Wagen = ماشین  
das Wahrzeichen = نماد  
der Weihnachtsmarkt = بازار کریسمس  
der Wein = شراب  
achten — geachtet = احترام گذاشتن — احترام گذاشته  
analog = آنالوگ  
anderthalب = یک و نیم  
aufmerksam = توجه‌کننده  
bearbeiten — bearbeitet = ویرایش کردن — ویرایش کرده  
behaupten — behauptet = ادعا کردن — ادعا کرده  
benötigen — benötigt = نیاز داشتن — نیاز داشته  
dank = به لطف  
derjenige = آن  
dokumentieren — dokumentiert = مستند کردن — مستند کرده  
einstellen — eingestellt = استخدام کردن — استخدام کرده  
elf = یازده  
entspannen — entspannt = آرامش دادن — آرامش داده  
entweder = یا  
ermöglichen — ermöglicht = امکان‌پذیر کردن — امکان‌پذیر کرده  
faszinieren — fasziniert = جذب کردن — جذب کرده  
fertigen — gefertigt = تولید کردن — تولید کرده  
fliehen — ist geflohen = فرار کردن — فرار کرده  
fürchten — gefürchtet = ترسیدن — ترسیده  
geraten — geraten = پیشنهاد دادن — پیشنهاد داده  
gewöhnen — gewöhnt = عادت کردن — عادت کرده  
heiß = داغ  
hinaus = بیرون  
hundert = صد  
immerhin = حداقل  
interessiert = علاقه‌مند  
konzentrieren sich — konzentriert = تمرکز کردن — تمرکز کرده  
laden — geladen = بارگیری کردن — بارگیری کرده  
leer = خالی  
magisch = جادویی  
maximal = حداکثر  
mitmachen — mitgemacht = مشارکت کردن — مشارکت کرده  
mobil = موبایل  
passend = مناسب  
real = واقعی  
recht = درست  
reich = ثروتمند  
reisen — gereist = سفر کردن — سفر کرده  
rennen — ist gerannt = دویدن — دویده  
runter = پایین  
schneiden — geschnitten = بریدن — بریده  
schön = زیبا  
sodass = به طوری که  
stören — gestört = مزاحم بودن — مزاحم بوده  
trauen — getraut = اعتماد کردن — اعتماد کرده  
träumen von {Dat.} — geträumt = رویا دیدن — رویا دیده  
ursprünglich = اصلی  
verletzen — verletzt = آسیب زدن — آسیب زده  
werfen — er wirft — geworfen = پرتاب کردن — او پرتاب می‌کند — پرتاب کرده  
wertvoll = ارزشمند  
zeichnen — gezeichnet = طراحی کردن — طراحی کرده  
zukünftig = آینده  
überraschen — überrascht = غافلگیر کردن — غافلگیر کرده  
Afrika = آفریقا  
die Agentur = آژانس  
der Arbeitgeber = کارفرما  
die Bahn = قطار  
der Bahnhof = ایستگاه قطار  
die Baustelle = محل ساخت‌و‌ساز  
das Bulgarien = بلغارستان  
der Bundestag = پارلمان آلمان  
das Dia = اسلاید  
der Durchschnitt = میانگین  
die EU = اتحادیه اروپا  
der Effekt = اثر  
einfach = ساده  
das Erbe = میراث  
der Februar = فوریه  
der Flug = پرواز  
die Forschung = تحقیق  
das Frankfurt = فرانکفورت  
die Gemeinschaft = جامعه  
das Grundeinkommen = درآمد پایه  
die Haltung = نگرش  
der Hamburger = همبرگر  
der Handwerker = صنعتگر  
die Heimatstadt = شهر زادگاه  
die Identität = هویت  
die Innenstadt = مرکز شهر  
Japan = ژاپن  
der Kanal = کانال  
der Kebab = کباب  
die Kollektion = مجموعه  
der Krebs = سرطان  
Leipzig = لایپزیگ  
die Lokomotive = لوکوموتیو  
die Macht = قدرت  
das Mehl = آرد  
der Müll = زباله  
die Nachricht = خبر  
der Oldtimer = ماشین قدیمی  
Pakistan = پاکستان  
der Pariser = پاریسی  
die Party = مهمانی  
Potsdam = پوتسدام  
das Programm = برنامه  
der Rock = سنگ  
die Schicht = لایه  
die Spezialität = تخصص  
die Sportart = نوع ورزش  
die Spree = رودخانه اشپری  
der Start = شروع  
die Suche = جستجو  
das Tal = دره  
der Teller = بشقاب  
der Termin = قرار  
der Turm = برج  
der Tänzer = رقصنده  
der User = کاربر  
der VW = فولکس‌واگن  
die Vergangenheit = گذشته  
der Verkauf = فروش  
die Veränderung = تغییر  
der Volkswagen = فولکس‌واگن  
die Weihnachtsgurke = خیار کریسمس  
das Wohnzimmer = اتاق نشیمن  
die Zeichnung = طراحی  
der Zirkus = سیرک  
der Zustand = وضعیت  
der Abgeordnete = نماینده  
anpassen sich — angepasst = تطبیق دادن — تطبیق داده  
austauschen — ausgetauscht = تعویض کردن — تعویض کرده  
bedienen — bedient = سرو کردن — سرو کرده  
beeindrucken — beeindruckt = تحت تأثیر قرار دادن — تحت تأثیر قرار داده
beeindruckend = تأثیرگذار  
beeinflussen — beeinflusst = تأثیر گذاشتن — تأثیر گذاشته  
behalten — behalten = نگه داشتن — نگه داشته  
der Bekannte = آشنا  
berühren — berührt = لمس کردن — لمس کرده  
beweisen — bewiesen = اثبات کردن — اثبات کرده  
diskutieren — diskutiert = بحث کردن — بحث کرده  
erstmal = اول  
erwachsen = بالغ  
ewig = ابدی  
exportieren — exportiert = صادر کردن — صادر کرده  
genügend = کافی  
herkommen — gekommen = آمدن — آمده  
indem = با این که  
innen = داخل  
insbesondere = به ویژه  
insofern = به این ترتیب  
kaputt = خراب  
offensichtlich = آشکار  
recyceln — recycelt = بازیافت کردن — بازیافت کرده  
schwimmen — geschwommen = شنا کردن — شنا کرده  
sowohl = هر دو  
spanisch = اسپانیایی  
treu = وفادار  
umsetzen — umgesetzt = اجرا کردن — اجرا کرده  
verwandeln — verwandelt = تبدیل کردن — تبدیل کرده  
vorhanden = موجود  
wahrnehmen — wahrgenommen = درک کردن — درک کرده  
weitergehen — weitergegangen = ادامه دادن — ادامه داده  
wert = ارزش  
wiederum = دوباره  
willkommen = خوش‌آمد  
das Abenteuer = ماجراجویی  
die Anerkennung = تقدیر  
die Armee = ارتش  
der Artikel = مقاله  
die Auswirkung = تأثیر  
die Bank = بانک  
der Bauch = شکم  
der Beginn = شروع  
der Beitrag = مشارکت  
die Belastung = بار  
die Beziehung = رابطه  
der Bezug = ارتباط  
die Blüte = شکوفه  
die Brauerei = آبجوسازی  
das Bundesland = ایالت  
der Bürgermeister = شهردار  
die Community = جامعه  
das Design = طراحی  
die Diagnose = تشخیص  
der Diesel = دیزل  
Düsseldorf = دوسلدورف  
die Ehre = افتخار  
die Emotion = احساس  
das Ensemble = گروه  
der Esel = الاغ  
das Experiment = آزمایش  
der Follower = دنبال‌کننده  
die Freundschaft = دوستی  
die Fähigkeit = توانایی  
das Gebiet = منطقه  
das Gerät = دستگاه  
das Getreide = غلات  
die Gewalt = خشونت  
Grönland = گرینلند  
der Handel = تجارت  
die Initiative = ابتکار  
die Inspiration = الهام  
der Investor = سرمایه‌گذار  
der Keller = زیرزمین  
der Kredit = وام  
das Kreuzfahrtschiff = کشتی کروز  
die Kugel = توپ  
die Kulisse = صحنه  
der Käufer = خریدار  
der Köhler = زغال‌ساز  
die Landwirtschaft = کشاورزی  
der Lohn = دستمزد  
der Müller = آسیابان  
der Oktober = اکتبر  
der Pist = پیست  
der Planet = سیاره  
die Pommes = سیب‌زمینی سرخ‌کرده  
der Rattenfänger = موش‌گیر  
der Reichstag = رایشتاگ  
die Reihe = ردیف  
der Rhein = راین  
der Sand = شن  
der Schluss = پایان  
die Schwierigkeit = مشکل  
die Schönheit = زیبایی  
das Social = اجتماعی  
die Spitze = نوک  
die Staatsbürgerschaft = تابعیت  
die Station = ایستگاه  
die Stiftung = بنیاد  
die Stimmung = حال‌وهوا  
der Supermarkt = سوپرمارکت  
der Trainer = مربی  
der Verbraucher = مصرف‌کننده  
die Version = نسخه  
das Volk = مردم  
die Vorbereitung = آماده‌سازی  
der West = غرب  
die Wildkräuter = گیاهان وحشی  
das Wunder = معجزه  
die Wärme = گرما  
das Zeichen = علامت  
der Zufall = اتفاق  
der Zuschauer = تماشاگر  
ansagen — angesagt = اعلام کردن — اعلام کرده  
ansehen — angesehen = نگاه کردن — نگاه کرده  
anziehen — angezogen = پوشیدن — پوشیده  
arm = فقیر  
aufregend = هیجان‌انگیز  
aussterben — ausgestorben = منقرض شدن — منقرض شده  
automatisch = خودکار  
außergewöhnlich = غیرمعمول  
behandeln — behandelt = درمان کردن — درمان کرده  
beziehen — bezogen = مرتبط کردن — مرتبط کرده  
blau = آبی  
bloß = فقط  
buchen — gebucht = رزرو کردن — رزرو کرده  
diverser = متنوع  
doppelt = دو برابر  
drüber = روی آن  
dunkel = تاریک  
durchschnittlich = متوسط  
dünن = نازک  
effizient = کارآمد  
eingehen — eingegangen = وارد شدن — وارد شده  
einheimisch = محلی  
elektrisch = الکتریکی  
empfinden — empfunden = احساس کردن — احساس کرده  
erfüllen — erfüllt = انجام دادن — انجام داده  
ergeben — ergeben = نتیجه دادن — نتیجه داده  
erledigen — erledigt = انجام دادن — انجام داده  
erschaffen — erschaffen = خلق کردن — خلق کرده  
fantastisch = فوق‌العاده  
finanziell = مالی  
fördern — gefördert = حمایت کردن — حمایت کرده  
gelangen — gelangt = رسیدن — رسیده  
gestern = دیروز  
gigantisch = عظیم  
grundsätzlich = اساساً  
haben — er hat — gehabt = داشتن — او دارد — داشته  
hauptsächlich = عمدتاً  
herausfinden — herausgefunden = کشف کردن — کشف کرده  
herkömmlich = سنتی  
hinein = داخل  
hinzu = علاوه بر آن  
hochwertig = با کیفیت  
hoffentlich = امیدوارم  
ideal = ایده‌آل  
irgendwelcher = هر کدام  
italienisch = ایتالیایی  
jahrelang = سال‌ها  
kleben — geklebt = چسباندن — چسبانده  
kompliziert = پیچیده  
künftig = آینده  
künstlich = مصنوعی  
lebend = زنده  
lecker = خوشمزه  
lenken — gelenkt = هدایت کردن — هدایت کرده  
letztlich = در نهایت  
olympisch = المپیک  
regional = منطقه‌ای  
schießen — geschossen = شلیک کردن — شلیک کرده  
sichern — gesichert = ایمن کردن — ایمن کرده
sinken — gesenkt = پایین آمدن — پایین آمده  
sportlich = ورزشی  
trennen — getrennt = جدا کردن — جدا کرده  
umso = بیشتر  
unterscheiden — unterschieden = تفاوت داشتن — تفاوت داشته  
verbreiten — verbreitet = گسترش دادن — گسترش داده  
vereinen — vereint = متحد کردن — متحد کرده  
vertreiben — vertrieben = دور کردن — دور کرده  
weich = نرم  
widmen — gewidmet = اختصاص دادن — اختصاص داده  
zentral = مرکزی  
ökologisch = زیست‌محیطی  
die Ahnung = حدس  
der Anteil = سهم  
der Arbeitnehmer = کارمند  
die Aufmerksamkeit = توجه  
die Aufnahme = ضبط  
der Ausflug = گردش  
die Autobahn = اتوبان  
der Autor = نویسنده  
der Ball = توپ  
die Bedeutung = معنی  
der Bunker = پناهگاه  
die Butter = کره  
der Charakter = شخصیت  
die Diversität = تنوع  
das Dutzend = دوجین  
die Ebene = سطح  
die Fashion = مد  
die Fassade = نمای ساختمان  
der Forscher = محقق  
der Franzose = فرانسوی  
das Frühstück = صبحانه  
das Gefängnis = زندان  
das Gehalt = حقوق  
das Gehirn = مغز
das Gewicht = وزن  
der Gletscher = یخچال  
das Gold = طلا  
der Großteil = بخش عمده  
der Großvater = پدربزرگ  
das Gut = کالا  
die Handarbeit = کار دستی  
hey = هی  
das Highlight = نکته برجسته  
der Himmel = آسمان  
der Holzmarkt = بازار چوب  
die Innovation = نوآوری  
die Intelligenz = هوش  
der Juli = ژوئیه  
die Kartoffel = سیب‌زمینی  
die Katastrophe = فاجعه  
die Kindheit = کودکی  
der Klassiker = کلاسیک  
der Kontinent = قاره  
die Koralle = مرجان  
der Kranich = درنا  
die Kräuter = گیاهان  
das Kurzem = مدت کوتاه  
der Mauerfall = سقوط دیوار  
die Maßnahme = اقدام  
das Mittelalter = قرون وسطی  
das Münster = کلیسای جامع  
das Ohr = گوش  
die Oma = مادربزرگ  
das Opfer = قربانی  
die Option = گزینه  
der Ost = شرق  
das Papier = کاغذ  
die Perspektive = چشم‌انداز  
das Preußen = پروس  
der Rassismus = نژادپرستی  
der Respekt = احترام  
die Schneekugel = گوی برفی  
die Schulter = شانه  
das Spanien = اسپانیا  
der Spieler = بازیکن  
der Stadtteil = محله  
der Strand = ساحل  
die Struktur = ساختار  
der Tipp = نکته  
der Titel = عنوان  
der Trick = ترفند  
die Tänzerin = رقصنده زن  
die Universität = دانشگاه  
die Veranstaltung = رویداد  
das Verkehrsmittel = وسیله نقلیه  
der Versuch = آزمایش  
das Wachstum = رشد  
das Weingut = تاکستان  
der Weizen = گندم  
das Werkzeug = ابزار  
der Wettbewerb = رقابت  
der Zoo = باغ وحش  
abbauen — abgebaut = کاهش دادن — کاهش داده  
der Angestellte = کارمند  
ausgehen — ausgegangen = بیرون رفتن — بیرون رفته  
auskommen — ausgekommen = کنار آمدن — کنار آمده  
ausstatten — ausgestattet = تجهیز کردن — تجهیز کرده
beschreiben — beschrieben = توصیف کردن — توصیف کرده  
besetzen — besetzt = اشغال کردن — اشغال کرده  
beteiligen — beteiligt = مشارکت کردن — مشارکت کرده  
betrachten — betrachtet = بررسی کردن — بررسی کرده  
breit = پهن  
brennen — gebrannt = سوختن — سوخته  
dankbar = سپاسگزار  
darstellen — dargestellt = نمایش دادن — نمایش داده  
dauerhaft = دائمی  
dick = ضخیم  
diesmal = این بار  
ebenfalls = همچنین  
ebenso = به همین ترتیب  
einerseits = از یک طرف  
einladen — eingeladen = دعوت کردن — دعوت کرده  
enden — geendet = پایان یافتن — پایان یافته  
enorm = عظیم  
enthalten — enthalten = شامل بودن — شامل بوده  
entsorgen — entsorgt = دفع کردن — دفع کرده  
erkunden — erkundet = کاوش کردن — کاوش کرده  
erlauben — erlaubt = اجازه دادن — اجازه داده  
erneuerbar = تجدیدپذیر  
erscheinen — erschienen = ظاهر شدن — ظاهر شده  
exklusiv = انحصاری  
finanzieren — finanziert = تأمین مالی کردن — تأمین مالی کرده  
freiwillig = داوطلبانه  
geheim = مخفی  
geil = عالی  
gewaltig = عظیم  
großartig = فوق‌العاده  
grün = سبز  
herum = دور  
jedenfalls = به هر حال  
kehren — gekehrt = بازگشت کردن — بازگشت کرده  
mehrfach = چندین بار  
melden — gemeldet = گزارش دادن — گزارش داده
mutig = شجاع  
nachdenken — nachgedacht = فکر کردن — فکر کرده  
nachher = بعداً  
nix = هیچ  
nähen — genäht = دوختن — دوخته  
polnisch = لهستانی  
ran = به  
reinigen — gereinigt = تمیز کردن — تمیز کرده  
richten — gerichtet = تنظیم کردن — تنظیم کرده  
schade = حیف  
senken — gesenkt = کاهش دادن — کاهش داده  
sowieso = به هر حال  
traurig = غمگین  
unmöglich = غیرممکن  
unterrichten — unterrichtet = آموزش دادن — آموزش داده  
von = از  
verdanken — verdankt = مدیون بودن — مدیون بوده  
verhalten — verhalten = رفتار کردن — رفتار کرده  
vorsichtig = محتاط  
wachsend = در حال رشد  
wahnsinnig = دیوانه‌وار  
wenigstens = حداقل  
zugleich = همزمان  
übersetzen — übersetzt = ترجمه کردن — ترجمه کرده  
die Aktion = اقدام  
der Antrieb = محرک  
die Anzahl = تعداد  
der Apfelstrudel = شیرینی سیب  
der April = آوریل  
der Arbeiter = کارگر  
das Atelier = آتلیه  
der Ausblick = چشم‌انداز  
das Baujahr = سال ساخت  
der Bayer = باواریایی  
der Besitzer = مالک  
das Brandenburg = براندنبورگ  
das Brotbier = آبجو نان  
der Bäcker = نانوا  
das Chaos = آشفتگی  
der Chinese = چینی  
das Christkind = مسیح کودک  
die Demokratie = دموکراسی  
das Eiweiß = پروتئین  
die Emission = انتشار  
die Etage = طبقه  
der Fahrgast = مسافر  
die Faszination = جذابیت  
die Flucht = فرار  
der Fokus = تمرکز  
der Fortschritt = پیشرفت  
der Fotograf = عکاس  
die Freizeit = اوقات فراغت  
der Fund = کشف  
der Fußball = فوتبال  
die Galerie = گالری  
der Geburtstag = تولد  
der Gegner = حریف  
die Gelegenheit = فرصت  
das Gewürz = ادویه  
der Hafen = بندر  
die Hast = عجله  
der Haushalt = خانه  
die Haustür = درب خانه  
der Hund = سگ  
das Immunsystem = سیستم ایمنی  
das Island = ایسلند  
der Jakobsweg = راه یعقوب  
der Journalist = روزنامه‌نگار  
jung = جوان  
der Kaffee = قهوه  
die Kasse = صندوق  
die Kinderarbeit = کار کودکان  
das Kino = سینما  
der Klotz = بلوک  
die Konkurrenz = رقابت
der Konzern = شرکت بزرگ  
die Kälte = سرما  
das Label = برچسب  
der Ladepunkt = نقطه شارژ  
der Lebensraum = فضای زندگی  
das Leder = چرم  
die Linie = خط  
der Macher = سازنده  
die Media = رسانه  
der Migrant = مهاجر