der Abend — Abende = вечер 
Guten Abend! = Добрый вечер! 
alles = всё 
antworten — geantwortet = отвечать 
Sie antworten = Вы отвечаете 
auch = тоже 
auf { Akkusativ, Dativ } = на 
aus { Dativ } = из 
Ich komme aus Syrien. = Я приехал из Сирии. 
die Aussage — Aussagen = утверждение 
bisschen = немного 
Er spricht ein bisschen Englisch. = Он говорит немного по-английски. 
bitte = пожалуйста 
danke = спасибо 
dann = потом 
das = это 
der = этот 
Deutsch = немецкий 
Ich spreche Deutsch. = Я говорю по-немецки. 
der Dialog — Dialoge = диалог 
die = эта 
Wie geht‘s? = Как дела? 
dir = тебе 
Wie geht es dir? = Как дела у тебя? 
du = ты 
Bist du aus Polen? = Ты из Польши? 
ein, eine = один / одна 
die Entschuldigung = извинение 
er = он 
es = это 
die Form — Formen = форма 
die Frage — Fragen = вопрос 
fragen — gefragt = спрашивать 
die Frau — Frauen = женщина 
ganz = совсем / полностью 
Es geht mir ganz gut. = У меня всё довольно хорошо. 
gehen — ist gegangen — ging = идти 
Es geht mir gut. = У меня всё хорошо. 
die Grammatik = грамматика 
gut — besser — am besten = хороший 
hallo = привет 
heißen — geheißen = называться 
Ich heiße Anna. = Меня зовут Анна. 
der Herr — Herren = господин 
hören — gehört = слушать 
ich = я 
Ihnen = вам 
Wie geht es Ihnen? = Как дела у вас? 
ihr = вы 
im { Dativ } = в 
Fragen Sie im Kurs. = Спрашивайте на курсе. 
ja = да 
klar = ясно 
Ja, klar. = Да, ясно. 
kommen — ist gekommen = приходить 
der Kurs — Kurse = курс 
der Kursteilnehmer — Kursteilnehmer = участник курса 
die Kursteilnehmerin — Kursteilnehmerinnen = участница курса 
das Land — Länder = страна 
lesen — gelesen — las = читать 
der Mann — Männer = мужчина 
mein, meine = мой / моя 
mit { Dativ } = с 
morgen = завтра 
Bis morgen! = До завтра! 
die Nacht — Nächte = ночь 
Gute Nacht! = Спокойной ночи! 
der Name — Namen = имя 
nein = нет 
Nein, danke. = Нет, спасибо. 
neu = новый 
nicht = не 
oder = или 
die Person — Personen = человек 
richtig = правильный 
Das ist richtig! = Это правильно! 
der Satz — Sätze = предложение 
schreiben — geschrieben — schrieb = писать 
sehr = очень 
sein — ist gewesen — war = быть 
Seid ihr aus Afghanistan? = Вы из Афганистана? 
sie = она 
Sie = вы 
so = так 
die Sprache — Sprachen = язык 
sprechen mit { Dativ } über { Akkusativ } — gesprochen — sprach = говорить 
supergut = суперхорошо 
der Tag — Tage = день 
Guten Tag, Herr Maier. = Добрый день, господин Майер. 
Tschüss = Пока 
Tschüss, bis bald! = Пока, до скорого! 
und = и 
was = что 
Was machst du morgen? = Что ты делаешь завтра? 
welche = какой 
Welche Sprachen sprichst du? = Какие языки ты говоришь? 
wer = кто 
Wer ist das? = Кто это? 
das Wiedersehen = прощание 
Auf Wiedersehen! = До свидания! 
wie = как 
Wie heißt du? = Как тебя зовут? 
wissen — gewusst — wusste = знать 
wo = где 
Wo wohnst du? = Где ты живёшь? 
woher = откуда 
Woher kommst du? = Откуда ты? 
das Wort — Wörter = слово 
aber = но 
die Adresse — Adressen = адрес 
alt — älter — am ältesten = старый 
anmelden sich — angemeldet = записываться 
die Anmeldung = регистрация 
arbeiten — gearbeitet = работать 
das Bild — Bilder = картинка 
der Bruder — Brüder = брат 
buchstabieren — buchstabiert = произносить по буквам 
dein, deine = твой / твоя 
einmal = один раз 
Noch einmal, bitte. = Ещё раз, пожалуйста. 
die Eltern (Pl.) = родители 
falsch = неправильный 
die Familie — Familien = семья 
der Familienname — Familiennamen = фамилия 
der Familienstand = семейное положение 
das Formular — Formulare = бланк 
geschieden = разведённый 
die Geschwister (Pl.) = братья и сёстры 
Hast du Geschwister? = У тебя есть братья или сёстры? 
haben — hat — gehabt — hatte = иметь 
die Handynummer — Handynummern = номер мобильного 
Wie ist deine Handynummer? = Какой у тебя номер телефона? 
die Hausnummer — Hausnummern = номер дома 
das Heimatland — Heimatländer = родина 
hier = здесь 
Ihr, Ihre = ваш / ваша 
Wie ist Ihre Adresse? = Какой у вас адрес? 
in { Dativ, Akkusativ } = в 
die Information — Informationen = информация 
das Jahr — Jahre = год 
jetzt = сейчас 
kein, keine = никакой / никакая 
das Kind — Kinder = ребёнок 
Ich habe keine Kinder. = У меня нет детей. 
der Kindergarten — Kindergärten = детский сад 
der Kontakt — Kontakte = контакт 
leben — gelebt = жить 
Wo lebst du? = Где ты живёшь? 
ledig = холостой 
die E-Mail — E-Mails = электронная почта 
möchten — gemocht = хотеть 
die Mutter — Mütter = мать 
nach { Dativ } = в / к 
der Nachname — Nachnamen = фамилия 
noch = ещё 
die Postleitzahl — Postleitzahlen = почтовый индекс 
die Schwester — Schwestern = сестра 
die Schwägerin = невестка 
die Schwiegertochter = невестка 
der Schwiegervater = свёкор 
der Sohn — Söhne = сын 
die Straße — Straßen = улица 
die Telefonnummer — Telefonnummern = номер телефона 
die Tochter — Töchter = дочь 
über { Akkusativ } = о / через 
Der Zug nach Basel fährt über Stuttgart. = Поезд в Базель идёт через Штутгарт. 
der Vater — Väter = отец 
vergleichen — verglichen = сравнивать 
verheiratet = женатый 
Sind Sie verheiratet? = Вы женаты? 
verwitwet = овдовевший 
viel / viele — mehr — am meisten = много 
Wie viele Kinder haben Sie? = Сколько у вас детей? 
der Vorname — Vornamen = имя 
vorstellen sich — vorgestellt = представляться 
welcher, welche, welches = который 
willkommen = добро пожаловать 
Herzlich willkommen! = Сердечно добро пожаловать! 
wir = мы 
wohnen — gewohnt = жить 
der Wohnort = место жительства 
die Zahl — Zahlen = число 
zu { Dativ } = к 
Das ist jetzt leider zu spät. = Это, к сожалению, слишком поздно. 
also = итак 
an { Dativ, Akkusativ } = у / на 
Am Samstag ist kein Deutschkurs. = В субботу нет курса немецкого. 
andere = другой 
benutzen — benutzt = использовать 
das Blatt — Blätter = лист 
der Bleistift — Bleistifte = карандаш 
das Buch — Bücher = книга 
da = там 
der Deutschkurs = курс немецкого 
Der Deutschkurs ist am Montag. = Курс немецкого в понедельник. 
der Dienstag = вторник 
doch = ведь 
der Donnerstag = четверг 
endlich = наконец 
erklären — erklärt = объяснять 
erzählen — erzählt = рассказывать 
das Familienfoto = семейное фото 
der Feiertag — Feiertage = праздник 
das Fenster = окно 
das Foto = фото 
der Freitag = пятница 
der Freund — Freunde = друг 
Hast du schon Freunde hier? = У тебя уже есть друзья здесь? 
für { Akkusativ } = для 
Sie nehmen die Wohnung für 750 Euro. = Они берут квартиру за 750 евро. 
genau = точно 
gestern = вчера 
groß = большой 
der Gruß — Grüße = привет 
Viele Grüße = Много приветов 
die Hausaufgabe — Hausaufgaben = домашнее задание 
das Heft — Hefte = тетрадь 
heute = сегодня 
ihr = её 
immer = всегда 
die Karte — Karten = карта 
klein = маленький 
knifflig = хитрый 
der Kugelschreiber (Kuli) — Kugelschreiber = шариковая ручка 
das Kursbuch = учебник курса 
der Kursraum = аудитория курса 
die Lampe — Lampen = лампа 
die Landkarte — Landkarten = географическая карта 
langsam = медленно 
der Lehrer — Lehrer = учитель 
die Lehrerin — Lehrerinnen = учительница 
lernen — gelernt = учить 
liebe, lieber = дорогой 
Liebe Laura, … = Дорогая Лаура, … 
die Liste — Listen = список 
machen — gemacht = делать 
mir = мне 
der Mittwoch = среда 
der Montag = понедельник 
natürlich = конечно 
Noch einmal langsam bitte! – Natürlich. = Ещё раз медленно, пожалуйста! – Конечно. 
nett = милый 
das Papier = бумага 
der Papierkorb = мусорная корзина 
die Pause — Pausen = перерыв 
das Problem — Probleme = проблема 
der Projektor = проектор 
der Radiergummi = ластик 
der Raum = комната 
der Rucksack = рюкзак 
die Sache — Sachen = вещь 
sagen — gesagt — sagte = говорить 
der Samstag = суббота 
sehen — gesehen — sah = видеть 
Was sehen Sie? = Что вы видите? 
die Seite = страница 
der Schlüssel — Schlüssel = ключ 
schnell = быстро 
der Sonntag = воскресенье 
der Spaß = удовольствие 
spielen — gespielt = играть 
Spielen Sie die Dialoge. = Проиграйте диалоги. 
der Spitzer = точилка 
der Stuhl — Stühle = стул 
die Tabelle = таблица 
die Tafel = доска 
die Tasche = сумка 
der Text = текст 
der Tisch — Tische = стол 
die Tür = дверь 
übermorgen = послезавтра 
die Übung — Übungen = упражнение 
das Übungsbuch = рабочая тетрадь 
verstehen — verstanden — verstand = понимать 
vorgestern = позавчера 
die Wand = стена 
die Woche = неделя 
das Wochenende = выходные 
das Wörterbuch — Wörterbücher = словарь 
zeigen — gezeigt = показывать 
der Zettel — Zettel = записка 
zusammen = вместе 
Wir gehen zusammen ins Kino. = Мы идём вместе в кино. 
Im Supermarkt = В супермаркете 
das Angebot — Angebote = предложение 
die Antwort — Antworten = ответ 
der Apfel — Äpfel = яблоко 
der Apfelsaft = яблочный сок 
die Aufgabe — Aufgaben = задание 
die Babynahrung = детское питание 
die Banane — Bananen = банан 
der Becher — Becher = стакан 
ein Becher Joghurt = стакан йогурта 
das Beispiel — Beispiele = пример 
das Bier = пиво 
die Birne — Birnen = груша 
das Bistro = бистро 
die Blaubeere — Blaubeeren = голубика 
die Bohne — Bohnen = боб 
brauchen — gebraucht = нуждаться 
das Brot — Brote = хлеб 
das Brötchen — Brötchen = булочка 
der Cent — Cent = цент 
die Cola — Cola, Colas = кола 
der Couscous = кускус 
denn = ведь 
diese, dieser, dieses = этот 
die Dose — Dosen = банка 
durch { Akkusativ } = через 
das Ei — Eier = яйцо 
der Einkaufszettel = список покупок 
einige = некоторые 
die Erbse — Erbsen = горох 
die Erdbeere — Erdbeeren = клубника 
essen — gegessen — aß = есть 
etwas = что-то 
fertig = готовый 
der Fisch — Fische = рыба 
die Flasche — Flaschen = бутылка 
das Fleisch = мясо 
frisch = свежий 
das Frühstück = завтрак 
frühstücken — gefrühstückt = завтракать 
gemeinsam = вместе 
das Gemüse = овощи 
gern = охотно 
Ich esse gern Tomaten. = Я охотно ем помидоры. 
das Getränk — Getränke = напиток 
das Glas — Gläser = стакан 
gleich = сразу 
das Gramm — Gramm = грамм 
die Himbeere — Himbeeren = малина 
der Honig = мёд 
der Joghurt — Joghurts = йогурт 
der Kaffee = кофе 
die Kartoffel — Kartoffeln = картофель 
der Käse = сыр 
kaufen — gekauft = покупать 
der Keks — Kekse = печенье 
die Kichererbse — Kichererbsen = нут 
das Kilo — Kilos = килограмм 
die Kirsche — Kirschen = вишня 
die Kiwi — Kiwis = киви 
die Kontrolle — Kontrollen = контроль 
kosten — gekostet = стоить 
der Kuchen = торт 
der Kunde — Kunden = клиент 
die Kundin — Kundinnen = клиентка 
kurz = короткий 
das Lammfleisch = баранина 
das Lebensmittel — Lebensmittel = продукт питания 
die Limonade (Limo) — Limonaden (Limos) = лимонад 
der Liter — Liter = литр 
man = человек 
die Mandarine — Mandarinen = мандарин 
die Mango — Mangos = манго 
der Markt — Märkte = рынок 
die Marmelade — Marmeladen = джем 
das Mehl = мука 
meistens = чаще всего 
die Mengenangabe = указание количества 
die Melone — Melonen = дыня 
die Milch = молоко 
das Milchprodukt — Milchprodukte = молочный продукт 
mögen — gemocht = любить 
die Möhre — Möhren = морковь 
müssen — gemusst = должен 
nehmen — genommen — nahm = брать 
die Nudel — Nudeln = лапша 
nur = только 
das Obst = фрукты 
der Obstsalat = фруктовый салат 
das Olivenöl = оливковое масло 
die Orange — Orangen = апельсин 
ordnen — geordnet = упорядочивать 
die Packung — Packungen = упаковка 
eine Packung Reis = упаковка риса 
die Paprika — Paprikas = перец 
der Partner — Partner = партнёр 
die Partnerin — Partnerinnen = партнёрша 
das Pfund = фунт 
der Pilz — Pilze = гриб 
planen — geplant = планировать 
der Preis — Preise = цена 
pro { Akkusativ } = за 
Die Äpfel kosten 2,50 € pro Kilo. = Яблоки стоят 2,50 € за килограмм. 
der Pudding = пудинг 
der Reis = рис 
das Rindfleisch = говядина 
der Saft — Säfte = сок 
die Sahne = сливки 
der Salat — Salate = салат 
das Salz = соль 
sich = себя 
schmecken — geschmeckt = нравиться на вкус 
die Schokolade = шоколад 
schön = красивый 
das Schweinefleisch = свинина 
sonst = иначе 
stehen — ist gestanden — stand = стоять 
streichen — gestrichen = зачёркивать 
das Stück — Stücke = кусок 
ein Stück Kuchen = кусок торта 
die Tasse — Tassen = чашка 
der Tee = чай 
teuer = дорогой 
der Tipp — Tipps = совет 
die Tomate — Tomaten = помидор 
die Traube — Trauben = виноград 
trinken — getrunken — trank = пить 
unterstreichen — unterstrichen = подчёркивать 
verbinden — verbunden = соединять 
der Verkäufer — Verkäufer = продавец 
die Verkäuferin — Verkäuferinnen = продавщица 
von { Dativ } = от 
das Wasser = вода 
der Wein = вино 
die Zitrone — Zitronen = лимон 
der Zucker = сахар 
die Zwiebel — Zwiebeln = лук 
Von morgens bis abends = С утра до вечера 
abends = вечером 
der Alltag = повседневность 
anrufen — angerufen — rief an = звонить 
Ich rufe dich an. = Я тебе позвоню. 
die Arbeit = работа 
aufstehen sich — ist sich aufgestanden — stand sich auf = вставать 
beginnen — begonnen — begann = начинать 
beide = оба 
das Bett — Betten = кровать 
bis { Akkusativ } = до 
das Büro — Büros = офис 
der Computer — Computer = компьютер 
das Computerspiel — Computerspiele = компьютерная игра 
erst = сначала 
Wir lernen erst Deutsch, dann gehen wir spazieren. = Мы сначала учим немецкий, потом идём гулять. 
fernsehen — ferngesehen = смотреть телевизор 
der Film — Filme = фильм 
die Freundin — Freundinnen = подруга 
früh = рано 
der Fußball = футбол 
Ich spiele gern Fußball. = Я охотно играю в футбол. 
geöffnet = открытый 
grillen — gegrillt = жарить на гриле 
halb = половина 
Es ist halb zwölf. = Половина двенадцатого. 
der Hunger = голод 
die Idee — Ideen = идея 
das Interview — Interviews = интервью 
kochen — gekocht = готовить 
können — gekonnt — konnte = мочь 
lecker = вкусный 
leider = к сожалению 
manchmal = иногда 
der Mittag = полдень 
mittags = в полдень 
die Mittagspause = обеденный перерыв 
der Morgen = утро 
morgens = утром 
müde = усталый 
die Musik = музыка 
der Nachmittag = послеобеденное время 
nachmittags = после обеда 
nachts = ночью 
nie = никогда 
der Notizzettel = заметка 
oft = часто 
die Pizza = пицца 
putzen — geputzt = чистить 
schade = жаль 
schlafen — geschlafen — schlief = спать 
der Schluss = конец 
Um eins haben wir Schluss. = В час у нас конец. 
die Schule — Schulen = школа 
spät = поздно 
spazieren — ist spazieren gegangen = гулять 
das Spiel — Spiele = игра 
der Sport = спорт 
die Stunde — Stunden = час 
der Stundenplan = расписание 
der Supermarkt = супермаркет 
telefonieren — telefoniert = звонить по телефону 
tun — getan — tat = делать 
die Uhr = часы 
Die Uhr steht im Wohnzimmer. = Часы стоят в гостиной. 
die Uhrzeit = время 
Es ist 14 Uhr. = Два часа дня. 
um { Akkusativ } = в 
der Unterricht = урок 
das Viertel = четверть 
Es ist Viertel vor zehn. = Без четверти десять. 
vor { Dativ } = перед 
der Vormittag = утро 
vormittags = утром 
wann = когда 
die Wohnung — Wohnungen = квартира 
zeichnen — gezeichnet = рисовать 
die Zeit = время 
zu Hause = дома
Ich bin zu Hause. = Я дома. 
Auf Wohnungssuche = В поисках жилья 
ab { Dativ } = с 
Die Wohnung ist ab 1.5. frei. = Квартира свободна с 1 мая. 
der Altbau = старое здание 
die Angabe — Angaben = указание 
die Anzeige — Anzeigen = объявление 
das Arbeitszimmer = рабочий кабинет 
das Bad — Bäder = ванная 
baden — gebadet = купаться 
die Badewanne = ванна 
das Badezimmer = ванная комната 
der Balkon — Balkone = балкон 
der Bauernhof — Bauernhöfe = ферма 
bei { Dativ } = у 
bekommen — bekommen — bekam = получать 
Meine Blumen bekommen jeden Tag Wasser. = Мои цветы получают воду каждый день. 
der Besichtigungstermin = время осмотра 
besser = лучше 
billig = дешёвый 
breit = широкий 
circa = примерно 
die Diele = прихожая 
direkt = прямо 
dort = там 
draußen = снаружи 
dringend = срочно 
dunkel = тёмный 
die Dusche = душ 
das Einfamilienhaus = частный дом 
einkaufen — eingekauft = делать покупки 
das Elektrogerät — Elektrogeräte = электроприбор 
das Erdgeschoss = первый этаж 
ersetzen — ersetzt = заменять 
der Euro — Euros = евро 
der Fernseher — Fernseher = телевизор 
finden — gefunden — fand = находить 
die Firma — Firmen = фирма 
der Flur — Flure = коридор 
frei = свободный 
die Garage — Garagen = гараж 
der Garten — Gärten = сад 
der Gast — Gäste = гость 
das Geld — Gelder = деньги 
gemütlich = уютный 
gepflegt = ухоженный 
das Gerät — Geräte = устройство 
das Geschäft — Geschäfte = магазин 
das Gespräch — Gespräche = разговор 
die Größe = размер 
grün = зелёный 
hängen — gehangen = висеть 
hässlich = уродливый 
die Hauptsache = главное 
das Haus — Häuser = дом 
das Haustier — Haustiere = домашнее животное 
die Heizung = отопление 
helfen — geholfen — half = помогать 
hell = светлый 
der Herd = плита 
die Hilfe = помощь 
hinten = сзади 
das Hochhaus = высотка 
ihr, ihre = её 
die Immobilie — Immobilien = недвижимость 
insgesamt = в общей сложности 
interessant = интересный 
jeder, jede, jedes = каждый 
der Juni = июнь 
die Kaffeemaschine = кофемашина 
kalt = холодный 
die Kaution = залог 
der Keller — Keller = подвал 
das Kinderzimmer = детская комната 
der Kleiderschrank = шкаф для одежды 
die Küche — Küchen = кухня 
der Kühlschrank — Kühlschränke = холодильник 
lang = длинный 
lassen — gelassen — ließ = оставлять 
Lass uns in einem anderen Geschäft schauen. = Давай посмотрим в другом магазине. 
laut = громкий 
gerne — lieber — am liebsten = с удовольствием
liegen — ist gelegen — lag = лежать 
Die Wohnung liegt direkt an der Hauptstraße. = Квартира находится прямо у главной улицы. 
maximal = максимум 
das Mehrfamilienhaus = многоквартирный дом 
die Miete = аренда 
mindestens = минимум 
die Möbel (Pl.) = мебель 
möbliert = меблированный 
modern = современный 
der Monat — Monate = месяц 
die Monatsmiete — Monatsmieten = месячная аренда 
der Müll = мусор 
neben { Dativ } = рядом 
die Nebenkosten — Nebenkosten = коммунальные расходы 
ohne { Akkusativ } = без 
das Obergeschoss = верхний этаж 
der Ort — Orte = место 
die Pflanze — Pflanzen = растение 
der Plan — Pläne = план 
der Platz — Plätze = место 
Wir brauchen mehr Platz. = Нам нужно больше места. 
der Quadratmeter — Quadratmeter = квадратный метр 
das Regal — Regale = полка 
das Reihenhaus = рядовой дом 
ruhig = тихий 
schauen — geschaut = смотреть 
das Schlafzimmer = спальня 
schmal = узкий 
der Schrank — Schränke = шкаф 
der Sessel — Sessel = кресло 
singen — gesungen — sang = петь 
sitzen — gesessen — saß = сидеть 
das Sofa — Sofas = диван 
sofort = сразу 
sollen — gesollt = должен 
Sollen wir ins Kino gehen? = Пойдём в кино? 
das Sonderangebot — Sonderangebote = специальное предложение 
die Sonne = солнце 
sonstiges = прочее 
die Sprachschule = языковая школа 
spülen — gespült = мыть 
die Spülmaschine — Spülmaschinen = посудомоечная машина 
die Stadt — Städte = город 
suchen — gesucht = искать 
super = супер 
der Teppich = ковёр 
die Terrasse — Terrassen = терраса 
die Toilette — Toiletten = туалет 
toll = классный 
die Traumwohnung = квартира мечты 
unbedingt = обязательно 
ungemütlich = неуютный 
unser, unsere = наш / наша 
warum = почему 
waschen — gewaschen = стирать 
die Waschmaschine = стиральная машина 
das WC = туалет 
wegziehen — ist weggezogen = переезжать 
weiter = дальше 
wenn = если 
werden — ist geworden — wurde = становиться 
wichtig = важный 
die Wohnungsanzeige = объявление о квартире 
die Wohnungssuche = поиск жилья 
das Wohnzimmer = гостиная 
wunderschön = прекрасный 
wünschen — gewünscht = желать 
zahlen — gezahlt = платить 
die Zeitung — Zeitungen = газета 
das Zentrum = центр 
das Zimmer — Zimmer = комната 
zu Fuß = пешком 
In der Stadt unterwegs = По городу 
die Ampel — Ampeln = светофор 
die Ankunftszeit = время прибытия 
die Ansage — Ansagen = объявление 
die Apotheke — Apotheken = аптека 
der Arzt — Ärzte = врач 
die Ärztin — Ärztinnen = врачиха 
die Auskunft = справка 
außerdem = кроме того 
außerplanmäßig = внепланово 
das Auto — Autos = автомобиль 
die Bahn = поезд 
der Bahnhof — Bahnhöfe = вокзал 
der Ball — Bälle = мяч 
die Bank = банк 
bezahlen — bezahlt = платить 
die Bibliothek = библиотека 
das Bürgerbüro = бюро для граждан 
der Bus — Busse = автобус 
die Bushaltestelle — Bushaltestellen = автобусная остановка 
das Café — Cafés = кафе 
dafür = для этого 
dritte = третий 
die Durchsage = объявление 
einfach = простой 
die Einzelfahrkarte = билет на одну поездку 
erste = первый 
der Erwachsene — Erwachsenen = взрослый 
fahren — ist gefahren — fuhr = ехать 
der Fahrgast — Fahrgäste = пассажир 
die Fahrkarte = билет 
das Fahrrad — Fahrräder = велосипед 
fallen — ist gefallen — fiel = падать 
fast = почти 
der Flughafen — Flughäfen = аэропорт 
das Gebäude — Gebäude = здание 
geben — gegeben — gab = давать 
gegenüber { Dativ } = напротив 
geradeaus = прямо 
das Gleis — Gleise = путь 
gültig = действительный 
halten — gehalten — hielt = останавливаться 
die Haltestelle — Haltestellen = остановка 
der Hauptbahnhof = главный вокзал 
hinter { Dativ } = за 
das Hotel — Hotels = отель 
der Informationsschalter = информационная стойка 
der Intercity (IC) = междугородний поезд 
das Jobcenter = центр занятости 
das Kino — Kinos = кинотеатр 
die Kirche = церковь 
das Krankenhaus — Krankenhäuser = больница 
die Krankenkasse = медицинская страховка 
die Kreuzung = перекрёсток 
die Kurzstrecke = короткая дистанция 
die Linie = линия 
links = налево 
die Lösung — Lösungen = решение 
der Meter — Meter = метр 
der Metzger = мясник 
die Minute — Minuten = минута 
die Mobilität = мобильность 
das Motorrad — Motorräder = мотоцикл 
nachfragen — nachgefragt = переспрашивать 
nächster, nächste, nächstes = следующий 
nichts = ничего 
öffentlich = общественный 
die Orientierung = ориентация 
der Park — Parks = парк 
die Parkgebühr — Parkgebühren = плата за парковку 
der Parkplatz — Parkplätze = парковочное место 
die Polizei = полиция 
die Position = позиция 
die Post = почта 
praktisch = практичный 
rechts = направо 
das Rathaus = ратуша 
die Regionalbahn = региональный поезд 
das Restaurant — Restaurants = ресторан 
die Ruhe = покой 
der Schienenersatzverkehr = замена рельсового транспорта 
das Schwimmbad — Schwimmbäder = бассейн 
selten = редко 
sowieso = в любом случае 
später = позже 
der Stadtplan — Stadtpläne = план города 
der Stadtwald = городской лес 
steigen — ist gestiegen — stieg = подниматься 
die Straßenbahn — Straßenbahnen = трамвай 
die Tageskarte = дневной билет 
das Taxi — Taxis = такси 
überall = везде 
umsteigen — ist umgestiegen = пересаживаться 
ungefähr = примерно 
unter { Dativ } = под 
die Verfügung = распоряжение 
das Verkehrsmittel — Verkehrsmittel = транспортное средство 
verstanden = понято 
verzögern — verzögert = задерживать 
die Volkshochschule (VHS) = народный университет 
voll = полный 
vorbei = мимо 
vorne = впереди 
warten — gewartet = ждать 
der Weg = путь 
der Winter — Winter = зима 
der Wochenmarkt = еженедельный рынок 
wohin = куда 
wollen — gewollt = хотеть 
der Zug — Züge = поезд 
zweimal = дважды 
zweite = второй 
zwischen { Dativ } = между 
anfangen — angefangen — fing an = начинать 
der Arbeitstag — Arbeitstage = рабочий день 
die Ausbildung — Ausbildungen = обучение 
ausfüllen — ausgefüllt = заполнять 
die Aushilfe — Aushilfen = помощник 
der Automechaniker = автомеханик 
die Automechanikerin = автомеханик (жен.) 
backen — gebacken = печь 
der Bäcker = пекарь 
die Bäckerin = пекарь (жен.) 
bald = скоро 
berichten — berichtet = сообщать 
der Beruf — Berufe = профессия 
beruflich = профессиональный 
die Bürokauffrau = офисный работник (жен.) 
der Bürokaufmann = офисный работник 
der Chef — Chefs = начальник 
die Chefin — Chefinnen = начальница 
das Computerprogramm — Computerprogramme = компьютерная программа 
das Computersystem — Computersysteme = компьютерная система 
dauern — gedauert = длиться 
dreimal = трижды 
der Fahrer — Fahrer = водитель 
fangen — gefangen — fing = ловить 
der Feierabend = конец рабочего дня 
flexibel = гибкий 
fotografieren — fotografiert = фотографировать 
freundlich = дружелюбный 
der Führerschein = водительские права 
der Fußballspieler = футболист 
die Gitarre — Gitarren = гитара 
halbtags = неполный рабочий день 
die Hausfrau — Hausfrauen = домохозяйка 
der Hausmann — Hausmänner = домохозяин 
der Hund — Hunde = собака 
installieren — installiert = устанавливать 
die Kantine — Kantinen = столовая 
kaputt = сломанный 
die Kasse — Kassen = касса 
der Kassierer = кассир 
die Kassiererin — Kassiererinnen = кассир (жен.) 
die Kauffrau = продавщица 
der Kellner — Kellner = официант 
die Kellnerin — Kellnerinnen = официантка 
klingeln — geklingelt = звонить 
der Koch — Köche = повар 
die Köchin — Köchinnen = повариха 
der Kollege — Kollegen = коллега 
die Kollegin — Kolleginnen = коллега (жен.) 
das Konzert — Konzerte = концерт 
korrigieren — korrigiert = исправлять 
das Kraftfahrzeug (KFZ) = автомобиль 
der Krankenpfleger — Krankenpfleger = медбрат 
die Krankenschwester — Krankenschwestern = медсестра 
kreativ = креативный 
langweilig = скучный 
die Leute (Pl.) = люди 
die Mathematik = математика 
der Mechaniker — Mechaniker = механик 
der Mensch — Menschen = человек 
das Mittagessen = обед 
der Moment — Momente = момент 
der Musiklehrer = учитель музыки 
die Musiklehrerin = учительница музыки 
der Nachtdienst = ночная смена 
organisieren — organisiert = организовывать 
der Pizzafahrer = доставщик пиццы 
die Pizzeria = пиццерия 
die Pflege = уход 
prüfen — geprüft = проверять 
pünktlich = пунктуальный 
das Radio — Radios = радио 
rechnen — gerechnet = считать 
der Rentner — Rentner = пенсионер 
die Reparatur = ремонт 
reparieren — repariert = ремонтировать 
der Reporter = репортёр 
der Roman — Romane = роман 
schlimm = ужасный 
der Schüler — Schüler = ученик 
die Schülerin — Schülerinnen = ученица 
servieren — serviert = подавать 
der Stress = стресс 
der Student — Studenten = студент 
die Studentin — Studentinnen = студентка 
studieren — studiert = учиться 
der Taxifahrer = таксист 
die Taxifahrerin = таксистка 
der Techniker = техник 
das Telefon — Telefone = телефон 
der Traumberuf = профессия мечты 
treffen — getroffen — traf = встречать 
die Universität — Universitäten = университет 
unterrichten — unterrichtet = преподавать 
vielleicht = возможно 
wählen — gewählt = выбирать 
die Werkstatt = мастерская 
das Wiederhören = до услышания 
Auf Wiederhören! = До услышания! 
zuerst = сначала 
Beim Arzt = У врача 
das Altenpflegeheim = дом престарелых 
anbei = приложено 
die Anrede = обращение 
Sehr geehrter Herr Maier, … = Уважаемый господин Майер, … 
der Arm — Arme = рука 
atmen — geatmet = дышать 
das Auge — Augen = глаз 
der Bauch = живот 
das Bein — Beine = нога 
die Bauchschmerzen (Pl.) = боли в животе 
der Bescheid = уведомление 
Ich sage dir Bescheid. = Я дам тебе знать. 
die Besserung = улучшение 
Gute Besserung! = Выздоравливай! 
der Betreff = тема 
bevor = перед 
bleiben — ist geblieben — blieb = оставаться 
der Brief — Briefe = письмо 
der Briefteil — Briefteile = часть письма 
die Brust = грудь 
danach = после 
das Datum = дата 
dürfen — gedurft = мочь 
der Ellbogen/Ellenbogen = локоть 
der Empfänger — Empfänger = получатель 
das Entschuldigungsschreiben = письмо с извинениями 
erkälten sich — erkältet = простужаться 
die Erkältung = простуда 
euer, eure = ваш / ваша 
das Fieber = жар 
der Finger — Finger = палец 
freundlich = дружелюбный 
Mit freundlichen Grüßen = С дружескими пожеланиями 
geehrter, geehrte = уважаемый / уважаемая 
Sehr geehrte Frau Müller, … = Уважаемая госпожа Мюллер, … 
das Gesicht = лицо 
die Gesundheit = здоровье 
die Gesundheitskarte = медицинская карта 
die Grippe = грипп 
die Gruppe — Gruppen = группа 
das Haar — Haare = волосы 
der Hals = горло 
der Hals-Nasen-Ohren-Arzt (HNO) = ЛОР-врач 
das Halsweh = боль в горле 
die Hand — Hände = рука 
der Hausarzt — Hausärzte = семейный врач 
heiß = горячий 
der Husten = кашель 
Hustensaft = сироп от кашля 
das Knie — Knie = колено 
der Kopf — Köpfe = голова 
die Kopfschmerzen (Pl.) = головные боли 
der Körper — Körper = тело 
der Körperteil — Körperteile = часть тела 
krank = больной 
die Krankheit = болезнь 
die Krankmeldung = уведомление о болезни 
der März = март 
das Medikament — Medikamente = лекарство 
der Mund = рот 
der Nacken = шея 
die Nase = нос 
die Notfallsprechstunde = экстренный приём 
das Ohr — Ohren = ухо 
der Orthopäde = ортопед 
der Patient — Patienten = пациент 
die Patientin — Patientinnen = пациентка 
per = через 
das Pflaster — Pflaster = пластырь 
das Praktikum — Praktika = практика 
die Praktikumsbetreuerin = куратор практики 
die Praxis — Praxen = практика 
die Praxisgemeinschaft = совместная практика 
rauchen — geraucht = курить 
regelmäßig = регулярный 
das Rezept — Rezepte = рецепт 
rot = красный 
der Rücken = спина 
rund = круглый 
die Salbe — Salben = мазь 
schicken — geschickt = отправлять 
der Schmerz — Schmerzen = боль 
der Schnupfen = насморк 
die Schulter — Schultern = плечо 
schwanger = беременная 
sein, seine = его 
die Sprechstunde = приёмные часы 
die Sprechstundenhilfe = помощник на приёме 
das Sprechzimmer = кабинет приёма 
stark = сильный 
die Stirn = лоб 
die Tablette — Tabletten = таблетка 
der Termin — Termine = приём 
der Tropfen — Tropfen = капля 
die Unterschrift = подпись 
die Untersuchung = обследование 
der Verband = повязка 
verschieden = различный 
die Vorsorge = профилактика 
das Wartezimmer = зал ожидания 
der Wechsel = смена 
wechseln — gewechselt = менять 
wehtun — wehgetan — tat weh = болеть 
wieder = снова 
wiederkommen — ist wiedergekommen = возвращаться 
der Zahn — Zähne = зуб 
der Zeh — Zehen = палец на ноге 
zurzeit = в настоящее время 
Gestern und heute = Вчера и сегодня 
aufwachsen — ist aufgewachsen = расти 
beantworten — beantwortet = отвечать 
der Besuch = визит 
die Bewegung — Bewegungen = движение 
bilden — gebildet = образовывать 
die Blume — Blumen = цветок 
der Dienst = служба 
extra = дополнительно 
das Ferienhaus — Ferienhäuser = дом для отдыха 
früher = раньше 
sein/wurden geboren — ist/wurde geboren — war = родиться 
Ich bin in Kabul geboren. = Я родился в Кабуле. 
gerade = только что 
gucken — geguckt = смотреть 
der Hausflur = коридор дома 
heiraten — geheiratet = жениться 
das Hobby — Hobbys = хобби 
der Ingenieur = инженер 
die Insel — Inseln = остров 
die Inselrundfahrt = тур по острову 
kennen — gekannt = знать 
der Koffer — Koffer = чемодан 
letzte = последний 
das Meer = море 
der Mond = луна 
der Nachbar — Nachbarn = сосед 
die Nachbarin — Nachbarinnen = соседка 
die Natur = природа 
packen — gepackt = паковать 
die Postkarte — Postkarten = открытка 
die Reise — Reisen = путешествие 
das Schiff — Schiffe = корабль 
der Seehund — Seehunde = тюлень 
der Ski = лыжа 
der Strand — Strände = пляж 
stressig = стрессовый 
das Studium = учёба 
stundenlang = часами 
die Suppe — Suppen = суп 
süß = сладкий 
das Tennis = теннис 
der Tourist — Touristen = турист 
unregelmäßig = нерегулярный 
der Urlaub = отпуск 
verdienen — verdient = зарабатывать 
warten — gewartet = ждать 
das Wetter = погода 
Wir gehen shoppen! = Мы идём за покупками! 
anziehen — angezogen — zog an = надевать 
der Anzug — Anzüge = костюм 
beige = бежевый 
bequem = удобный 
besser = лучше 
bestimmt = определённо 
blau = синий 
blöd = глупый 
die Bluse — Blusen = блузка 
braun = коричневый 
bringen — gebracht — brachte = приносить 
denken an { Akkusativ } — gedacht — dachte = думать 
der Einkaufsbummel = прогулка за покупками 
eng = узкий 
euch = вас 
die Farbe — Farben = цвет 
furchtbar = ужасный 
gefallen — ist gefallen — gefiel = нравиться 
Die Bluse gefällt mir. = Мне нравится эта блузка. 
gegenseitig = взаимно 
gelb = жёлтый 
genauso = точно так же 
glauben an { Akkusativ } — geglaubt = верить 
grau = серый 
günstig = выгодный 
das Hemd — Hemden = рубашка 
die Hose — Hosen = брюки 
ihm = ему 
die Jacke — Jacken = куртка 
die Jeans — Jeans = джинсы 
der Jogginganzug = спортивный костюм 
der Kassenbon = чек 
das Kaufhaus — Kaufhäuser = универмаг 
die Klamotten (Pl.) = шмотки 
klasse = классный 
das Kleid — Kleider = платье 
die Kleidung — Kleidung = одежда 
das Kleidungsstück — Kleidungsstücke = предмет одежды 
lila = фиолетовый 
der Mantel — Mäntel = пальто 
die Mode = мода 
das Modell = модель 
die Mütze = шапка 
online = онлайн 
die Ordnung = порядок 
Das ist in Ordnung. = Это в порядке. 
das Paar — Paare = пара 
passen — gepasst = подходить 
positiv = позитивный 
probieren — probiert = примерять 
der Prospekt — Prospekte = проспект 
der Pullover = свитер 
raten — geraten — riet = советовать 
der Rock = юбка 
der Schal = шарф 
der Schuh — Schuhe = туфля 
schwarz = чёрный 
sicher = уверенный 
die Socke — Socken = носок 
der Sportschuh = спортивная обувь 
die Strickjacke = вязаная кофта 
der Strumpf — Strümpfe = чулок 
tragen — getragen — trug = носить 
das T-Shirt — T-Shirts = футболка 
typisch = типичный 
überhaupt = вообще 
umtauschen — umgetauscht = обменивать 
uns = нас 
vergessen — vergessen — vergaß = забывать 
der Wintermantel = зимнее пальто 
zurück = обратно 
Endlich Frühling! = Наконец-то весна! 
die Achtung = внимание 
Achtung! = Внимание! 
der April = апрель 
aufregen sich — aufgeregt = волноваться 
Ich bin ganz aufgeregt. = Я очень взволнован. 
der August = август 
bauen — gebaut = строить 
der Baum — Bäume = дерево 
besuchen — besucht = посещать 
bewölkt = облачно 
die Braut — Bräute = невеста 
der Dank = благодарность 
Vielen Dank! = Большое спасибо! 
darüber = об этом 
die Deutschlandkarte = карта Германии 
der Dezember = декабрь 
eben = только что 
Na, da muss es eben ein Freitag sein. = Ну, тогда это, должно быть, пятница. 
einladen — eingeladen = приглашать 
die Einladung = приглашение 
einverstanden = согласен 
das Eis = лёд 
der Februar = февраль 
die Feier — Feiern = праздник 
feiern — gefeiert = праздновать 
das Fest — Feste = фестиваль 
freuen sich auf { Akkusativ } — gefreut = радоваться 
froh = радостный 
Frohe Ostern! = Счастливой Пасхи! 
der Frühling = весна 
fühlen — gefühlt = чувствовать 
die Gartenparty — Gartenpartys = вечеринка в саду 
der Geburtstag = день рождения 
die Geburtstagstorte = торт на день рождения 
das Geschenk — Geschenke = подарок 
glücklich = счастливый 
der Glückstag = счастливый день 
der Grad = градус 
hageln — gehagelt = идти град 
Es hagelt. = Идёт град. 
der Handschuh — Handschuhe = перчатка 
der Hase = заяц 
der Herbst = осень 
die Himmelsrichtung — Himmelsrichtungen = сторона света 
die Hochzeit — Hochzeiten = свадьба 
die Hochzeitsfeier = свадебный праздник 
die Jahreszahl = год 
die Jahreszeit — Jahreszeiten = время года 
der Januar = январь 
der Juli = июль 
der Kalender — Kalender = календарь 
lieben — geliebt = любить 
der Luftballon — Luftballons = воздушный шар 
lustig = весёлый 
der Mai = май 
die Mama = мама 
minus = минус 
Es sind minus 15 Grad. = Минус 15 градусов. 
mitbringen — mitgebracht — brachte mit = приносить с собой 
nass = мокрый 
nebelig = туманно 
der Norden = север 
der November = ноябрь 
nun = теперь 
der Oktober = октябрь 
das Oktoberfest = Октоберфест 
die Oma = бабушка 
der Osten = восток 
das Osterei — Ostereier = пасхальное яйцо 
das Osterfest = Пасха 
der Osterhase = пасхальный заяц 
das Ostern = Пасха 
der Papa = папа 
räumen — geräumt = убирать 
reden — geredet = говорить 
regnen — geregnet = идти дождь 
Es regnet. = Идёт дождь. 
samstags = по субботам 
der Schatz = сокровище 
scheinen — geschienen — schien = светить 
Die Sonne scheint. = Солнце светит. 
schenken — geschenkt = дарить 
schlecht = плохой 
der Schnee = снег 
der Schneemann = снеговик 
schneien — geschneit = идти снег 
Es schneit. = Идёт снег. 
der Schokoladenkuchen = шоколадный торт 
der Sekt = игристое вино 
der September = сентябрь 
der Sommer = лето 
sonnig = солнечно 
die Spezialität — Spezialitäten = специалитет 
das Standesamt = загс 
stellen — gestellt = ставить 
der Süden = юг 
tanzen — getanzt = танцевать 
der Teller — Teller = тарелка 
die Torte — Torten = торт 
trocken = сухой 
unglücklich = несчастный 
der Unglückstag = несчастливый день 
warm = тёплый 
das Weihnachten = Рождество 
der Weihnachtsbaum — Weihnachtsbäume = рождественская ёлка 
die Weihnachtsfeier = рождественская вечеринка 
das Weihnachtsgeschenk = рождественский подарок 
der Weihnachtsmann = Дед Мороз 
das Westdeutschland = Западная Германия 
der Westen = запад 
der Wetterbericht = прогноз погоды 
wieso = почему 
Chatten, mailen, sich informieren = Чатиться, отправлять письма, узнавать 
die Abendkasse = вечерняя касса 
abholen — abgeholt = забирать 
aktuell = актуальный 
alle = все 
anklicken — angeklickt = кликать 
die App = приложение 
aussuchen — ausgesucht = выбирать 
der Benutzername = имя пользователя 
bestellen — bestellt = заказывать 
chatten — gechattet = общаться в чате 
die Datei — Dateien = файл 
dich = тебя 
diskutieren — diskutiert = обсуждать 
drucken — gedruckt = печатать 
der Eintritt — Eintritte = вход 
empfehlen — empfohlen = рекомендовать 
die Empfehlung — Empfehlungen = рекомендация 
flirten — geflirtet = флиртовать 
der Flohmarkt — Flohmärkte = блошиный рынок 
das Forum = форум 
funktionieren — funktioniert = работать 
gebraucht = б/у 
googeln — gegoogelt = гуглить 
herausfinden — herausgefunden — fand heraus = выяснять 
herunterladen — heruntergeladen = скачивать 
hochladen — hochgeladen = загружать 
informieren sich — informiert = узнавать 
international = международный 
das Internet = интернет 
das Kennwort — Kennwörter = пароль 
die Kinokarte = билет в кино 
klicken — geklickt = кликать 
der Kommentar — Kommentare = комментарий 
kostenlos = бесплатный 
das Kulturcafé = культурное кафе 
der/die Leser/in = читатель / читательница 
löschen — gelöscht = удалять 
mailen — gemailt = отправлять письмо 
mich = меня 
mitkommen — ist mitgekommen — kam mit = идти вместе 
Kommen deine Eltern mit? = Твои родители пойдут с нами? 
mitmachen — mitgemacht = участвовать 
nachschauen — nachgeschaut = проверять 
Schauen wir doch mal im Internet nach. = Давай посмотрим в интернете. 
der Neffe = племянник 
nervös = нервный 
Newsletter = рассылка 
oben = наверху 
die Politik = политика 
prima = отлично 
das Programm — Programme = программа 
die Radtour — Radtouren = велопрогулка 
der Regen = дождь 
der Regenschirm = зонт 
die Reihenfolge = последовательность 
reservieren — reserviert = резервировать 
die Reservierung = бронирование 
die Rolle — Rollen = роль 
sinken — ist gesunken — sank = опускаться 
das Smartphone = смартфон 
speichern — gespeichert = сохранять 
das Spielzeug = игрушка 
starten — gestartet = начинать 
die Startseite = главная страница 
steigen — ist gestiegen — stieg = подниматься 
das Straßenfest = уличный фестиваль 
das Symbol — Symbole = символ 
tauschen — getauscht = обменивать 
die Temperatur — Temperaturen = температура 
das Theater = театр 
der Treffpunkt = место встречи 
unternehmen — unternommen — unternahm = предпринимать 
die Verabredung — Verabredungen = договорённость 
die Veranstaltung — Veranstaltungen = мероприятие 
der Veranstaltungstipp — Veranstaltungstipps = совет по мероприятию 
der Vorschlag — Vorschläge = предложение 
die Welt = мир 
die Wettervorhersage = прогноз погоды 
die Wirtschaft = экономика 
das Würstchen = сосиска 
zeitweise = временами 
zuhören — zugehört = слушать 
zuschauen — zugeschaut = смотреть 
Mit Bus und Bahn = На автобусе и поезде 
abfahren — ist abgefahren — fuhr ab = отправляться 
die Abfahrt — Abfahrten = отправление 
ankommen — ist angekommen — kam an = прибывать 
die Ankunft — Ankünfte = прибытие 
der Anschluss = стыковка 
der Anschlusszug — Anschlusszüge = стыковочный поезд 
ausblenden — ausgeblendet = скрывать 
ausfallen — ist ausgefallen — fiel aus = отменяться 
aussteigen — ist ausgestiegen — stieg aus = выходить 
das Autofahren = вождение автомобиля 
der Automat = автомат 
das Bahnfahren = поездка на поезде 
der Bahnsteig = платформа 
bitten — gebeten = просить 
buchen — gebucht = бронировать 
die Dauer = продолжительность 
defekt = неисправный 
deshalb = поэтому 
drehen — gedreht = поворачивать 
drüben = там 
die Einfahrt — Einfahrten = въезд 
einsteigen — ist eingestiegen — stieg ein = садиться 
erhalten — erhalten = получать 
erreichen — erreicht = достигать 
der Fahrkartenschalter = билетная касса 
der Fahrplan — Fahrpläne = расписание 
der Fernbus = междугородний автобус 
fliegen — ist geflogen — flog = летать 
das Flugzeug — Flugzeuge = самолёт 
der Grund = причина 
der Halt = остановка 
hin = туда 
die Hinfahrt — Hinfahrten = поездка туда 
der/die Mitarbeiter/in = сотрудник / сотрудница 
mitnehmen — mitgenommen — nahm mit = брать с собой 
nah = близко 
nämlich = а именно 
die Nummer = номер 
die Option = вариант 
passieren — passiert = происходить 
das Pech = невезение 
planmäßig = по плану 
preiswert = недорогой 
die Reisemöglichkeit — Reisemöglichkeiten = возможность поездки 
das Reiseziel = пункт назначения 
die Richtung — Richtungen = направление 
die Rückfahrt — Rückfahrten = обратная поездка 
der/die Schaffner/in = кондуктор / кондукторша 
das Schild — Schilder = табличка 
schwarzfahren — ist schwarzgefahren — fuhr schwarz = ездить без билета 
schwierig = сложный 
der/die Senior/in = пожилой человек 
der Serviceschalter = стойка обслуживания 
sondern = а 
sparen — gespart = экономить 
die Station = станция 
die Störung — Störungen = сбой 
die Strafe — Strafen = штраф 
die Strecke — Strecken = маршрут 
umsteigen — ist umgestiegen — stieg um = пересаживаться 
die Umwelt = окружающая среда 
unterwegs = в пути 
die Verbindung — Verbindungen = соединение 
verehrt, verehrte = уважаемый / уважаемая 
„Verehrte Fahrgäste, achten Sie bitte auf die Durchsagen!“ = „Уважаемые пассажиры, обратите внимание на объявления!“ 
verpassen — verpasst = пропускать 
verschlafen — verschlafen — verschlief = проспать 
verspätet = опоздавший 
die Verspätung — Verspätungen = опоздание 
die Vorsicht = осторожность 
wenig = мало 
wohl = наверное 
die Zeitschrift — Zeitschriften = журнал 
der Zoo = зоопарк 
Unsere neue Wohnung = Наша новая квартира 
ablesen — abgelesen — las ab = считывать 
die Ablesung = снятие показаний 
abstellen — abgestellt = ставить 
Wir stellen das Fahrrad in der Garage ab. = Мы ставим велосипед в гараж. 
afrikanisch = африканский 
das Altglas = старое стекло 
aufschließen — aufgeschlossen = отпирать 
ausführen — ausgeführt = выполнять 
ausgeben — ausgegeben — gab aus = тратить 
ausziehen — ist ausgezogen — zog aus = выезжать 
beachten — beachtet = учитывать 
bedeuten — bedeutet = означать 
der Beinbruch = перелом ноги 
berufstätig = работающий 
die Beschwerde — Beschwerden = жалоба 
besichtigen — besichtigt = осматривать 
der Bezirk = район 
der Biomüll = биоотходы 
die Biotonne = контейнер для биоотходов 
das Brett = доска 
der Briefkasten — Briefkästen = почтовый ящик 
darum = поэтому 
dass = что 
die Ecke = угол 
die Einbauküche = встроенная кухня 
einrichten — eingerichtet = обустраивать 
die Einweihungsparty = вечеринка по случаю новоселья 
die Einwurfzeit — Einwurfzeiten = время доставки 
einziehen — ist eingezogen — zog ein = въезжать 
der Einzug = въезд 
entsorgen — entsorgt = утилизировать 
erfolgen — ist erfolgt = происходить 
der Fahrradständer = стойка для велосипедов 
die Fernwärme = центральное отопление 
das Gas = газ 
Gassi gehen — ist Gassi gegangen — ging Gassi = гулять с собакой 
Pablo geht mit seinem Hund Gassi. = Пабло гуляет со своей собакой. 
gehören — gehört = принадлежать 
gesondert = отдельно 
der Glascontainer = контейнер для стекла 
der/die Hausbewohner/in = житель дома 
der/die Hausmeister/in = дворник / дворничиха 
die Hausordnung = правила дома 
die Hausregel — Hausregeln = правило дома 
die Hausreinigung = уборка дома 
die Hausverwaltung = управление домом 
herzlich = сердечный 
hoch = высокий 
Hof = двор 
hoffen — gehofft = надеяться 
jemand = кто-то 
der Kellerzugang = вход в подвал 
der Kinderwagen = коляска 
die Kleinmöbel (Pl.) = мелкая мебель 
die Kommode = комод 
kündigen — gekündigt = расторгать 
legen — gelegt = класть 
leidtun — leidgetan — tat leid = сожалеть 
Es tut mir leid. = Мне жаль. 
der/die Lieferant/in = поставщик / поставщица 
liefern — geliefert = доставлять 
der/die Makler/in = маклер / маклерша 
der/die Mieter/in = арендатор / арендаторша 
der/die Mitbewohner/in = сосед по квартире 
die Mitteilung = сообщение 
die Müllabfuhr = вывоз мусора 
die Nachbarschaft = соседство 
die Nachricht = новость 
der Nachtisch = десерт 
die Nähe = близость 
ordnungsgerecht = в соответствии с порядком 
privat = частный 
reichlich = обильно 
der Restmüll = остаточный мусор 
schließlich = в конце концов 
schonen — geschont = беречь 
setzen — gesetzt = устанавливать 
sogar = даже 
sorgen — gesorgt = заботиться 
sorgfältig = тщательный 
Spaziergang = прогулка 
der Spiegel = зеркало 
der Stellplatz — Stellplätze = парковочное место 
die Tiefgarage = подземный гараж 
die Tonne = бочка 
trennen — getrennt = разделять 
die Treppe = лестница 
das Treppenhaus = лестничная клетка 
übernehmen — übernommen — übernahm = принимать 
umziehen — ist umgezogen — zog um = переезжать 
der Umzug = переезд 
der Umzugskarton — Umzugskartons = коробка для переезда 
die Vase — Vasen = ваза 
der Verbraucherzähler = счётчик потребления 
vereinbaren — vereinbart = договариваться 
der/die Vermieter/in = арендодатель / арендодательница 
vermieten — vermietet = сдавать в аренду 
vorhanden = в наличии 
wegen { Genitiv } = из-за 
weil = потому что 
weiterhin = далее 
die Wohngemeinschaft = совместное проживание 
die Wohnungsbesichtigung = осмотр квартиры 
der Wunsch — Wünsche = желание 
der Zähler = счётчик 
der Zugang — Zugänge = доступ 
zuletzt = в последний раз 
zuzüglich = плюс 
Auf dem Amt = В учреждении 
abgeben — abgegeben — gab ab = сдавать 
ablehnen — abgelehnt = отклонять 
abmelden sich — abgemeldet = сниматься с учёта 
die Abmeldung = снятие с учёта 
ähnlich = похожий 
das Amt = учреждение 
das Amtsdeutsch = официальный немецкий 
ändern — geändert = изменять 
der/die Angehörige — Angehörigen = родственник / родственница 
ankreuzen — angekreuzt = отмечать галочкой 
die Anschrift = адрес 
der Antrag — Anträge = заявление 
der/die Antragsteller/in = заявитель / заявительница 
die Arbeitsagentur = агентство по трудоустройству 
die Arbeitserlaubnis = разрешение на работу 
das Arbeitslosengeld = пособие по безработице 
der Arbeitsplatz — Arbeitsplätze = рабочее место 
die Arbeitsvermittlung = трудоустройство 
der Aufenthalt = пребывание 
die Aufenthaltserlaubnis = вид на жительство 
aufrufen — aufgerufen — rief auf = вызывать 
der Ausbildungsplatz = место обучения 
das Ausländeramt = отдел по делам иностранцев 
die Ausländerbehörde = управление по делам иностранцев 
der Ausweis = удостоверение 
beantragen — beantragt = подавать заявление 
bearbeiten — bearbeitet = обрабатывать 
die Behörde = ведомство 
die Berufsberatung = профориентация 
das Berufsinformationszentrum = центр информации о профессиях 
der/die Cousin/e = двоюродный брат / сестра 
dabei = при этом 
das Dokument = документ 
der/die Ehepartner/in = супруг / супруга 
die Eheschließung — Eheschließungen = заключение брака 
das Einwohnermeldeamt = регистрационная служба 
der/die Enkel/in = внук / внучка 
das Enkelkind — Enkelkinder = внук 
entschuldigen sich — entschuldigt = извиняться 
das Familienbuch = семейная книга 
die Familienkasse = семейный фонд 
das Familienmitglied — Familienmitglieder = член семьи 
fehlen — gefehlt = отсутствовать 
das Finanzamt = налоговая служба 
die Geburt — Geburten = рождение 
das Geburtsdatum — Geburtsdaten = дата рождения 
das Geburtsland = страна рождения 
der Geburtsname = имя при рождении 
der Geburtsort = место рождения 
die Geburtsurkunde = свидетельство о рождении 
genehmigen — genehmigt = утверждать 
das Geschlecht — Geschlechter = пол 
herein = внутрь 
hingehen — ist hingegangen — ging hin = идти туда 
die Integration = интеграция 
der Integrationskurs = интеграционный курс 
das Kindergeld = пособие на детей 
der/die Lebenspartner/in = партнёр / партнёрша по жизни 
der Lichtbildausweis = удостоверение с фото 
losfahren — ist losgefahren — fuhr los = отправляться 
männlich = мужской 
die Nichte — Nichten = племянница 
notieren — notiert = записывать 
der Personalausweis = паспорт 
der Reisepass — Reisepässe = загранпаспорт 
die Schwiegereltern (Pl.) = тёща и тесть 
die Staatsangehörigkeit = гражданство 
das Team = команда 
der Teil = часть 
die Unterlagen (Pl.) = документы 
unterschreiben — unterschrieben = подписывать 
die Urkunde — Urkunden = свидетельство 
vollständig = полный 
die Webseite — Webseiten = веб-сайт 
weiblich = женский 
wiederholen — wiederholt = повторять 
die Zulassungsstelle = регистрационный отдел 
zuständig = ответственный 
die Schule, und dann? = Школа, а потом? 
das Abitur (Abi) = аттестат зрелости 
ablegen — abgelegt = сдавать 
eine Prüfung ablegen = Сдавать экзамен 
abschließen — abgeschlossen = завершать 
anbieten — angeboten — bot an = предлагать 
der/die Anfänger/in = новичок / новичка 
die Architektur = архитектура 
das Ausland = заграница 
der Autounfall — Autounfälle = авария 
beenden — beendet = заканчивать 
die Beratung = консультация 
der Bereich = область 
die Berufsausbildung = профессиональное обучение 
die Berufsschule = профессиональная школа 
besonders = особенно 
der Bildungsweg = образовательный путь 
die Büroorganisation = организация офиса 
das Chaos = хаос 
die Decke = потолок 
das Ende = конец 
die Energie = энергия 
enthalten — enthalten = содержать 
entscheiden sich — entschieden = решаться 
erforderlich = необходимый 
die Fitness = фитнес 
fliehen — ist geflohen — floh = бежать 
fortgeschritten = продвинутый 
der/die Frisör/in = парикмахер / парикмахерша 
genial = гениальный 
hoffentlich = надеюсь 
jobben — gejobbt = подрабатывать 
die Kategorie — Kategorien = категория 
kaufmännisch = коммерческий 
die Kenntnisse (Pl.) = знания 
die Kommunikation = коммуникация 
kompakt = компактный 
kürzen — gekürzt = сокращать 
die Kursgebühr = плата за курс 
das Kurzprogramm = короткая программа 
der Lebensweg — Lebenswege = жизненный путь 
die Lehre = обучение 
das Lehrmaterial = учебный материал 
das Material = материал 
miserabel = ужасный 
mittlere = средний 
das Prost = тост 
die Prüfung = экзамен 
das Prüfungstraining = подготовка к экзамену 
der Realschulabschluss = аттестат средней школы 
reisen — ist gereist = путешествовать 
rhythmisch = ритмичный 
schaffen — geschafft = справляться 
die Schulzeit = школьное время 
seit = с 
das Semester — Semester = семестр 
separat = отдельный 
die Situation — Situationen = ситуация 
städtisch = городской 
die Terminplanung = планирование встреч 
der Test — Tests = тест 
das Thema — Themen = тема 
die Theorie = теория 
trainieren — trainiert = тренировать 
das Training = тренировка 
der Trick — Tricks = трюк 
die Überraschung — Überraschungen = сюрприз 
die Überschrift — Überschriften = заголовок 
umschreiben — umgeschrieben — schrieb um = переписывать 
verlieben sich — verliebt = влюбляться 
verlieren — verloren — verlor = терять 
Vorbereitung = подготовка 
die Vorkenntnisse (Pl.) = предварительные знания 
das Vorstellungsgespräch = собеседование 
die Weiterbildung — Weiterbildungen = дополнительное образование 
das Yoga = йога 
das Zeitmanagement = управление временем 
das Zertifikat = сертификат 
das Zeugnis = свидетельство 
zufrieden = довольный 
Auf Arbeitssuche = В поисках работы 
der/die Ansprechpartner/in = контактное лицо 
der Aushilfsjob = подработка 
aussehen — ausgesehen — sah aus = выглядеть 
der/die Auszubildende (Azubi) — Auszubildende = стажёр / стажёрка 
der/die Bäckereifachverkäufer/in = продавец в пекарне 
bedanken sich — bedankt = благодарить 
bedienen — bedient = обслуживать 
beeilen sich — beeilt = торопиться 
begründen — begründet = обосновывать 
das Beratungsgespräch = консультационное собеседование 
das Berufsfeld — Berufsfelder = профессиональная сфера 
der/die Bewerber/in = кандидат / кандидатка 
bieten — geboten — bot = предлагать 
eindecken — eingedeckt = накрывать 
genug = достаточно 
Grundschule = начальная школа 
handwerklich = ремесленный 
das Holz = дерево 
der/die Informatiker/in = информатик / информатик (жен.) 
die Kneipe = паб 
kostenfrei = бесплатный 
die Küchenhilfe = помощник на кухне 
die Laufbahn = карьера 
der Lebenslauf — Lebensläufe = резюме 
lückenlos = без пробелов 
melden sich — gemeldet = сообщать 
die Mittelschule = средняя школа 
der/die Modedesigner/in = модельер / модельерша 
das Muster = образец 
nötig = необходимый 
ob = ли 
persönlich = личный 
professionell = профессиональный 
die Reinigungsarbeiten (Pl.) = уборочные работы 
die Rente — Renten = пенсия 
der/die Restaurantfachmann/-frau = специалист по ресторанам 
spezial = специальный 
statt = вместо 
die Stelle = место 
das Stellenangebot = предложение о работе 
die Stellensuche = поиск работы 
die Struktur = структура 
sympathisch = симпатичный 
die Teilzeit = неполный рабочий день 
die Teilzeitstelle = место с неполной занятостью 
tippen — getippt = печатать 
der Tippfehler = опечатка 
der/die Tischler/in = столяр / столярка 
üben — geübt = практиковать 
die Übersiedlung = переселение 
unprofessionell = непрофессиональный 
unsympathisch = неприятный 
unzufrieden = недовольный 
verrückt = сумасшедший 
das Volleyball = волейбол 
die Vollzeit = полный рабочий день 
die Vollzeitstelle = место с полной занятостью 
die Voraussetzung — Voraussetzungen = условие 
die Vorlage — Vorlagen = шаблон 
zuverlässig = надёжный 
Ein Einkaufsbummel = Прогулка за покупками 
die Accessoires (Pl.) = аксессуары 
anhaben — angehabt = надевать 
die Apfelschorle = яблочный шорле 
die Aubergine — Auberginen = баклажан 
die Ausrüstung = оборудование 
der Babyartikel — Babyartikel = детские товары 
die Badesachen (Pl.) = купальные принадлежности 
der Bart — Bärte = борода 
die Bekleidung = одежда 
bestimmt = определённо 
Der Mantel ist bestimmt sehr teuer. = Пальто определённо очень дорогое. 
blond = блондин 
braten — gebraten = жарить 
bummeln — gebummelt = прогуливаться 
bunt = яркий 
das Camping = кемпинг 
der Champignon — Champignons = шампиньон 
die Currywurst = карривурст 
die Dame — Damen = дама 
darin = в этом 
dick = толстый 
der/die Dieb/in = вор / воровка 
das Ding — Dinge = вещь 
der Duft = аромат 
dünn = тонкий 
das Duschgel = гель для душа 
egal = всё равно 
das Ehepaar = супружеская пара 
einfarbig = одноцветный 
die Elektronik = электроника 
der Fahrradhelm = велосипедный шлем 
fantastisch = фантастический 
das Fast Food = фастфуд 
die Flipflops (Pl.) = шлёпанцы 
frittieren — frittiert = жарить во фритюре 
die Gemüselasagne = овощная лазанья 
gepunktet = в горошек 
das Gericht = блюдо 
gestreift = в полоску 
glatt = гладкий 
die Glatze = лысина 
das Gold = золото 
griechisch = греческий 
die Gulaschsuppe = суп-гуляш 
der Gürtel = ремень 
die Haarpflege = уход за волосами 
das Hauptgericht = основное блюдо 
die Hautpflege = уход за кожей 
hübsch = симпатичный 
die Kamera = камера 
kariert = в клетку 
das Kompliment — Komplimente = комплимент 
der Kopfhörer = наушники 
die Kosmetiktasche = косметичка 
die Krawatte = галстук 
das Küchengerät — Küchengeräte = кухонный прибор 
laufen — ist gelaufen — lief = бегать 
die Lieblingsfarbe = любимый цвет 
lockig = кудрявый 
das Make-up = макияж 
die Maus = мышь 
das Mineralwasser = минеральная вода 
das Modegeschäft = магазин моды 
der Modeschmuck = бижутерия 
nachher = потом 
die Naturkosmetik = натуральная косметика 
das Navigationsgerät (Navi) = навигатор 
der Ofen = печь 
der Ohrring — Ohrringe = серьга 
die Parfümerie = парфюмерный магазин 
die Pfanne = сковорода 
plötzlich = внезапно 
der/die Polizist/in = полицейский / полицейская 
der Schafskäse = овечий сыр 
scharf = острый 
schauen — geschaut = смотреть 
das Schaufenster = витрина 
schick = стильный 
schlank = стройный 
der Schmuck = украшение 
das Schnäppchen = выгодная покупка 
das Schnitzel = шницель 
der Schnurrbart = усы 
der Schrei = крик 
die Schuhgröße = размер обуви 
die Shorts = шорты 
das Silber = серебро 
der Snack — Snacks = закуска 
die Spielwaren (Pl.) = игрушки 
das Steak = стейк 
stehlen — gestohlen — stahl = красть 
der Stiefel — Stiefel = сапог 
die Süßigkeiten = сладости 
das Tattoo — Tattoos = татуировка 
der Toaster = тостер 
ungarisch = венгерский 
die Unterwäsche = нижнее бельё 
das Vanilleeis = ванильное мороженое 
der/die Vegetarier/in = вегетарианец / вегетарианка 
vegetarisch = вегетарианский 
wandern — ist gewandert = ходить пешком 
der Wanderschuh — Wanderschuhe = походная обувь 
der Wecker = будильник 
wirklich = действительно 
wunderbar = замечательный 
zubereiten — zubereitet = готовить 
die Zucchini = кабачок 
Bei der Arbeit = На работе 
absetzen — abgesetzt = снимать 
die Abteilung — Abteilungen = отдел 
angeben — angegeben — gab an = указывать 
der Anruf — Anrufe = звонок 
der/die Anrufer/in = звонивший / звонившая 
der/die Arbeitgeber/in = работодатель / работодательница 
der Arbeitsauftrag — Arbeitsaufträge = рабочее задание 
der Arbeitsbeginn = начало работы 
der Arbeitsschutz = охрана труда 
der Arbeitsvertrag — Arbeitsverträge = трудовой договор 
der Aufzug = лифт 
der Außendienst = выездная работа 
ausmachen — ausgemacht = договариваться 
der/die Beauftragte = уполномоченный / уполномоченная 
bereit = готовый 
bereitstellen — bereitgestellt = предоставлять 
besprechen — besprochen = обсуждать 
die Besprechung = совещание 
betätigen — betätigt = задействовать 
betreffen — betroffen = касаться 
bewahren — bewahrt = сохранять 
bewegen — bewegt = двигать 
der Bildschirm = экран 
der Brand = пожар 
die Brandbekämpfung = тушение пожара 
der Brandfall = случай пожара 
der Brandmelder = пожарный датчик 
der Brandschutz = противопожарная защита 
brennen — gebrannt — brannte = гореть 
die Buchhaltung = бухгалтерия 
danken — gedankt = благодарить 
deutlich = ясно 
echt = настоящий 
die Einweisung = инструктаж 
die Elektrik = электрика 
der Entwurf — Entwürfe = проект 
erlauben — erlaubt = разрешать 
erwarten — erwartet = ожидать 
erwischen — erwischt = поймать 
der Feuerlöscher = огнетушитель 
die Flamme — Flammen = пламя 
folgen — gefolgt = следовать 
gefährden — gefährdet = подвергать опасности 
gestalten — gestaltet = оформлять 
gesund = здоровый 
die Grafik — Grafiken = графика 
der/die Grafiker/in = график / график (жен.) 
die Hektik = суета 
heraussuchen — herausgesucht = выбирать 
hinfahren — ist hingefahren — fuhr hin = ехать туда 
höflich = вежливый 
der Internetzugang = доступ в интернет 
der Kabelsalat = путаница проводов 
kennzeichnen — gekennzeichnet = обозначать 
die Kerze — Kerzen = свеча 
das Konto — Konten = счёт 
die Kontoverbindung = банковские реквизиты 
kopieren — kopiert = копировать 
die Kraft — Kräfte = сила 
die Kundenbetreuung = обслуживание клиентов 
der Laptop = ноутбук 
das Marketing = маркетинг 
die Mehrfachsteckdose = удлинитель 
mitschreiben — mitgeschrieben — schrieb mit = записывать 
die Nachbereitung = последующая обработка 
nennen — genannt = называть 
die Personalabteilung = отдел кадров 
das Personalbüro = кадровый офис 
der/die Personalleiter/in = руководитель отдела кадров 
das Protokoll = протокол 
reagieren — reagiert = реагировать 
die Regel — Regeln = правило 
der Rettungswagen = скорая помощь 
die Rückfrage = обратный вопрос 
das Sekretariat = секретариат 
die Sicherheit = безопасность 
die Steckdose = розетка 
die Steuer = налог 
das Teelicht — Teelichter = чайная свеча 
überlasten — überlastet = перегружать 
unbürokratisch = неформальный 
unterstützen — unterstützt = поддерживать 
verabschieden sich — verabschiedet = прощаться 
verbessern — verbessert = улучшать 
verboten = запрещённый 
das Verhalten = поведение 
verlegen — verlegt = переносить 
vermeiden — vermieden = избегать 
die Vermeidung = избежание 
die Versicherung — Versicherungen = страховка 
der Vertrieb = сбыт 
verwenden — verwendet = использовать 
vorbeikommen — ist vorbeigekommen — kam vorbei = заходить 
vorbereiten — vorbereitet = готовить 
die Vorschrift — Vorschriften = предписание 
der Werbeflyer = рекламный листок 
die Werbeagentur = рекламное агентство 
der/die Werbetexter/in = автор рекламных текстов 
In der Schule = В школе 
aggressiv = агрессивный 
anders = другой 
die Angst — Ängste = страх 
aufhören — aufgehört = прекращать 
aufpassen — aufgepasst = следить 
ausreichend = достаточный 
befriedigend = удовлетворительный 
die Begrüßung — Begrüßungen = приветствие 
beraten — beraten = консультировать 
der Bericht — Berichte = отчёт 
das Berufskolleg = профессиональный колледж 
der Berufswunsch = желаемая профессия 
die Biologie = биология 
das Bundesland = федеральная земля 
die Chemie = химия 
damals = тогда 
dieselbe = тот же самый 
das Diplom = диплом 
der Elternabend = родительское собрание 
der Elternsprechtag = день общения с родителями 
der/die Englischlehrer/in = учитель / учительница английского 
die Erdkunde = география 
etwa = примерно 
das Fach — Fächer = предмет 
die Fachhochschule = университет прикладных наук 
die Fachhochschulreife = аттестат для поступления в университет прикладных наук 
der Fluss — Flüsse = река 
formell = формальный 
der/die Fotograf/in = фотограф / фотограф (жен.) 
freiwillig = добровольный 
die Gesamtschule = общеобразовательная школа 
die Geschichte = история 
das Gipsbein = гипс на ноге 
das Glück = счастье 
das Gymnasium = гимназия 
das Halbjahr = полугодие 
die Hauptschule = основная школа 
hinfallen — ist hingefallen — fiel hin = падать 
der Integrationsverein = интеграционная ассоциация 
der/die Jugendliche — Jugendlichen = подросток 
der Junge = мальчик 
die Kindertagesstätte (Kita) — Kindertagesstätten (Kitas) = детский сад 
die Klasse = класс 
die Klassenarbeit = классная работа 
der/die Klassenlehrer/in = классный руководитель 
der Knöchel = лодыжка 
der Korb = корзина 
die Kunst = искусство 
das Lieblingsfach — Lieblingsfächer = любимый предмет 
lösen — gelöst = решать 
die Lust = желание 
das Mädchen — Mädchen = девочка 
mangelhaft = неудовлетворительный 
die Mathearbeit = контрольная по математике 
die Meinung — Meinungen = мнение 
die Nachhilfe = дополнительные занятия 
normal = нормальный 
die Note — Noten = оценка 
die Oberschule = старшая школа 
olympisch = олимпийский 
die Pflicht = обязанность 
die Physik = физика 
der/die Pilot/in = пилот / пилот (жен.) 
die Planung = планирование 
die Realschule = реальная школа 
die Rede = речь 
die Religion = религия 
das Schaubild = диаграмма 
schrecklich = ужасный 
die Schulform = форма школы 
der/die Schulleiter/in = директор / директриса школы 
die Schulpflicht = обязательное школьное образование 
das Schulsystem = школьная система 
selbst = сам 
der/die Sozialpädagoge/-pädagogin = социальный педагог 
der Sportunterricht = урок физкультуры 
streng = строгий 
die Tagesordnung = повестка дня 
der Teenager — Teenager = подросток 
teilnehmen — teilgenommen — nahm teil = участвовать 
das Tier — Tiere = животное 
der/die Tierpfleger/in = смотритель животных 
träumen — geträumt = мечтать 
traurig = грустный 
turnen — geturnt = заниматься гимнастикой 
umknicken — umgeknickt = подвернуть 
unfair = несправедливый 
ungenügend = недостаточный 
die Uniform = униформа 
Gesund sein und gesund bleiben = Быть здоровым и оставаться здоровым 
die Akupunktur = акупунктура 
die Alternative = альтернатива 
anerkannt = признанный 
die Anweisung — Anweisungen = инструкция
die Auflistung = список
die Behandlung — Behandlungen = лечение
belegen — belegt = доказывать
die Bescheinigung — Bescheinigungen = справка
der Boden — Böden = пол
dagegen = против
damit = с этим
der Eiswürfel — Eiswürfel = кубик льда
empfindlich = чувствительный
engagieren sich — engagiert = заниматься
entspannen sich — entspannt = расслабляться
die Entspannung = расслабление
erfahren — erfahren — erfuhr = узнавать
erstatten — erstattet = возмещать
fit = в форме
gesamt = общий
gesundheitlich = связанный со здоровьем
die Gymnastik = гимнастика
das Handgelenk = запястье
das Hausmittel — Hausmittel = домашнее средство
die Haut = кожа
hiermit = этим
hierzu = к этому
hochlegen — hochgelegt = поднимать
holen — geholt = приносить
klagen — geklagt = жаловаться
kommunizieren — kommuniziert = общаться
kompliziert = сложный
die Kostenerstattung = возмещение расходов
die Kostenübernahme = покрытие расходов
kühlen — gekühlt = охлаждать
leihen — geliehen = одалживать
manche = некоторые
die Massage = массаж
massieren — massiert = массировать
die Meditation = медитация
der Muskel — Muskeln = мышца
die Nebenwirkung — Nebenwirkungen = побочный эффект
das Pilates = пилатес
der Rat = совет
reizen — gereizt = раздражать
die Rückenmuskulatur = мускулатура спины
schlafengehen — ist schlafen gegangen — ging schlafen = ложиться спать
schlagen — geschlagen — schlug = бить
die Schmerztablette = обезболивающая таблетка
die Schwellung = отёк
selber = сам
speziell = специальный
die Sportart = вид спорта
der Sportverein = спортивный клуб
ständig = постоянный
stärken — gestärkt = укреплять
der Tanzkurs = курс танцев
die Teilnahme = участие
die Teilnahmebescheinigung = свидетельство об участии
telefonisch = телефонный
die Therapie = терапия
der/die Trainer/in = тренер
treiben — getrieben — trieb = заниматься
die Tüte = пакет
die Übelkeit = тошнота
übersenden — übersandt = пересылать
überweisen — überwiesen = переводить
übrigens = кстати
die Verabschiedung = прощание
vermitteln — vermittelt = передавать
verschreiben — verschrieben = выписывать
der/die Versicherungsnehmer/in = страхователь
der Versicherungstarif = страховой тариф
die Verspannung — Verspannungen = напряжение
während { Genitiv } = во время
die Wärmflasche = грелка
weggehen — ist weggegangen — ging weg = уходить
zwischendurch = между делом
Auf der Bank = На банке
abheben — abgehoben = снимать
die Aktivität — Aktivitäten = активность
anfordern — angefordert = запрашивать
die Armut = бедность
aufheben — aufgehoben = поднимать
ausdrucken — ausgedruckt = печатать
die Bankkarte = банковская карта
der/die Bankkaufmann/Bankkauffrau = банковский служащий
die Bankleitzahl = банковский код
der Bankschalter = банковская стойка
bar = наличные
das Bargeld = наличные деньги
bargeldlos = безналичный
die Basis = основа
begleichen — beglichen = оплачивать
berechnen — berechnet = рассчитывать
die Bestellnummer = номер заказа
die Bestellung = заказ
der BIC = BIC
der Blick = взгляд
die Broschüre = брошюра
drücken — gedrückt = нажимать
eigen = собственный
die Eingabe — Eingaben = ввод
eingeben — eingegeben — gab ein = вводить
einzahlen — eingezahlt = вносить
erledigen — erledigt = выполнять
eröffnen — eröffnet = открывать
die Filiale = филиал
folgend = следующий
formulieren — formuliert = формулировать
die Gebühr — Gebühren = сбор
der Geldautomat = банкомат
die Geldbörse = кошелёк
das Geldstück — Geldstücke = монета
genießen — genossen = наслаждаться
gewinnen — gewonnen — gewann = выигрывать
die Girocard = карта Giro
das Girokonto = текущий счёт
das Hufeisen = подкова
die IBAN = IBAN
indirekt = косвенный
die Innenstadt = центр города
jederzeit = в любое время
das Kleeblatt = клевер
das Kleingeld = мелочь
der Kontoauszug — Kontoauszüge = выписка по счёту
der/die Kontoinhaber/in = владелец счёта
die Kontonummer — Kontonummern = номер счёта
der Kontostand = баланс счёта
kontrollieren — kontrolliert = контролировать
das Kreditinstitut — Kreditinstitute = кредитное учреждение
die Kreditkarte — Kreditkarten = кредитная карта
die Kundennummer — Kundennummern = номер клиента
die Kundenreferenz = клиентская ссылка
der Laden — Läden = магазин
die Leistung — Leistungen = услуга
die Menge = количество
mobil = мобильный
monatlich = ежемесячный
die Münze — Münzen = монета
niemand = никто
der Nulltarif = нулевой тариф
nutzen — genutzt = использовать
das Online-Banking = онлайн-банкинг
der Pfennig — Pfennige = пфенниг
der PIN = PIN
der Quatsch = чепуха
die Rechnung = счёт
der Rechnungsbetrag = сумма счёта
die Rechnungsnummer = номер счёта
reich = богатый
der Reichtum = богатство
der Respekt = уважение
der Schein — Scheine = купюра
schieben — geschoben — schob = толкать
schlachten — geschlachtet = забивать
der/die Schornsteinfeger/in = трубочист
das Sparkonto — Sparkonten = сберегательный счёт
das Sparschwein — Sparschweine = копилка
spätestens = самое позднее
stecken — gesteckt = засовывать
stoßen — gestoßen — stieß = толкать
die TAN = TAN
die Taste — Tasten = кнопка
der/die Täter/in = преступник
der Überfall — Überfälle = нападение
überfallen — überfallen — überfiel = нападать
die Überwachungskamera — Überwachungskameras = камера наблюдения
die Überweisung — Überweisungen = перевод
das Überweisungsformular = бланк перевода
der Versuch — Versuche = попытка
der Verwendungszweck — Verwendungszwecke = назначение платежа
der Vorteil — Vorteile = преимущество
weglaufen — ist weggelaufen — lief weg = убегать
der/die Zahlungsempfänger/in = получатель платежа
der Zeitungsartikel — Zeitungsartikel = газетная статья
der/die Zeuge/Zeugin = свидетель
zurückgeben — zurückgegeben — gab zurück = возвращать
Freizeitvergnügen = Досуговые развлечения
abschalten — abgeschaltet = отключать
der Appetit = аппетит
ärgern sich — geärgert = раздражаться
asiatisch = азиатский
der Ausflug — Ausflüge = экскурсия
ausgezeichnet = отличный
der Ausgleich = компенсация
außer { Dativ } = кроме
die Aussicht = вид
der/die Babysitter/in = няня
die Band = группа
das Basketball = баскетбол
basteln — gebastelt = мастерить
das Besteck = столовые приборы
der Chor = хор
daheim = дома
der Daumen = большой палец
der Einlass = вход
entlang { Dativ } = вдоль
das Event = событие
das Feuerzeug = зажигалка
die Freizeit = свободное время
die Freizeitaktivität — Freizeitaktivitäten = досуговая активность
das Freizeitangebot — Freizeitangebote = предложение для досуга
das Freizeitvergnügen = досуговое удовольствие
die Gabel — Gabeln = вилка
die Gastronomie = гастрономия
das Gedicht — Gedichte = стихотворение
der Gegensatz = противоположность
der/die Geiger/in = скрипач
gemischt = смешанный
das Geschirr = посуда
der Grill = гриль
die Grillkohle = уголь для гриля
der Grillplatz = место для гриля
die Grillsoße = соус для гриля
die Grillzange = щипцы для гриля
herrlich = прекрасный
herum = вокруг
interessieren sich für { Akkusativ } — interessiert = интересоваться
der/die Interviewpartner/in = собеседник
irgendwo = где-то
jährlich = ежегодный
jeweils = каждый раз
knackig = хрустящий
konzentrieren sich — konzentriert = концентрироваться
der Kumpel = приятель
die Leidenschaft = страсть
der Löffel — Löffel = ложка
malen — gemalt = рисовать
meist = чаще всего
das Messer — Messer = нож
mitfahren — ist mitgefahren — fuhr mit = ехать вместе
nähen — genäht = шить
normalerweise = обычно
das Open-Air-Konzert = концерт на открытом воздухе
der Poetry-Slam = поэтический слэм
die Regie = режиссура
der Saal — Säle = зал
das Schach = шахматы
der Schnupperkurs = пробный курс
die Schüssel = миска
segeln — gesegelt = плавать под парусом
der Sieg = победа
das Spielfeld = игровое поле
das Sportergebnis — Sportergebnisse = спортивный результат
der Sportplatz = спортивная площадка
surfen — gesurft = заниматься сёрфингом
der Tango = танго
der/die Tänzer/in = танцор
die Tischdecke = скатерть
die Tischdekoration = украшение стола
trotzdem = тем не менее
umfangreich = обширный
die Umfrage = опрос
die Umkleide = раздевалка
unterhalten sich — unterhalten = беседовать
veranstalten — veranstaltet = проводить
der Veranstaltungshinweis — Veranstaltungshinweise = уведомление о мероприятии
verbringen — verbracht = проводить
die Verpackung — Verpackungen = упаковка
verteilen — verteilt = распределять
das Volleyballspiel = игра в волейбол
die Vorlesung — Vorlesungen = лекция
wundervoll = замечательный
Gute Reise! = Хорошей поездки!
der Abfall — Abfälle = мусор
der Abflug = вылет
die Absage = отмена
aktiv = активный
der Alkohol = алкоголь
angenehm = приятный
annulliert = аннулированный
die Anzeigetafel — Anzeigetafeln = табло
der Aufruf = вызов
der Ausgang — Ausgänge = выход
die Ausstattung = оснащение
der Behälter — Behälter = контейнер
betreten — betreten = входить
der/die Bewohner/in — Bewohner/innen = житель
die Bordkarte = посадочный талон
der/die Camper/in — Camper/innen = кемпер
der Campingplatz — Campingplätze = кемпинг
der Check-in-Schalter = стойка регистрации
der Container — Container = контейнер
die Dienstreise = командировка
das Doppelbett — Doppelbetten = двуспальная кровать
das Doppelzimmer (DZ) — Doppelzimmer = двухместный номер
einchecken — eingecheckt = регистрироваться
die Einsteigezeit = время посадки
das Einzelzimmer (EZ) = одноместный номер
erleben — erlebt = переживать
der Flug — Flüge = полёт
der/die Flugbegleiter/in — Flugbegleiter/innen = бортпроводник
der Fluggast — Fluggäste = авиапассажир
die Fluggesellschaft — Fluggesellschaften = авиакомпания
führen — geführt = вести
füttern — gefüttert = кормить
das Gate = выход на посадку
das Gepäck = багаж
die Gepäckausgabe = выдача багажа
das Gepäckband = багажная лента
sein gestattet = быть разрешённым
die Halbpension (HP) = полупансион
das Handgepäck = ручная кладь
historisch = исторический
das Hostel = хостел
hygienisch = гигиенический
das Inlineskaten = катание на роликовых коньках
die Jugendherberge — Jugendherbergen = молодёжный хостел
der Katalog — Kataloge = каталог
klettern — geklettert = лазать
komfortabel = комфортный
die Lage = местоположение
das Lagerfeuer = костёр
landen — gelandet = приземляться
der Lärm = шум
die Lautsprecherdurchsage — Lautsprecherdurchsagen = объявление по громкоговорителю
lebhaft = оживлённый
die Leine = поводок
der Leuchtturm — Leuchttürme = маяк
der Meerblick = вид на море
mitten = посреди
der Nebel = туман
neblig = туманный
das Paradies = рай
der/die Passagier/in — Passagiere = пассажир
die Passkontrolle = паспортный контроль
der Pilotenstreik = забастовка пилотов
der Pool = бассейн
rechtzeitig = своевременно
das Reisebüro = туристическое агентство
der Reiseplan — Reisepläne = план поездки
die Reiseplanung = планирование поездки
reiten — geritten — ritt = ездить верхом
die Ruhezeit — Ruhezeiten = время отдыха
sauber = чистый
die Sauberkeit = чистота
der Schalter — Schalter = стойка
die Schlange = очередь
der Sonnenschirm — Sonnenschirme = зонтик от солнца
die Sonnenterrasse — Sonnenterrassen = солнечная терраса
der Sonnenuntergang — Sonnenuntergänge = закат солнца
der Stern — Sterne = звезда
stören — gestört = беспокоить
das Streichholz — Streichhölzer = спичка
streiken — gestreikt = бастовать
die Taschenlampe = фонарик
das Taschenmesser = карманный нож
traumhaft = сказочный
übernachten — übernachtet = ночевать
die Übernachtung = ночёвка
die Übernachtung mit Frühstück (ÜF) = ночёвка с завтраком
die Umgebung = окрестности
umgehend = немедленно
verärgert = раздражённый
verreisen — ist verreist = путешествовать
verschieben — verschoben = переносить
der Wanderer = путешественник
die Wandertour — Wandertouren = пешеходный тур
der Waschraum — Waschräume = умывальная комната
der Wohnwagen = жилой прицеп
das Zelt = палатка
der Zoll = таможня
der Zuschlag — Zuschläge = доплата
die Nachbarn = Соседи
absprechen — abgesprochen = договариваться
der Abstellplatz — Abstellplätze = место для хранения
akzeptieren — akzeptiert = принимать
anstreichen — angestrichen = красить
der Ärger = раздражение
ärgerlich = раздражающий
die Aufregung = волнение
die Ausnahme = исключение
das Balkongeländer = балконные перила
befestigen — befestigt = закреплять
behalten — behalten — behielt = сохранять
beleidigen — beleidigt = оскорблять
die Beleidigung — Beleidigungen = оскорбление
berechtigt = обоснованный
beschimpfen — beschimpft = ругать
die Beschimpfung — Beschimpfungen = ругательство
beschweren sich — beschwert = жаловаться
der Blumentopf — Blumentöpfe = цветочный горшок
bohren — gebohrt = сверлить
deswegen = поэтому
dumm = глупый
eilig = спешный
einhalten — eingehalten — hielt ein = соблюдать
einlegen — eingelegt = вставлять
einstellen — eingestellt = настраивать
enden — geendet = заканчивать
die Entscheidung — Entscheidungen = решение
entspannend = расслабляющий
entsprechen — entsprochen = соответствовать
erhöhen — erhöht = повышать
erleichtern — erleichtert = облегчать
erwähnen — erwähnt = упоминать
eskalieren — eskaliert = обостряться
exotisch = экзотический
fair = справедливый
festkleben — festgeklebt = приклеивать
die Freude = радость
die Frist — Fristen = срок
fristgerecht = своевременный
fristlos = без уведомления
der Gemeinschaftsraum — Gemeinschaftsräume = общая комната
gesetzlich = законный
hämmern — gehämmert = стучать
heizen — geheizt = отапливать
die Instandhaltung = обслуживание
klug = умный
der Konflikt — Konflikte = конфликт
die Kündigung = расторжение
lüften — gelüftet = проветривать
massiv = массивный
meckern — gemeckert = ворчать
das Meerschweinchen = морская свинка
die Mieterhöhung = повышение арендной платы
der Mietspiegel = обзор арендных ставок
der Mietvertrag — Mietverträge = договор аренды
die Modernisierung = модернизация
nachsehen — nachgesehen — sah nach = проверять
neugierig = любопытный
obwohl = хотя
offenbar = очевидно
protestieren — protestiert = протестовать
der/die Richter/in — Richter/innen = судья
die Rücksicht = внимание
sammeln — gesammelt = собирать
sauer = кислый / сердитый
der Schaden — Schäden = ущерб
schmutzig = грязный
selbstverständlich = само собой разумеющийся
sinnlos = бессмысленный
sinnvoll = осмысленный
sortieren — sortiert = сортировать
stinken — gestunken — stank = вонять
streiten sich — gestritten = спорить
total = полный
treu = верный
überlegen — überlegt = обдумывать
üblich = обычный
unglaublich = невероятный
das Unrecht = несправедливость
das Urteil = приговор
vergleichbar = сравнимый
verpflichten — verpflichtet = обязывать
das Verständnis = понимание
der Verstoß — Verstöße = нарушение
verstoßen — verstoßen — verstieß = нарушать
völlig = полностью
vorher = раньше
wegräumen — weggeräumt = убирать
der Widerspruch — Widersprüche = противоречие
wütend = злой
der Zeitraum — Zeiträume = период
ziemlich = довольно
die Zimmerlautstärke = комнатная громкость
zugeben — zugegeben — gab zu = признавать
zurücklassen — zurückgelassen — ließ zurück = оставлять
das Zusammenleben = совместная жизнь
zustimmen — zugestimmt = соглашаться
der Zutritt = доступ
Ein Schulprojekt zum Umweltschutz = Школьный проект по защите окружающей среды
das Abgas — Abgase = выхлопные газы
das Abwasser = сточные воды
das Altöl = отработанное масло
das Altpapier = макулатура
das Aluminium = алюминий
andauernd = постоянный
ankündigen — angekündigt = объявлять
anstatt { Genitiv } = вместо
die Begleitperson = сопровождающее лицо
belasten — belastet = нагружать
die Belastung = нагрузка
beobachten — beobachtet = наблюдать
der Beutel — Beutel = мешок
biologisch = биологический
die Chemikalie — Chemikalien = химикат
der Deckel = крышка
doof = глупый
der Eierkarton — Eierkartons = картонная упаковка для яиц
die Eierschale — Eierschalen = яичная скорлупа
einfallen — ist eingefallen — fiel ein = приходить в голову
das Elektroauto = электромобиль
das Energiesparhaus = энергосберегающий дом
die Energiesparlampe = энергосберегающая лампа
das Erdbeben = землетрясение
die Erde = земля
die Erderwärmung = глобальное потепление
die Erlaubnis = разрешение
der/die Förster/in — Förster/innen = лесник
der Gegenstand — Gegenstände = предмет
der Gegenvorschlag — Gegenvorschläge = встречное предложение
giftig = ядовитый
der Haushalt = домашнее хозяйство
das Hochwasser = наводнение
der/die Hörer/in — Hörer/innen = слушатель
der Kaffeefilter = кофейный фильтр
das Klima = климат
der Klimawandel = изменение климата
die Konservendose = консервная банка
der Kunststoff — Kunststoffe = пластик
die Luft = воздух
die Matratze = матрас
das Metall = металл
der Milchkarton = молочный пакет
die Mülltonne = мусорный бак
die Mülltrennung = сортировка мусора
die Naturkatastrophe = природная катастрофа
das Naturprodukt — Naturprodukte = натуральный продукт
die Obstschale — Obstschalen = фруктовая миска
der Papiermüll = бумажный мусор
die Pappe = картон
das Picknick = пикник
der Planet — Planeten = планета
das Plastik = пластик
recyceln — recycelt = перерабатывать
der Sack — Säcke = мешок
die Sammelstelle = пункт сбора
schädigen — geschädigt = наносить вред
schädlich = вредный
der Schadstoff — Schadstoffe = загрязняющее вещество
schützen — geschützt = защищать
die Solarenergie = солнечная энергия
der Sondermüll = специальный мусор
der Sonnenschein = солнечный свет
die Sorge = забота
sparsam = экономный
der Sperrmüll = крупногабаритный мусор
stattfinden — stattgefunden — fand statt = происходить
der Tierschutz = защита животных
das Trinkwasser = питьевая вода
trüb = мутный
der Tsunami = цунами
der Turm = башня
umdrehen — umgedreht = поворачивать
umgehen — umgangen — umging = обходить
umweltfreundlich = экологичный
der Umweltschutz = защита окружающей среды
die Umweltverschmutzung = загрязнение окружающей среды
das Unwetter — Unwetter = непогода
verändern — verändert = изменять
verlaufen — ist verlaufen — verlief = проходить
verschmutzen — verschmutzt = загрязнять
verschwenden — verschwendet = тратить впустую
die Verschwendung = расточительство
versprechen — versprochen — versprach = обещать
verwerten — verwertet = утилизировать
voraussichtlich = предположительно
vorhersagen — vorhergesagt — sagte vorher = предсказывать
wahrscheinlich = вероятно
wegschmeißen (ugs.) — weggeschmissen — schmiss weg = выбрасывать
wegwerfen — weggeworfen — warf weg = выбрасывать
der Wertstoff — Wertstoffe = ценный материал
der Wind = ветер
die Windel — Windeln = подгузник
der Wirbelsturm — Wirbelstürme = ураган
die Wolke — Wolken = облако
zerstören — zerstört = разрушать
die Zerstörung = разрушение
die Zigarettenkippe — Zigarettenkippen = сигаретный окурок
zurückfahren — ist zurückgefahren — fuhr zurück = возвращаться
Online einkaufen = Покупки онлайн
AGB (Allgemeine Geschäftsbedingungen) = общие условия сделки
anfassen — angefasst = трогать
die Anprobe = примерка
anprobieren — anprobiert = примерять
die Art — Arten = вид
die Artikelnummer — Artikelnummern = номер артикула
die Atmung = дыхание
atmungsaktiv = дышащий
aufmerksam = внимательный
der Auftrag = заказ
die Auftragsnummer = номер заказа
ausliefern — ausgeliefert = доставлять
die Auswahl = выбор
der Bankeinzug = банковский перевод
bereits = уже
beschädigt = повреждённый
die Bestellhotline = горячая линия заказов
der Betrag — Beträge = сумма
der Bezahlvorgang — Bezahlvorgänge = процесс оплаты
das Callcenter = колл-центр
der Datenschutz = защита данных
dicht = плотный
durchlässig = проницаемый
ebenso = также
eher = скорее
das Eigentum = собственность
die Ergänzung — Ergänzungen = дополнение
erhältlich = доступный
eventuell = возможно
falls = если
der Gutschein = купон
herstellen — hergestellt = производить
die Herstellung = производство
das Impressum = выходные данные
innerhalb { Genitiv } = в пределах
irgendwie = как-то
der Kauf = покупка
die Kaufbestätigung = подтверждение покупки
der/die Käufer/in — Käufer/innen = покупатель
der Kaufvertrag = договор купли-продажи
die Kosmetik = косметика
die Kundenbefragung = опрос клиентов
kundenfreundlich = дружелюбный к клиентам
das Lager = склад
lieferbar = доступный для доставки
die Lieferbedingung — Lieferbedingungen = условие доставки
die Lieferung = доставка
luftdurchlässig = воздухопроницаемый
die Mehrkosten (Pl.) = дополнительные расходы
die Nachnahme = наложенный платёж
der Nachteil = недостаток
der Onlineeinkauf = онлайн-покупка
der Onlineshop = интернет-магазин
das Onlineshopping = онлайн-шопинг
das Paket = посылка
der Paketbote = курьер
der Paketdienst = служба доставки
das Porto = почтовые расходы
portofrei = без почтовых расходов
die Portokosten (Pl.) = почтовые издержки
produzieren — produziert = производить
die Qualität = качество
die Reklamation — Reklamationen = рекламация
die Retoure — Retouren = возврат
der Retourenschein = талон на возврат
die Rücksendung = обратная отправка
das Shopping = шопинг
unverbindlich = необязательный
der/die Verbraucher/in — Verbraucher/innen = потребитель
verpacken — verpackt = упаковывать
der Versand = отправка
die Versandkosten (Pl.) = стоимость доставки
versandkostenfrei = бесплатная доставка
die Versandkostenpauschale = фиксированная плата за доставку
versenden — versandt = отправлять
die Ware — Waren = товар
der Warenkorb = корзина
wasserdicht = водонепроницаемый
der Werktag — Werktage = рабочий день
wetterfest = устойчивый к погоде
widerrufen — widerrufen = отменять
das Widerrufsrecht = право на отмену
die Zahlung = оплата
zurückschicken — zurückgeschickt = отправлять обратно
zurücksenden — zurückgesandt = возвращать
zurücktreten — ist zurückgetreten — trat zurück = отступать
zustellen — zugestellt = доставлять
Fernsehen und Unterhaltung = Телевидение и развлечения
das Alter = возраст
anschauen — angeschaut = смотреть
der Anstoß = толчок
anstrengend = утомительный
das Autorennen = автогонки
befragen — befragt = опрашивать
begeistern sich — begeistert = увлекаться
beliebt = популярный
der Biergarten = пивной сад
das Boxen = бокс
die Chips (Pl.) = чипсы
demnächst = скоро
die Detektivgeschichte = детективная история
das Diagramm = диаграмма
die Diskussion = дискуссия
die Dokumentation (Doku) — Dokumentationen (Dokus) = документальный фильм
doppelt = двойной
dramatisch = драматичный
der Durchschnitt = среднее значение
die DVD = DVD
ehrlich = честный
einschlafen — ist eingeschlafen — schlief ein = засыпать
einsetzen — eingesetzt = использовать
das Eishockey = хоккей
der Eiskunstlauf = фигурное катание
entstehen — ist entstanden — entstand = возникать
das Ereignis — Ereignisse = событие
erfolgreich = успешный
das Ergebnis — Ergebnisse = результат
der/die Experte/Expertin — Experten/Expertinnen = эксперт
der Fan — Fans = фанат
der Fußballclub = футбольный клуб
die Gewohnheit — Gewohnheiten = привычка
das Golf = гольф
der Handball = гандбол
das Herz = сердце
der Horrorfilm = фильм ужасов
der/die Kandidat/in — Kandidaten/Kandidatinnen = кандидат
der/die Kommissar/in — Kommissare/Kommissarinnen = комиссар
der/die Kommentator/in — Kommentatoren/Kommentatorinnen = комментатор
die Komödie — Komödien = комедия
der Krimi — Krimis = криминал
kuscheln — gekuschelt = обниматься
die Langeweile = скука
die Leichtathletik = лёгкая атлетика
die Lieblingsbeschäftigung = любимое занятие
das Magazin = журнал
die Mannschaft = команда
die Mehrheit = большинство
die Minderheit = меньшинство
mitreden — mitgeredet = участвовать в разговоре
das Mittelfeld = полузащита
die Moderation = модерация
der Mord = убийство
motiviert = мотивированный
naschen — genascht = лакомиться
die Niederlage = поражение
objektiv = объективный
die Quizshow = викторина
das Radrennen = велогонки
die Rangliste = рейтинг
das Rätsel — Rätsel = загадка
die Reportage = репортаж
der/die Reporter/in — Reporter/innen = репортёр
retten — gerettet = спасать
romantisch = романтичный
die Runde = раунд
schalten — geschaltet = переключать
der Schiedsrichter = судья
schießen — geschossen — schoss = стрелять
die Seifenoper — Seifenopern = мыльная опера
die Sendung — Sendungen = передача
die Serie — Serien = сериал
siegen — gesiegt = побеждать
der/die Sieger/in — Sieger/innen = победитель
der Skisport = лыжный спорт
die Soap = мыльная опера
spannend = захватывающий
der/die Spieler/in — Spieler/innen = игрок
der Spielfilm = художественный фильм
das Stadion = стадион
die Statistik = статистика
der Tagesablauf = распорядок дня
die Talkshow = ток-шоу
das Tor — Tore = ворота
der/die Torwart/in = вратарь
der/die Tote — Toten = мёртвый
die Übertragung = трансляция
unentschieden = ничья
ungesund = нездоровый
die Unterhaltung = развлечение
der/die Verlierer/in — Verlierer/innen = проигравший
die Weltmeisterschaft (WM) = чемпионат мира
weshalb = почему
zappen — gezappt = переключать каналы
der Zeichentrickfilm = мультфильм
die Zeitverschwendung = трата времени
der/die Zuschauer/in — Zuschauer/innen = зритель
So war das damals … = Так было тогда …
der/die Alliierte — Alliierten = союзник
die Amtssprache — Amtssprachen = официальный язык
anfangs = вначале
anheben — angehoben = поднимать
die Arbeitskraft — Arbeitskräfte = рабочая сила
die Arbeitslosigkeit = безработица
der/die Astronaut/in — Astronauten/Astronautinnen = астронавт
das Asyl = убежище
aufschreiben — aufgeschrieben — schrieb auf = записывать
aufteilen — aufgeteilt = делить
der Auswanderer — Auswanderer = эмигрант
die Auswanderung = эмиграция
die Besatzungszone — Besatzungszonen = зона оккупации
besiegen — besiegt = побеждать
der/die Bundeskanzler/in = федеральный канцлер
die Bundesrepublik (BRD) = Федеративная Республика Германия
der/die Bürger/in — Bürger/innen = гражданин
der Bürgerkrieg = гражданская война
die Demokratie = демократия
demokratisch = демократический
die Demonstration — Demonstrationen = демонстрация
die Deutsche Demokratische Republik (DDR) = Германская Демократическая Республика
ehemalig = бывший
einführen — eingeführt = вводить
einsperren — eingesperrt = заключать в тюрьму
die Einwanderung = иммиграция
emotional = эмоциональный
entwickeln — entwickelt = развивать
erinnern sich an { Akkusativ } — erinnert = вспоминать
die Erinnerung — Erinnerungen = воспоминание
ernähren — ernährt = питать
die Europäische Union (EU) = Европейский Союз
die Euroeinführung = введение евро
der Flüchtling — Flüchtlinge = беженец
fördern — gefördert = способствовать
die Fremdsprache — Fremdsprachen = иностранный язык
friedlich = мирный
der/die Gastarbeiter/in — Gastarbeiter/innen = гастарбайтер
das Gefühl — Gefühle = чувство
der/die Gegner/in — Gegner/innen = противник
das Gehalt — Gehälter = зарплата
das Gewürz — Gewürze = специя
die Grenze — Grenzen = граница
gründen — gegründet = основывать
hart = тяжёлый
die Hauptstadt — Hauptstädte = столица
die Heimat = родина
die Industrie = промышленность
irgendwann = когда-нибудь
jahrelang = годами
das Jahrhundert — Jahrhunderte = век
das Jahrzehnt — Jahrzehnte = десятилетие
der/die Jude/Jüdin — Juden/Jüdinnen = еврей
kaum = едва
die Kindheit = детство
der Krieg — Kriege = война
das Kriegsende = конец войны
die Krippe — Krippen = ясли
der/die Kritiker/in — Kritiker/innen = критик
die Mauer — Mauern = стена
der Mauerbau = строительство стены
der Mauerfall = падение стены
die Medizin = медицина
merken — gemerkt = замечать
die Migration = миграция
miteinander = друг с другом
miterleben — mitgelebt = переживать вместе
musikalisch = музыкальный
die Muttersprache — Muttersprachen = родной язык
die Nachkriegszeit = послевоенное время
der Nationalsozialismus = национал-социализм
die NATO = НАТО
die Notunterkunft — Notunterkünfte = временное жильё
die Öffnung = открытие
die Phase — Phasen = фаза
politisch = политический
der Protest — Proteste = протест
die Regierung — Regierungen = правительство
die Republik — Republiken = республика
der/die Russlanddeutsche — Russlanddeutschen = российский немец
der Staat — Staaten = государство
die Staatsgründung = основание государства
das Stipendium — Stipendien = стипендия
tatsächlich = действительно
die Teilung — Teilungen = разделение
verdrängen — verdrängt = вытеснять
vereinigen — vereinigt = объединять
verfolgen — verfolgt = преследовать
verhaften — verhaftet = арестовывать
verlängern — verlängert = продлевать
verlassen — verlassen — verließ = покидать
vermischen — vermischt = смешивать
das Visum — Visa = виза
das Weltall = космос
wiedervereinigen — wiedervereinigt = воссоединять
die Wiedervereinigung = воссоединение
zerschlagen — zerschlagen — zerschlug = разбивать
zurückkehren — ist zurückgekehrt — kehrte zurück = возвращаться
Deutschland – zweite Heimat? = Германия – вторая родина?
abschicken — abgeschickt = отправлять
die Abwicklung = обработка
amtlich = официальный
anerkennen — anerkannt = признавать
die Anerkennung = признание
der Anfang — Anfänge = начало
ansteckend = заразный
ausstellen — ausgestellt = выписывать
die Bearbeitung = обработка
beglaubigen — beglaubigt = заверять
die Beglaubigung = заверение
der/die Bekannte — Bekannten = знакомый
benötigen — benötigt = нуждаться
berufen sich — berufen = ссылаться
bescheinigen — bescheinigt = удостоверять
sein dran — ist dran gewesen — war dran = быть на очереди
einreichen — eingereicht = подавать
enttäuschen — enttäuscht = разочаровывать
die Enttäuschung — Enttäuschungen = разочарование
der Erhalt = получение
die Erklärung — Erklärungen = объяснение
erkundigen sich — erkundigt = справляться
die Fähigkeit — Fähigkeiten = способность
die Fantasie = фантазия
die Formalität — Formalitäten = формальность
förmlich = формальный
die Fotokopie — Fotokopien = фотокопия
der Frieden = мир
das Führungszeugnis = справка о несудимости
garantieren — garantiert = гарантировать
der Gedanke — Gedanken = мысль
die Geduld = терпение
geduldig = терпеливый
die Gemeinsamkeit — Gemeinsamkeiten = общность
der Geruch — Gerüche = запах
das Gesundheitszeugnis = медицинская справка
gewährleisten — gewährleistet = обеспечивать
häufig = частый
das Heimweh = тоска по родине
herkommen — ist hergekommen — kam her = приезжать
das Herkunftsland — Herkunftsländer = страна происхождения
hierher = сюда
hilfsbereit = готовый помочь
inzwischen = тем временем
die Kopie — Kopien = копия
die Mentalität — Mentalitäten = менталитет
nachdenklich = задумчивый
der/die Pflegehelfer/in — Pflegehelfer/innen = помощник по уходу
die Pflegekraft — Pflegekräfte = работник по уходу
die Reihe = ряд
der/die Sachbearbeiter/in — Sachbearbeiter/innen = сотрудник по делам
der Sprachnachweis = подтверждение знания языка
übereinstimmen — übereingestimmt = соответствовать
überglücklich = очень счастливый
übersetzen — übersetzt = переводить
die Übersetzung — Übersetzungen = перевод
das Übersetzungsbüro = бюро переводов
ungeduldig = нетерпеливый
vermissen — vermisst = скучать
verurteilen — verurteilt = осуждать
wahr = истинный
weitergehen — ist weitergegangen — ging weiter = продолжать
wohlfühlen sich — wohlgefühlt = чувствовать себя хорошо
das Ziel — Ziele = цель
zügig = быстро
zusammenstellen — zusammengestellt = составлять
Ein neuer Arbeitsplatz = новый рабочий место
abhängig = зависимый
absolvieren — absolviert = завершать
der/die Abteilungsleiter/in — Abteilungsleiter/innen = руководитель отдела
abwechslungsreich = разнообразный
der/die Altenpfleger/in — Altenpfleger/innen = сиделка для пожилых
die Anlage = оборудование / приложение
die Annahme = принятие / предположение
anrechnen — angerechnet = засчитывать
die Anstellung = найм
die Arbeitsstelle = рабочее место
die Arbeitsweise = способ работы
die Arbeitszeit — Arbeitszeiten = рабочее время
die Assistenz = помощь
die Aufteilung = распределение
der Auszug — Auszüge = выписка / переезд
der Bachelor = бакалавр
beherrschen — beherrscht = владеть
beilegen — beigelegt = прилагать
die Berufsbezeichnung = профессиональное звание
die Berufserfahrung = профессиональный опыт
das Berufsleben = профессиональная жизнь
die Betriebswirtschaft = экономика предприятия
beurteilen — beurteilt = оценивать
das Bewerbungsschreiben = сопроводительное письмо
der/die Bilanzbuchhalter/in — Bilanzbuchhalter/innen = бухгалтер по балансу
bisher = до сих пор
das Briefpapier = писчая бумага
das Büromaterial = офисные материалы
die Bürozeit — Bürozeiten = офисное время
das Catering = кейтеринг
daneben = рядом / мимо
eigenverantwortlich = самостоятельный
eingehen — ist eingegangen — ging ein = поступать
einschreiben — eingeschrieben — schrieb ein = записывать
das Eintrittsdatum = дата вступления
der Empfang = приём / ресепшен
empfangen — empfangen — empfing = принимать
englischsprachig = англоязычный
entnehmen — entnommen — entnahm = извлекать
die Erstellung = создание
färben — gefärbt = красить
das Fax = факс
die Festanstellung = постоянная работа
festlegen — festgelegt = устанавливать
finanziell = финансовый
das Finanzwesen = финансы
der Firmensitz = местонахождение фирмы
fließend = свободно
der Föhn = фен
fordern — gefordert = требовать
die Formulierung = формулировка
die Fortbildung = повышение квалификации
die Frisur = причёска
die Gehaltsvorstellung = ожидания по зарплате
der/die Geschäftsführer/in — Geschäftsführer/innen = управляющий директор
die Geschäftsführung = управление
gleichzeitig = одновременно
die Handlung = действие
die Herausforderung = вызов
individuell = индивидуальный
insofern = поскольку
intern = внутренний
die Jobbezeichnung = название должности
der Kamm = расчёска
die Kommunikationsstärke = сила коммуникации
kommunikativ = коммуникабельный
der Konferenzraum = конференц-зал
die Kontaktdaten (Pl.) = контактные данные
kümmern sich — gekümmert = заботиться
leistungsgerecht = справедливый по результатам
leiten — geleitet = руководить
der/die Manager/in — Manager/innen = менеджер
der Maschinenbau = машиностроение
meistern — gemeistert = овладевать
der/die Millionär/in = миллионер
mittelständisch = средний бизнес
nachdem = после того как
das Niveau = уровень
das Original = оригинал
der PC — PCs = персональный компьютер
der Posteingang = входящая почта
die Probezeit = испытательный срок
die Qualifikation — Qualifikationen = квалификация
regeln — geregelt = регулировать
der/die Sales Manager/in — Sales Manager/innen = менеджер по продажам
schneiden — geschnitten — schnitt = резать
das Schreiben = письмо / писание
seitdem = с тех пор
der/die Selbstständige — Selbstständigen = самозанятый
senden — gesandt = отправлять
das Seniorenheim = дом престарелых
soweit = насколько
die Speise — Speisen = блюдо
spezialisieren sich — spezialisiert = специализироваться
die Stellenanzeige — Stellenanzeigen = объявление о вакансии
der Steuerberater = налоговый консультант
das Steuerberatungsbüro = офис налогового консультанта
die Teamfähigkeit = умение работать в команде
die Telekommunikation = телекоммуникация
der Terminkalender = календарь встреч
traditionsreich = богатый традициями
die Überstunde — Überstunden = сверхурочная работа
der Umgang = общение / обращение
die Umschulung = переподготовка
unbefristet = бессрочный
das Unternehmen — Unternehmen = предприятие
der Urlaubstag — Urlaubstage = день отпуска
verabreden — verabredet = договариваться
die Vergütung = вознаграждение
die Verstärkung = усиление
weiterhelfen — weitergeholfen — half weiter = помогать дальше
die Weiterleitung = переадресация
das Werkzeug = инструмент
zaubern — gezaubert = колдовать
zeitlich = временной
der Zeitpunkt = момент времени
zusätzlich = дополнительный
die Zusatzqualifikation = дополнительная квалификация
die Zuverlässigkeit = надёжность
Büroalltag = офисная повседневность
abdrehen — abgedreht = выключать
abheften — abgeheftet = подшивать
allerdings = однако
anmachen — angemacht = включать
ansehen — angesehen — sah an = смотреть
aufdrehen — aufgedreht = включать
aufmachen — aufgemacht = открывать
ausschalten — ausgeschaltet = выключать
ausschlafen — ausgeschlafen = высыпаться
das Besprechungszimmer = комната для совещаний
der Büroalltag = офисная повседневность
der/die Büroassistent/in — Büroassistenten/Büroassistentinnen = офисный ассистент
der Büroraum — Büroräume = офисное помещение
die Dienstleistung — Dienstleistungen = услуга
drinnen = внутри
einschalten — eingeschaltet = включать
die Energiekosten (Pl.) = затраты на энергию
die Energieverschwendung = растрата энергии
der/die Handwerker/in — Handwerker/innen = мастер
die Heizkosten (Pl.) = затраты на отопление
indem = тем что
kippen — gekippt = опрокидывать
der/die König/in — Könige/Königinnen = король
der Kopierer — Kopierer = копировальный аппарат
langfristig = долгосрочный
mehrmals = несколько раз
die Million — Millionen = миллион
mitdenken — mitgedacht — dachte mit = думать вместе
offen = открытый
die Privatnummer = личный номер
rasieren sich — rasiert = бриться
die Reinigungsfirma = уборочная фирма
der Reinigungsvertrag = договор на уборку
senken — gesenkt = снижать
stinksauer (ugs.) = очень злой
der Strom = электричество
der Stromanbieter = поставщик электроэнергии
die Stromkosten (Pl.) = затраты на электричество
tropfen — getropft = капать
übergeben — übergeben — übergab = передавать
unnötig = ненужный
der Verbrauch = потребление
verschwenden — verschwendet = тратить впустую
das Vertragsende = окончание договора
die Vertragsnummer = номер договора
die Wärme = тепло
der Wasserhahn = водопроводный кран
die Weise = способ
zudrehen — zugedreht = закручивать
zumachen — zugemacht = закрывать
die Zusammenarbeit = сотрудничество
zusammenarbeiten — zusammengearbeitet = работать вместе
Gesunde Ernährung = здоровое питание
abnehmen — abgenommen — nahm ab = худеть
achten — geachtet = обращать внимание
die Allergie = аллергия
allergisch = аллергический
der Anbau = выращивание
angewöhnen sich — angewöhnt = привыкать
auseinandersetzen sich — auseinandergesetzt = разбираться
ausgewogen = сбалансированный
ausprobieren — ausprobiert = пробовать
bedenklich = сомнительный
die Bedingung — Bedingungen = условие
behaupten — behauptet = утверждать
die Berufstätigkeit = профессиональная деятельность
die Bevölkerung = население
bewusst = сознательный
bio (biologisch) = био (биологический)
das Bioprodukt — Bioprodukte = биопродукт
bloß = только / лишь
der/die Diabetiker/in — Diabetiker/innen = диабетик
der Döner = дёнер
durchschnittlich = средний
das Einkommen — Einkommen = доход
einseitig = односторонний
das Eiweiß = белок
erkennen — erkannt = узнавать
die Ernährung = питание
der/die Esser/in — Esser/innen = едок
das Fertiggericht = готовое блюдо
fett = жирный
fix = быстрый
fleischfrei = без мяса
fleischlos = без мяса
der Freundeskreis = круг друзей 
der Frust = разочарование 
furchtbar = ужасный 
der Gang — Gänge = проход 
der/die Gemüsehändler/in — Gemüsehändler/innen = продавец овощей 
der Geschmack = вкус 
das Getreide = зерно 
glutenfrei = безглютеновый 
grundsätzlich = принципиально 
der Hartweizen = твёрдая пшеница 
die Haselnuss — Haselnüsse = фундук 
der Hauptgrund — Hauptgründe = главная причина 
die Hülsenfrucht — Hülsenfrüchte = бобовые 
industriell = промышленный 
die Institution — Institutionen = учреждение 
irgendwelche = какие-то 
irgendwer = кто-то 
das Kochbuch — Kochbücher = кулинарная книга 
kulinarisch = кулинарный 
laktosefrei = безлактозный 
die Laune = настроение 
leiden — gelitten = страдать 
die Massentierhaltung = массовое животноводство 
der Milchzucker = молочный сахар 
moralisch = моральный 
der Nährstoff — Nährstoffe = питательное вещество 
das Nahrungsmittel — Nahrungsmittel = продукт питания 
nebenbei = кстати 
die Nuss — Nüsse = орех 
präsentieren — präsentiert = представлять 
problemlos = беспроблемный 
der Quark = творог 
reduzieren — reduziert = уменьшать 
die Studie = исследование 
die Tiefkühlpizza — Tiefkühlpizzen = замороженная пицца 
tierisch = животный 
der Trend = тенденция 
überzeugen — überzeugt = убеждать 
vegan = веганский 
der/die Veganer/in — Veganer/innen = веган 
vereinbar = совместимый 
versorgen — versorgt = снабжать 
vertragen — vertragen = переносить 
der Verzehr = потребление 
verzichten — verzichtet = отказываться 
vorbeigehen — ist vorbeigegangen — ging vorbei = проходить мимо 
der Wert — Werte = ценность 
die Wurst — Würste = колбаса 
der Zeitmangel = нехватка времени 
der Zeitungsbericht = газетный репортаж 
zufällig = случайный 
zunehmen — zugenommen — nahm zu = увеличиваться 
der Zusatzstoff — Zusatzstoffe = добавка 
Gut versichert! = Хорошо застрахован! 
abdecken — abgedeckt = покрывать 
absichtlich = намеренно 
anfahren — ist angefahren — fuhr an = трогаться 
ärztlich = медицинский 
aufkommen — ist aufgekommen — kam auf = возникать 
ausparken — ausgeparkt = выезжать с парковки 
der Außenspiegel — Außenspiegel = боковое зеркало 
der/die Autofahrer/in — Autofahrer/innen = водитель 
die Automarke = марка автомобиля 
das Autoteil — Autoteile = автозапчасть 
die Autoversicherung = автострахование 
das Benzin = бензин 
beschädigen — beschädigt = повреждать 
betrunken = пьяный 
der Blinker — Blinker = поворотник 
bremsen — gebremst = тормозить 
das Dach = крыша 
der Diebstahl = кража 
das Dorf = деревня 
einbrechen — ist eingebrochen — brach ein = вламываться 
der/die Einbrecher/in — Einbrecher/innen = взломщик 
der Einbruch = взлом 
einparken — eingeparkt = парковаться 
die Fahrerseite = сторона водителя 
der/die Freiwillige — Freiwilligen = доброволец 
frustriert = разочарованный 
der Gebrauchtwagen — Gebrauchtwagen = подержанный автомобиль 
die Haftpflicht = ответственность 
die Haftpflichtversicherung = страхование ответственности 
der Hagel = град 
der Hügel = холм 
die Kaskoversicherung = каско-страхование 
der Kilometer = километр 
der Kofferraum = багажник 
korrekt = правильный 
krachen — gekracht = разбиваться 
der Kratzer — Kratzer = царапина 
lenken — gelenkt = управлять 
lohnen sich — gelohnt = окупаться 
der Motor — Motoren = двигатель 
die Motorhaube = капот 
der/die Motorradfahrer/in — Motorradfahrer/innen = мотоциклист 
nachdenken — nachgedacht — dachte nach = размышлять 
der Neuwagen — Neuwagen = новый автомобиль 
das Nummernschild — Nummernschilder = номерной знак 
der Oldtimer = старый автомобиль 
optimistisch = оптимистичный 
parken — geparkt = парковать 
die Parklücke = парковочное место 
der Personenschaden — Personenschäden = телесный ущерб 
PS (Pferdestärke) = лошадиные силы 
quietschen — gequietscht = скрипеть 
regulieren — reguliert = регулировать 
die Regulierung = регулирование 
der Reifen — Reifen = шина 
das Rücklicht — Rücklichter = задний фонарь 
die Rückscheibe = заднее стекло 
rückwärts = назад 
rutschen — ist gerutscht = скользить 
der Sachschaden — Sachschäden = материальный ущерб 
der Schadensfall = страховой случай 
die Scheibe — Scheiben = стекло 
der Scheinwerfer — Scheinwerfer = фара 
der Schläger = хулиган 
schwingen — geschwungen — schwang = качать 
der Sinn = смысл 
der Sportwagen = спортивный автомобиль 
die Stoßstange = бампер 
der Straßenrand = обочина 
der Straßenverkehr = дорожное движение 
der Sturm = шторм 
das/der Sport Utiliy Vehicle (SUV) = внедорожник 
die Teilkaskoversicherung (Teilkasko) = частичное каско-страхование 
überraschen — überrascht = удивлять 
die Überschwemmung = наводнение 
umfallen — ist umgefallen — fiel um = падать 
umso = тем более 
der Unfall — Unfälle = авария 
die Unfallgefahr = риск аварии 
verletzen — verletzt = ранить 
versehentlich = случайно 
versichern — versichert = страховать 
der/die Versicherungsberater/in — Versicherungsberater/innen = страховой консультант 
der Versicherungsschutz = страховое покрытие 
verursachen — verursacht = вызывать 
die Vollkaskoversicherung (Vollkasko) = полное каско-страхование 
vorschreiben — vorgeschrieben — schrieb vor = предписывать 
vorsichtig = осторожный 
wegfahren — ist weggefahren — fuhr weg = уезжать 
die Windschutzscheibe = лобовое стекло 
zulassen — zugelassen — ließ zu = допускать 
zusammenstoßen — ist zusammengestoßen — stieß zusammen = сталкиваться 
die Zusatzversicherung = дополнительное страхование