ist gewesen — wäre = был — был бы = be — was; were
ihr habt — hätte = прошедшее — имел бы = have — had
wird — ist geworden — wurde = будущее — стал — бы = become — became
konnte — könnte = мог — мог бы = can — could
von (Dativ) = от = from
der Mann — Männer = мужчина; человек = man
aus (Dativ) = из = from
richtig = правильно = correct
nach (Dativ) = после; в = after
machen — gemacht = делать = do — did
er gibt — gegeben — gab = давать = give — gave
um (Akkusativ) = вокруг; ради; в (о времени) = around
gut — besser — am besten = хороший = good
wenn = если = if
bei (Dativ) = у; при = at
ist gegangen — ging = ходил = go — went
gehen um (Akkusativ) = (речь) идёт про = be about
ist gekommen — kam = пришел; приехал = come — came
als = как; чем; когда = as
über = о; над; через = about
der Text — Texte = текст = text
noch = ещё = still
dann = тогда; затем = then
der Mensch — Menschen = человек = person
das Wort — Wörter = слово = word
falsch = неправильно = wrong
der Herr — Herren = господин = gentleman
viel — mehr — am meisten = много = much
der Moderator — Moderatoren = модератор = moderator
immer = всегда = always
vor (Dativ) = перед; до = before
die Präposition — Präpositionen = предлог = preposition
schon = уже = already
sehr = очень = very
das Kind — Kinder = ребёнок = child
der Schuh — Schuhe = туфля; обувь = shoe
neu = новый = new
der Teil — Teile = часть = part
stehen — steht — gestanden — stand = стоять = stand — stood
sehen — sieht — gesehen — sah = видеть = see — saw
heute = сегодня = today
ergänzen — ergänzt = дополнять = supplement
wollen — will — wollte = хотеть = want
groß — größer — am größten = большой = big
da = там; здесь; так как = there
das Jahr — Jahre = год = year
die Leute = люди = people
sollen — soll — sollte = должен; следует = should
die Frau — Frauen = женщина = woman
doch = всё же; однако = however
mir = мне = me
ander = другой = other
welche = какой; который = which
ihnen = им; Вам = them
sprechen — spricht — gesprochen — sprach = говорить = speak
sprechen mit (Dativ) über (Akkusativ) = говорить с (кем?) про (кого? что?) = speak with about
sprechen von (Dativ) = упоминать о = speak of
sprechen für (Akkusativ) = говорить в пользу = speak for
sagen — gesagt = сказать; говорить = say
finden — findet — gefunden — fand = находить = find — found
das Leben — Leben = жизнь = life
etwas = что-то = something
das Haus — Häuser = дом = house
benutzen — benutzt = использовать = use
bis (Akkusativ) = до = until
ganz = весь; совсем = whole
wissen — weiß — gewusst — wusste = знать = know — knew
hören — gehört = слышать; слушать = hear
jetzt = сейчас = now
möchten — möchte — möchte = хотел бы = would like
passend = подходящий = suitable
schreiben — schreibt — geschrieben — schrieb = писать = write
schreibt an (Akkusativ) über (Akkusativ) = писать на (кого?) про (кого? что?) = write to about
das Kreuz — Kreuze = крест = cross
denn = ведь; потому что = for
die Lösung — Lösungen = решение = solution
der Tag — Tage = день = day
unser = наш = our
viel; viele = много; многие = many
wieder = снова = again
die Frage nach (Dativ) — Fragen = вопрос о = question about
der Satz — Sätze = предложение = sentence
folgend = следующий = following
der Artikel — Artikel = статья; артикль = article
Deutschland = Германия = Germany
die Person — Personen = человек; личность = person
also = итак; следовательно = therefore
helfen — hilft — geholfen — half = помогать = help
helfen bei (Dativ) = помогать в = help with
hier = здесь = here
leben — gelebt = жить = live
lernen — gelernt = учиться = learn
wichtig = важный = important
die Aufgabe — Aufgaben = задание = task
das Auto — Autos = автомобиль = car
der Freund — Freunde = друг = friend
die Grammatik — Grammatiken = грамматика = grammar
alle = все = all
denken — denkt — gedacht — dachte = думать = think
denken an (Akkusativ) = думать про = think of
durch (Akkusativ) = через; сквозь = through
gern = охотно = gladly
ob = ли; если = whether
das Beispiel — Beispiele = пример = example
fahren — fährt — ist gefahren — fuhr = ехать; водить = drive — drove
jeder = каждый = every
lesen — liest — gelesen — las = читать = read — read
mich = меня = me
der Film — Filme = фильм = film
der Hauptsatz — Hauptsätze = главное предложение = main clause
die Mail — Mails = письмо (электронное) = email
die Schule — Schulen = школа = school
die Zeit für (Akkusativ) — Zeiten = время для = time for
bekommen — bekommt — bekommen — bekam = получать = get — got
dazu = к этому = to that
einmal = один раз; однажды = once
früh = рано = early
verstehen — versteht — verstanden — verstand = понимать = understand — understood
warum = почему = why
wo = где = where
die Antwort auf (Akkusativ) — Antworten = ответ на = answer to
der Computer — Computer = компьютер = computer
das Verb — Verben = глагол = verb
weil = потому что = because
die Aussage — Aussagen = утверждение = statement
das Partizip — Partizipien = причастие (делающий) = participle
ohne (Akkusativ) = без = without
wenig = мело = little
wer = кто = who
der Ausdruck — Ausdrücke = выражение = expression
die Information — Informationen = информация = information
die Stadt — Städte = город = city
arbeiten — gearbeitet = работать = work
heißen — heißt — geheißen — hieß = называться; звать = be called
kaufen — gekauft = покупать = buy
der Kasten — Kästen = ящик; коробка = box
ordnen — geordnet = упорядочивать = arrange
alt — älter — am ältesten = старый = old
bleiben — bleibt — ist geblieben — blieb = оставаться = stay
erste = первый = first
müssen — muss — musste = нужно (сделать) = must
suchen — gesucht = искать = search
sucht nach (Dativ) = искать (что?) = search for
treffen sich — trifft — getroffen — traf = встречаться = meet
uns = нас, нам = us
die Arbeit an (Dativ) — Arbeiten = работа над = work on
der Grund für (Akkusativ) — Gründe = причина для = reason for
das Land — Länder = страна = country
der Plural = множественное число = plural
das Thema — Themen = тема = topic
die Uhr — Uhren = часы = clock
der Wortschatz — Wortschätze = словарный запас = vocabulary
brauchen — gebraucht — brauchte = нуждаться = need
dafür = для этого = for that
dort = там = there
die Überschrift — Überschriften = заголовок = heading
bringen — bringt — gebracht — brachte = приносить = bring — brought
bringen zu (Dativ) = приносить (кому?) = bring to
die Familie — Familien = семья = family
das Geld = деньги = money
das Kino — Kinos = кино = cinema
der Nebensatz — Nebensätze = придаточное предложение = subordinate clause
der Relativsatz — Relativsätze = относительное придаточное предложение = relative clause
beginnen — beginnt — begonnen — begann = начинать с = begin — began
beginnen mit (Dativ) = начинать с = begin with
einfach = просто; простой = simple
lange = долго = long
markieren — markiert = отмечать = mark
zusammen = вместе = together
die Form — Formen = форма = form
die Kirche — Kirchen = церковь = church
der Konjunktiv = сослагательное наклонение = subjunctive
der Passiv = пассивный залог = passive voice
die Prüfung — Prüfungen = экзамен; проверка = exam
ab (Dativ) = с; от = from
dein = твой = your
dürfen — darf — durfte = мочь; разрешать = may
freuen sich — freut — gefreut — freute = радоваться = rejoice
freuen sich über (Akkusativ) auf (Akkusativ) = радоваться о (прошлом, настоящем) в (будущем) = rejoice about, look forward to
kennen — kennt — gekannt — kannte = знать; быть знакомым = know — knew
oft — öfter — am öftesten = часто = often
häufig — häufiger — am häufigsten = часто = frequently
zufrieden mit (Dativ) = довольный (чем?) = satisfied with
die Eltern = родители = parents
der Euro — Euros = евро = euro
die Sprache — Sprachen = язык = language
das Tier — Tiere = животное = animal
deutsch = немецкий = German
dir = тебе = to you
fragen — fragt — gefragt — fragte = спрашивать = ask
fragen nach (Dativ) = спрашивать о (ком? чём?) = ask about
nehmen — nimmt — genommen — nahm = брать = take — took
nächste = следующий = next
passen — passt — gepasst — passte = подходит = fit
passen zu (Dativ) = подходит к = fit to
schnell — schneller — am schnellsten = быстрый = fast
zwischen (Dativ) = между = between
das Ende — Enden = конец = end
die Freundin — Freundinnen = подруга = female friend
die Hilfe für (Akkusativ) — Hilfen = помощь для = help for
der Partner — Partner = партнёр = partner
die Partnerin — Partnerinnen = партнёрша = female partner
der Singular = единственное число = singular
der Urlaub — Urlaube = отпуск = vacation
die Zahl — Zahlen = число = number
beide = оба = both
bilden — bildet — gebildet = образовывать = form
gegen; wider (Akkusativ) = против = against
gestern = вчера = yesterday
gleich = сразу; одинаковый = immediately; same
klein — kleiner — am kleinsten = маленький = small
liegen — liegt — gelegen — lag = лежать = lie — lay
mal = раз = time (instance)
nichts = ничего = nothing
schön — schöner — am schönsten = красивый = beautiful
weit — weiter — am weitesten = далеко; широкий = far
die Beziehung — Beziehungen = отношение = relationship
das Buch — Bücher = книга = book
der Kaffee — Kaffees = кофе = coffee
München = Мюнхен = Munich
der Name — Namen = имя = name
die Woche — Wochen = неделя = week
bekannt für (Akkusativ) = известный (чем?) = known for
darauf = на это = on it
erhalten — erhält — erhalten — erhielt = получать = receive — received
essen — isst — gegessen — aß = есть; кушать = eat — ate
geradeaus = прямо = straight ahead
gerade = только что = just
möglich = возможный = possible
schlecht — schlechter — am schlechtesten = плохой = bad
spät = поздно = late
statt (Dativ) = вместо = instead of
die Angst vor (Dativ) — Ängste = страх перед = fear of
das Internet = интернет = internet
das Kapitel — Kapitel = глава = chapter
das Subjekt — Subjekte = подлежащее = subject
die Vorstellung von (Dativ) — Vorstellungen = представление, воображение о = idea of
die Zeitung — Zeitungen = газета = newspaper
allerdings = однако = however
bitte = пожалуйста = please
damit = этим; чтобы = with it; so that
halten — hält — gehalten — hielt = держать = hold — held
ihm = ему = to him
mögen — mag — mochte = любить; нравиться = like — liked
setzen — setzt — gesetzt = ставить; садиться = put
wählen — wählt — gewählt = выбирать = choose
das Hörverstehen = аудирование = listening comprehension
der Ort — Orte = место = place
das Wetter — Wetter = погода = weather
die Zukunft = будущее = future
bauen — baut — gebaut = строить = build
bieten — bietet — geboten — bot = предлагать = offer — offered
deshalb = поэтому = therefore
eigen = собственный = own
erzählen — erzählt — erzählt = рассказывать = tell
erzählen von (Dativ) = рассказывать о = tell about
jemand = кто-то = somebody
nennen — nennt — genannt — nannte = называть = call — called
passieren — passiert — ist passiert = происходить = happen
schwer — schwerer — am schwersten = тяжёлый; сложный = heavy; difficult
selbst = сам = self
stellen — stellt — gestellt = ставить = put
vielleicht = возможно; может быть = maybe
wegen (Genitiv) = из-за = because of
während (Genitiv) = во время = during
zuerst = сначала = first
das Adjektiv — Adjektive = прилагательное = adjective
das Bild — Bilder = картина; образ = picture
die Endung — Endungen = окончание = ending
die Firma — Firmen = фирма = company
das Hotel — Hotels = отель = hotel
mündlich — mündlicher — mündlichsten = устный = oral
die Nachricht von (Dativ) — Nachrichten = сообщение, новость о = message about
Präteritum = прошедшее время = simple past tense
die Reihenfolge — Reihenfolgen = последовательность = sequence
bedeuten — bedeutet — bedeutet = означать = mean
eben = только что; ровно = just
entscheiden — entscheidet — entschieden — entschied = решать = decide
genau = точно = exactly
handeln — handelt — gehandelt = действовать (поступать), торговать = act
es handelt sich um (Akkusativ) = говорится про (кого? что?) = it is about
handeln von (Dativ) = говорит про = speak about
ihn = его = him
manchmal = иногда = sometimes
sondern = а (в противопоставлении) = but
spielen — spielt — gespielt = играть = play
steigen — steigt — ist gestiegen — stieg = подниматься = rise — rose
der Berg — Berge = гора = mountain
die Deklination — Deklinationen = склонение = declension
die Lese = чтение = reading
die Meinung — Meinungen = мнение = opinion
das Recht — Rechte = право = right
der Satzbau — Satzbaus = построение предложения = sentence structure
die Situation — Situationen = ситуация = situation
die Tür — Türen = дверь = door
der Vater — Väter = отец = father
die Welt — Welten = мир = world
bald = скоро = soon
bestehen — besteht — bestanden — bestand = выдерживать = pass
bestehen auf (Dativ) = настаивать на = insist on
es besteht aus (Dativ) = это состоит из = consist of
fliegen — fliegt — ist geflogen — flog = летать = fly — flew
gesund = здоровый = healthy
lachen — lacht — gelacht — lachte = смеяться = laugh
meinen — meint — gemeint = иметь в виду = mean
sitzen — sitzt — gesessen — saß = сидеть = sit — sat
studieren — studiert — studiert = учиться (в вузе) = study
trinken — trinkt — getrunken — trank = пить = drink — drank
tun — tut — getan — tat = делать = do — did
verdienen — verdient — verdient = зарабатывать = earn
vergessen — vergisst — vergessen — vergaß = забывать = forget — forgot
warten — wartet — gewartet — wartete = ждать = wait
warten auf (Akkusativ) = ждать (кого? что?) = wait for
wohl = вероятно; хорошо = probably
überhaupt = вообще = at all
überzeugen — überzeugt — überzeugt = убеждать = convince
überzeugen von (Dativ) = убеждать в = convince of
der Anfang — Anfänge = начало = beginning
die Beschwerde über (Akkusativ) — Beschwerden = жалоба про = complaint about
die Ernährung — Ernährungen = питание = nutrition
die Geschichte — Geschichten = история = history
das Interesse an (Dativ) — Interessen = интерес к = interest in
die Lücke — Lücken = пробел = gap
die Million — Millionen = миллион = million
der Nachbar — Nachbarn = сосед = neighbour
die Party — Partys = вечеринка = party
der Roman — Romane = роман = novel
der Track — Tracks = трек = track
der Vortrag — Vorträge = доклад = lecture
die Wahl — Wahlen = выбор = choice
bestimmt = определённый = certain
besuchen — besucht — besucht = посещать = visit
daran = об этом = about it
darüber = об этом; над этим = about it; above it
dich = тебя = you
endlich = наконец = finally
fest = твёрдый; постоянный = firm
gehören — gehört — gehört = принадлежать = belong
gemeinsam = вместе = together
glauben — glaubt — geglaubt — glaubte = верить в = believe
glauben an (Akkusativ) = верить в = believe in
lang — länger — am längsten = длинный; долгий = long
lassen — lässt — gelassen — ließ = оставлять; позволять = let — let
letzte = последний = last
mehrere = несколько = several
seit (Dativ) = с (о времени) = since
tragen — trägt — getragen — trug = носить = carry — carried
vorstellen — stellt vor — vorgestellt — stellte vor = представлять = introduce
wahrscheinlich = вероятно = probably
zurück = обратно = back
die Angabe — Angaben = указание = indication
das Angebot — Angebote = предложение = offer
der August = август = August
das Bio = био (органический) = organic
der Chef — Chefs = начальник = boss
die Entscheidung — Entscheidungen = решение = decision
der Erfolg — Erfolge = успех = success
die Ergänzung — Ergänzungen = дополнение = addition
der Fall — Fälle = случай = case
das Gefühl — Gefühle = чувство = feeling
der Hund — Hunde = собака = dog
die Idee — Ideen = идея = idea
der Kunde — Kunden = клиент = customer
Plusquamperfekt = предпрошедшее время = past perfect tense
die Position — Positionen = позиция = position
das Produkt — Produkte = продукт = product
die Pronominaladverbien (da-, wo-) = местоименные наречия = pronominal adverbs
das Relativpronomen — Relativpronomen (der, die, das) = относительное местоимение (который, которая, которые) = relative pronoun
der Sport — Sportarten = спорт = sport
am (Dativ) = в; на = at
besonders = особенно = especially
bloß = только; лишь = merely
daher = поэтому = therefore
davon = об этом; от этого = of it; from it
erleben — erlebt — erlebt = переживать; испытывать = experience
frei von (Dativ) = свободный от = free from
gelten — gilt — gegolten — galt = действовать; считаться = apply
hoch — höher — am höchsten = высокий = high
laut — lauter — lautesten = громкий = loud
schließen — schließt — geschlossen — schloss = закрывать = close
unter = под = under
wirklich = действительно = really
ändern — ändert — geändert = менять = change
der Abend — Abende = вечер = evening
die Anzeige — Anzeigen = объявление = advertisement
die Erfahrung — Erfahrungen = опыт = experience
die Erwartung — Erwartungen = ожидание = expectation
das Essen — Essen = еда = food
der Gedanke an (Akkusativ) — Gedanken = мысль о = thought of
der Infinitiv — Infinitive = инфинитив = infinitive
der Kurs — Kurse = курс = course
die Liebe zu (Dativ) — Lieben = любовь к = love for
die Maßschuhe = обувь на заказ = bespoke shoes
das Modalverb — Modalverben = модальный глагол = modal verb
das Paar — Paare = пара = pair
das Problem — Probleme = проблема = problem
das Pronomen — Pronomen = местоимение = pronoun
das Präsens = настоящее время = present tense
der Prüfungsteil — Prüfungsteile = часть экзамена = exam part
die Rede — Reden = речь = speech
die Regel — Regeln = правило = rule
die Schlüsselwörter = ключевые слова = key words
die Seite — Seiten = страница; сторона = page; side
der Slum — Slums = трущобы = slum
der Spaß = веселье = fun
das Theater — Theater = театр = theater
die Vergangenheit — Vergangenheiten = прошлое = past
außer (Dativ) = кроме = except
eigentlich = вообще-то; на самом деле = actually
einige = некоторый = some
entwickeln — entwickelt — entwickelt = развивать = develop
erkennen — erkennt — erkannt — erkannte = узнавать; распознавать = recognize
erst = только; сначала = only; first
funktionieren — funktioniert — funktioniert = работать (о механизмах) = function
glücklich = счастливый = happy
infolge (Genitiv) = вследствие = due to
jung — jünger — am jüngsten = молодой = young
manche = некоторый = some
der Meister — Meister = мастер = master
natürlich = естественно = naturally
nie = никогда = never
obwohl = хотя = although
ordnen — ordnet — geordnet = упорядочивать = arrange
sicher = уверенный; безопасный = sure; safe
trotz (Genitiv) = несмотря на = despite
verbringen — verbringt — verbracht — verbrachte = проводить (время) = spend
wohnen — wohnt — gewohnt = жить (проживать) = live
zahlen — zahlt — gezahlt = платить = pay
zeigen — zeigt — gezeigt = показывать = show
der Absatz — Absätze = абзац; каблук = paragraph; heel
die Ausbildung — Ausbildungen = образование; обучение = education; training
Europa = Европа = Europe
der Gast — Gäste = гость = guest
die Homepage — Homepages = домашняя страница = homepage
die Katze — Katzen = кошка = cat
der Kauf — Käufe = покупка = purchase
die Kleidung — Kleidungen = одежда = clothing
der Konnektor — Konnektoren = соединитель = connector
Latein = латынь = Latin
der Lehrer — Lehrer = учитель = teacher
das Leseverstehen = понимание прочитанного = reading comprehension
die Minute — Minuten = минута = minute
der Monat — Monate = месяц = month
das Musical — Musicals = мюзикл = musical
die Musik = музыка = music
die Nummer — Nummern = номер = number
die Sache — Sachen = вещь; дело = thing; matter
die Schweiz = Швейцария = Switzerland
der Schüler — Schüler = ученик = pupil; student
der Sprecher — Sprecher = оратор; диктор = speaker
die Stelle — Stellen = место; должность = place; position
die Straße — Straßen = улица = street
die Stunde — Stunden = час = hour
Stuttgart = Штутгарт = Stuttgart
der Termin — Termine = срок; встреча = appointment; deadline
der Tipp — Tipps = совет = tip; advice
die Transkription — Transkriptionen = транскрипция = transcription
der Unfall — Unfälle = авария = accident
das Ziel — Ziele = цель = goal
anbieten — bietet an — angeboten — bot an = предлагать = offer — offered
ausdrücken — drückt aus — ausgedrückt — drückte aus = выражать = express
bitten um (Akkusativ) — bittet — gebeten — bat = просить о = ask for
dabei = при этом = thereby
dankbar für (Akkusativ) = благодарный за = grateful for
dauern — dauert — gedauert = длиться; продолжаться = last
eingehen — geht ein — ist eingegangen — ging ein = входить, поступать (о сообщении, предложении) = enter; arrive
eingehen auf (Akkusativ) — er geht auf (Akkusativ) ein = вдаваться в, принять во внимание, согласится на = go into; agree to
einverstanden mit (Dativ) = согласный с = agree with
erinnern (sich) — erinnert — erinnert = напоминать (вспомнить) = remind; remember
erinnern (sich) an (Akkusativ) = напоминать (вспомнить) про (кого? что?) = remind of
fallen — fällt — ist gefallen — fiel = падать = fall — fell
fühlen sich — fühlt — gefühlt — fühlte = чувствовать = feel
gegenüber (Dativ) = напротив; по отношению к = opposite; towards
gewinnen — gewinnt — gewonnen — gewann = выигрывать = win — won
hin = туда = there
interessiert an (Dativ) = заинтересованный в = interested in
jeweils = каждый раз; соответственно = each time; respectively
kaum = едва; почти не = hardly
kurz — kürzer — am kürzesten = короткий = short
lieben — liebt — geliebt = любить = love
lösen — löst — gelöst = решать; развязывать = solve
müde von (Dativ) = уставший от = tired of
neutral = нейтральный = neutral
niemand = никто = nobody
reparieren — repariert — repariert = ремонтировать = repair
schicken — schickt — geschickt = отправлять = send
sowie = а также = as well as
stimmen — stimmt — gestimmt = соответствовать; голосовать = be correct; vote
teils = частично = partly
verlassen — verlässt — verlassen — verließ = покидать; оставлять = leave — left
verlieren — verliert — verloren — verlor = терять; проигрывать = lose — lost
verschieden = различный = different
voll — voller — am vollsten = полный = full
ziehen — zieht — gezogen — zog = тянуть; переезжать = pull; move
die Übung — Übungen = упражнение = exercise
die Adjektivendung — Adjektivendungen = окончание прилагательного = adjective ending
das Alter — Alter = возраст = age
das Argument — Argumente = аргумент = argument
die Bedeutung — Bedeutungen = значение = meaning
Berlin = Берлин = Berlin
der Beruf — Berufe = профессия = profession
die Bildung — Bildungen = образование; формирование = education; formation
das Cafe — Cafes = кафе = cafe
das Einkaufszentrum — Einkaufszentren = торговый центр = shopping center
das Fahrrad — Fahrräder = велосипед = bicycle
der Fehler — Fehler = ошибка = mistake
das Fenster — Fenster = окно = window
das Fernsehen = телевидение = television
der Fernseher — Fernseher = телевизор = TV set
das Fest — Feste = праздник = festival
das Geschenk — Geschenke = подарок = gift
die Gesellschaft — Gesellschaften = общество; компания = society; company
der Haarausfall = выпадение волос = hair loss
der Haushalt — Haushalte = хозяйство; бюджет = household; budget
der Hinweis — Hinweise = указание; подсказка = hint; indication
die Karte — Karten = карта; билет = map; ticket
das Komma — Kommata = запятая = comma
die Kosten = расходы = costs
das Krankenhaus — Krankenhäuser = больница = hospital
das Modell — Modelle = модель = model
die Möglichkeit — Möglichkeiten = возможность = possibility
der Müll = мусор = garbage
die Polizei — Polizeien = полиция = police
die Post — Posten = почта = post office
der Preis — Preise = цена; приз = price; prize
der Rat — Räte = совет = advice
der Satzteil — Satzteile = часть предложения = part of a sentence
der Schuhmacher — Schuhmacher = сапожник = shoemaker
der Service — Services = сервис; обслуживание = service
der Single — Singles = одиночка; сингл = single
das Stück — Stücke = кусок; штука = piece
das Telefon — Telefone = телефон = telephone
die Veranstaltung — Veranstaltungen = мероприятие = event
der Verkehr = движение; транспорт = traffic; transport
der Vorteil — Vorteile = преимущество = advantage
die Werkstatt — Werkstätten = мастерская = workshop
die Wohnung — Wohnungen = квартира = apartment
das Wörterbuch — Wörterbücher = словарь = dictionary
der Zweifel — Zweifel = сомнение = doubt
abholen — holt ab — abgeholt — holte ab = забирать = pick up
dagegen = против этого = against it
darin = в этом; внутри = in it
entspannen — entspannt — entspannt = расслабляться = relax
entstehen — entsteht — ist entstanden — entstand = возникать = arise
etwa = примерно = approximately
folgen — folgt — ist gefolgt = следовать = follow
formell = формальный = formal
froh über; auf (Akkusativ) = радостный по поводу = glad about
fällen — fällt — gefällt = валить (дерево) = fell (tree)
führen — führt — geführt = вести; руководить = lead
gar = вовсе; даже = at all
gering — geringer — am geringsten = небольшой; низкий = low
grau = серый = gray
hängen — hängt — gehangen — hing = висеть = hang — hung
kochen — kocht — gekocht = готовить (еду) = cook
konzentrieren sich — konzentriert — konzentriert = сосредотачиваться = concentrate
konzentrieren sich auf (Akkusativ) = сосредотачиваться на = concentrate on
laufen — läuft — ist gelaufen — lief = бегать; идти (о ТВ) = run — ran
leider = к сожалению = unfortunately
lieb — lieber — am liebsten = лучше; дорогой = dear; better
maskulin = мужской = masculine
nachdem = после того как = after
nachdenken — denkt nach — nachgedacht — dachte nach = размышлять = think over
nachdenken über (Akkusativ) = размышлять о = think about
nämlich = а именно = namely
plötzlich = внезапно = suddenly
schließlich = в конце концов = finally
der Sprachbaustein — Sprachbausteine = языковой элемент = language element
ständig = постоянно = constantly
tatsächlich = действительно = actually
toll = классный; большой = great
verwenden — verwendet — verwendet = использовать = use
wann = когда = when
weder … noch … = ни то …, ни это … = neither … nor …
wohin = куда = where to
zwar = хотя; правда = indeed; although
ärgern sich — ärgert — geärgert — ärgerte = сердиться = get angry
ärgern sich über (Akkusativ) = сердиться из-за = be angry about
übrigens = кстати = by the way
das Adverb — Adverbien = наречие (прилагательное у глагола) = adverb
der Arbeitnehmer — Arbeitnehmer = работник = employee
der Arm — Arme = рука = arm
der Arzt — Ärzte = врач = doctor
der Aspekt — Aspekte = аспект = aspect
die Autobahn — Autobahnen = автобан = highway
der Bauer — Bauern = крестьянин; фермер = farmer
der Begriff — Begriffe = понятие, термин = term; concept
die Behinderung — Behinderungen = инвалидность; препятствие = disability; obstacle
der Bekannte — Bekannten = знакомый = acquaintance
der Besuch — Besuche = визит = visit
das Büro — Büros = офис = office
die Dame — Damen = дама; женщина = lady
der Dank für (Akkusativ) — Danke = благодарность за = thanks for
der Deutschkurs — Deutschkurse = курс немецкого языка = German course
der Dialekt — Dialekte = диалект = dialect
das Ding — Dinge = вещь = thing
das Eis — Eise = лёд; мороженое = ice; ice cream
die Freude an (Dativ) — Freuden = радость от = joy of
die Freude über (Akkusativ) auf (Akkusativ) — Freuden = радость в (прошлом, сейчас) в (будущем) = joy about, looking forward to
der Geburtstag — Geburtstage = день рождения = birthday
die Gegenwart = настоящее (время) = present
das Gerät — Geräte = устройство = device
das Gespräch — Gespräche = разговор = conversation
die Grafik — Grafiken = графика = graphic
die Hausaufgabe — Hausaufgaben = домашнее задание = homework
indirekt = косвенный = indirect
die Kartoffel — Kartoffeln = картофель = potato
der Kollege — Kollegen = коллега = colleague
der Kontext — Kontexte = контекст = context
der Kopfschmerz — Kopfschmerzen = головная боль = headache
die Kritik — Kritiken = критика = criticism
der Liebesfilm — Liebesfilme = мелодрама = romance film
die Meldung — Meldungen = сообщение = message
der Montag — Montage = понедельник = Monday
der Morgen — Morgen = утро = morning
das Paket — Pakete = посылка = package
der Patient — Patienten = пациент = patient
das Programm — Programme = программа = program
die Reise — Reisen = путешествие = journey; trip
der Rhein = Рейн (река) = Rhine (river)
die Schlange — Schlangen = змея; очередь = snake; queue
die Schokolade — Schokoladen = шоколад = chocolate
der Stau — Staus = пробка (дорожная) = traffic jam
die Tabelle — Tabellen = таблица = table
der Test — Tests = тест = test
die Textstelle — Textstellen = место в тексте = text passage
der Tisch — Tische = стол = table
die Tochter — Töchter = дочь = daughter
die Umfrage — Umfragen = опрос = survey
der Umlaut — Umlaute = умляут = umlaut
das Unternehmen — Unternehmen = предприятие = enterprise; company
die Verbindung — Verbindungen = связь = connection
der Verlust — Verluste = потеря = loss
das Warenhaus — Warenhäuser = универмаг = department store
die Warnung vor (Dativ) — Warnungen = предупреждение о = warning about
der Wunsch — Wünsche = желание = wish
der Zug — Züge = поезд = train
allein = один; одиноко = alone
außerdem = кроме того = besides
begeistern — begeistert — begeistert = восхищать = inspire
beherrschen — beherrscht — beherrscht = владеть = master
berichten — berichtet — berichtet = сообщать, упоминать = report
berichten über (Akkusativ) = сообщать о = report about
berichten von (Dativ) = упоминать о = report of
berücksichtigen — berücksichtigt — berücksichtigt = учитывать = consider
bevor = перед тем как = before
bezahlen — bezahlt — bezahlt = платить = pay
christlich = христианский = Christian
danken — dankt — gedankt = благодарить = thank
davor = до этого = before that
deutlich = ясно; отчётливо = clear
dritte = третий = third
drücken — drückt — gedrückt = нажимать; прижимать = press
durchführen — führt durch — durchgeführt = проводить = carry out
eher = скорее; раньше = rather
erfahren — erfährt — erfahren — erfuhr = узнавать; испытывать = learn; experience
ergeben — ergibt — ergeben — ergab = давать (результат) = result in
erklären — erklärt — erklärt = объяснять = explain
erwarten — erwartet — erwartet = ожидать = expect
fertig mit (Dativ) = закончить (готово) что-то = finished with
freundlich = дружелюбный = friendly
geehrt = уважаемый = honored
halb = половина = half
interessieren sich — interessiert — interessiert = интересоваться = be interested
interessieren sich für (Akkusativ) = интересоваться про (кого? что?) = be interested in
kaputt = сломанный = broken
kosten — kostet — gekostet = стоить = cost
kulturell = культурный = cultural
leiden — leidet — gelitten — litt = страдать от = suffer
leiden an (Dativ) = страдать от = suffer from
leiden unter (Dativ) = страдать под (влиянием) = suffer under
meistens = чаще всего = mostly
morgens = по утрам = in the mornings
paar = пара = couple
planen — plant — geplant = планировать = plan
reden — redet — geredet = говорить = talk
reich an (Dativ) — reicher — am reichsten = богатый (чем?) = rich in
reisen — reist — gereist = путешествовать = travel
rot = красный = red
scheinen — scheint — geschienen — schien = казаться; светить = seem; shine
schenken — schenkt — geschenkt = дарить = give (as gift)
schlafen — schläft — geschlafen — schlief = спать = sleep — slept
singen — singt — gesungen — sang = петь = sing — sang
spazieren — spaziert — spaziert = гулять = walk
stark — stärker — am stärksten = сильный = strong
stolz auf (Akkusativ) = гордый чем-то = proud of
teuer — teurer — am teuersten = дорогой = expensive
typisch = типичный = typical
unbedingt = обязательно = absolutely
unterrichten — unterrichtet — unterrichtet = преподавать, сообщать = teach
unterrichten in (Dativ) = преподавать (что?) = teach in
unterrichten von (Dativ) = сообщать о = inform about
unterstrichen = подчёркнутый = underlined
versprechen — verspricht — versprochen — versprach = обещать = promise
vorbei = мимо; законченный = past; over
warm — wärmer — am wärmsten = тёплый = warm
weiß = белый = white
wen = кого = whom
wünschen — wünscht — gewünscht = желать = wish
übrig = оставшийся = remaining
das Aktiv — Aktive = активный залог = active voice
das Amt — Ämter = ведомство; должность = office; position
die App — Apps = приложение = app
der Arbeitgeber — Arbeitgeber = работодатель = employer
der Architekt — Architekten = архитектор = architect
die Armut = бедность = poverty
die Art — Arten = вид; тип = type; kind
die Auffassung — Auffassungen = мнение; понимание = opinion; understanding
die Auskunft — Auskünfte = справка; информация = information; inquiry
das Ausland — Ausländer = заграница = foreign country
das Baby — Babys = младенец = baby
der Ball — Bälle = мяч = ball
die Bank — Bänke = банк; скамейка = bank; bench
der Beginn — Beginne = начало = beginning
die Beispielprüfung — Beispielprüfungen = примерный экзамен = practice exam
der Besucher — Besucher = посетитель = visitor
die Bevölkerung — Bevölkerungen = население = population
der Brief — Briefe = письмо = letter
die Chemie — Chemien = химия = chemistry
der Club — Clubs = клуб = club
die Diät — Diäten = диета = diet
der Einsteiger — Einsteiger = новичок = beginner
der Elefant — Elefanten = слон = elephant
das Ergebnis — Ergebnisse = результат = result
das Erlebnis — Erlebnisse = переживание = experience
die Erziehung — Erziehungen = воспитание = education; upbringing
das Fahrzeug — Fahrzeuge = транспортное средство = vehicle
das Fleisch — Fleischer = мясо = meat
die Folge — Folgen = следствие; эпизод = consequence; episode
die Freizeit — Freizeiten = свободное время = free time
die Fußprobleme = проблемы с ногами = foot problems
das Gemüse — Gemüse = овощи = vegetables
der Geschmack nach (Dativ) — Geschmäcker = вкус (чего?) = taste of
die Gitarre — Gitarren = гитара = guitar
das Glück = счастье = luck; happiness
griechisch = греческий язык = Greek
das Gymnasium — Gymnasien = гимназия = grammar school
die Hand — Hände = рука = hand
die Handlung — Handlungen = действие; сюжет = action; plot
das Handy — Handys = мобильный телефон = cell phone
das Heimatland — Heimatländer = родина = homeland
die Heirat — Heiraten = свадьба; женитьба = marriage
das Herz — Herzen = сердце = heart
die Hose — Hosen = брюки = trousers
die Impfung — Impfungen = прививка = vaccination
Indien = Индия = India
die Insel — Inseln = остров = island
die Intuition — Intuitionen = интуиция = intuition
Italien = Италия = Italy
die Jahreszeit — Jahreszeiten = время года = season
das Jahrhundert — Jahrhunderte = век = century
das Kasussymbol — Kasussymbole = символ падежа = case marker
die Konjunktur — Konjunkturen = конъюнктура (условия, влияющие на ситуацию) = economic situation
das Konzert — Konzerte = концерт = concert
der Kopf — Köpfe = голова = head
das Korrelat — Korrelate = соответствие (что-то, что относится к чему-то другому) = correlate
die Krankheit — Krankheiten = болезнь = illness
Köln = Кёльн = Cologne
das Können = умение = ability
der Liebeskummer = любовная тоска = lovesickness
die Luft — Lüfte = воздух = air
die Lust auf (Akkusativ) — Lüste = желание (чего?) = desire for
der Mai = май = May
die Maschine — Maschinen = машина = machine
der Meter — Meter = метр = meter
der Mitarbeiter — Mitarbeiter = сотрудник = employee
die Mutter — Mütter = мать = mother
die Nacht — Nächte = ночь = night
das Nomen — Nomen = существительное = noun
die Not — Nöte = нужда = need; distress
die Note — Noten = оценка; нота = grade; note
die Notiz — Notizen = заметка = note
der Nullartikel — Nullartikel = нулевой артикль = zero article
die Ortsangabe — Ortsangaben = указание места = place indication
das Parlament — Parlamente = парламент = parliament
die Pause — Pausen = пауза = break
der Plan — Pläne = план = plan
der Platz — Plätze = место = place
der Punkt — Punkte = точка = point
die Redemittel = средства выражения = speaking aids
die Regenbogenpresse = жёлтая пресса = tabloid press
die Richtung — Richtungen = направление = direction
der Schweizer — Schweizer = швейцарец = Swiss person
die Schwester — Schwestern = сестра = sister
der See — Seen = озеро = lake
die Sehenswürdigkeit — Sehenswürdigkeiten = достопримечательность = tourist attraction
das Sein = бытие = being
der Sommer — Sommer = лето = summer
der Sonntag — Sonntage = воскресенье = Sunday
das Spiel — Spiele = игра = game
der Stadtpark — Stadtparks = городской парк = city park
die Stimme — Stimmen = голос = voice
die Suche nach (Dativ) — Suchen = поиск (чего?) = search for
die Tastatur — Tastaturen = клавиатура = keyboard
die Tollwut = бешенство = rabies
der Unsinn = чепуха = nonsense
der Unterricht — Unterrichte = урок; преподавание = lesson; teaching
die Vermutung — Vermutungen = предположение = assumption
das Verständnis für (Akkusativ) — Verständnisse = понимание (чего?) = understanding of
das Wasser = вода = water
der Winter — Winter = зима = winter
die Wirtschaft — Wirtschaften = экономика = economy
der Zustand — Zustände = состояние = condition
abhalten — hält ab — abgehalten — hielt ab = проводить; удерживать = hold
ach; achso = ах; ах так = oh; oh I see
anfangen — fängt an — angefangen — fing an = начинать = begin — began
anfangen mit (Dativ) = начинать с = begin with
angenehm für (Akkusativ) = приятный для = pleasant for
ankommen — kommt an — ist angekommen — kam an = прибывать = arrive
ankommen auf (Akkusativ) = зависеть от (кого? что?) = depend on
anlässlich (Genitiv) = по случаю = on the occasion of
anrufen — ruft an — angerufen — rief an = звонить = call
anrufen bei (Dativ) = звонить (кому?) = call (someone)
ansehen — sieht an — angesehen — sah an = рассматривать = look at
antworten — antwortet — geantwortet = отвечать = answer
antworten auf (Akkusativ) mit (Dativ) = отвечать на (что?) с помощью (чего?) = answer with
aufgrund (Genitiv) = на основании = based on
ausbilden — bildet aus — ausgebildet — bildete aus = обучать = train
aussehen — sieht aus — ausgesehen — sah aus = выглядеть = look
bedanken — bedankt — bedankt — bedankte = благодарить = thank
bedanken sich bei (Dativ) für (Akkusativ) = благодарить у (кого?) за (что?) = thank (someone) for
beenden — beendet — beendet = заканчивать = finish
bereit zu (Dativ) = готовый к = ready for
beschweren sich — beschwert — beschwert = жаловаться = complain
beschweren sich bei (Dativ) über (Akkusativ) = жаловаться (кому?) про (кого? что?) = complain to about
bestätigen — bestätigt — bestätigt = подтверждать = confirm
beteiligen — beteiligt — beteiligt = участвовать = participate
bewegen (sich) — bewegt — bewegt = двигать (двигаться) = move
bewusst = сознательный = conscious
bezüglich (Genitiv) = относительно = regarding
danach = после этого = after that
je mehr, desto (umso) besser = чем больше, тем лучше = the more, the better
deswegen = поэтому = therefore
direkt = прямо; непосредственно = direct
drehen — dreht — gedreht = вращать = turn
enthalten — enthält — enthalten — enthielt = содержать = contain
entlang (Genitiv) = вдоль = along
enttäuschen — enttäuscht — enttäuscht = разочаровывать = disappoint
erledigen — erledigt — erledigt = выполнять; завершать = complete
erreichen — erreicht — erreicht = достигать = reach
erzielen — erzielt — erzielt = достигать; получать = achieve
europäisch = европейский = European
fehlend = отсутствующий = missing
feiern — feiert — gefeiert = праздновать = celebrate
fordern — fordert — gefordert = требовать = demand
französisch = французский = French
frisch — frischer — am frischesten = свежий = fresh
fähig zu (Dativ) = способный к = capable of
gültig = действительный = valid
günstig — günstiger — am günstigsten = выгодный; дешёвый = favorable; cheap
halt = ну; ведь = well
heiraten — heiratet — geheiratet = жениться; выходить замуж = marry
insgesamt = всего, вообще = altogether
international = международный = international
jugendliche = юношеский (подростковый) = youth; adolescent
klingeln — klingelt — geklingelt = звонить (о звонке) = ring
kostenlos = бесплатный = free of charge
kümmern sich — kümmert — gekümmert = заботиться о = take care of
kümmern sich um (Akkusativ) = заботиться о = look after
langweilen — langweilt — gelangweilt = скучать; надоедать = bore
leicht — leichter — am leichtesten = лёгкий = easy; light
lenken — lenkt — gelenkt = направлять; управлять = steer; control
los = прочь; началось = off; started
mindestens = по крайней мере = at least
mitteilen — teilt mit — mitgeteilt = сообщать = inform
neugierig auf (Akkusativ) = любопытный к = curious about
nun = теперь = now
pünktlich = пунктуальный = punctual
reagieren — reagiert — reagiert = реагировать на = react
reagieren auf (Akkusativ) = реагировать на = react to
renovieren — renoviert — renoviert = ремонтировать (обновлять) = renovate
sauer = кислый = sour
sauer auf (Akkusativ) = обида, досада от = angry at
schaffen — schafft — geschafft = справляться; создавать = manage; create
schmecken — es schmeckt — geschmeckt = иметь вкус = taste
schmecken nach (Dativ) = иметь вкус (чего?) = taste like
schreien — schreit — geschrien — schrie = кричать = shout
schriftlich = письменный = written
seitdem = с тех пор = since then
selten — seltener — am seltensten = редкий = rare
sowohl … als auch … = и …, и … = both … and …
nicht nur …, sondern auch … = не только …, но и … = not only … but also …
sperren — sperrt — gesperrt = запирать; блокировать = block
stattfinden — findet statt — stattgefunden — fand statt = происходить = take place
treten — tritt — getreten — trat = наступать; пинать = step; kick
träumen — träumt — geträumt = мечтать; видеть сон = dream
träumen von (Dativ) = мечтать о; видеть сон о = dream of
täglich = ежедневный = daily
unbekannt = неизвестный = unknown
verkaufen — verkauft — verkauft = продавать = sell
verlieben sich — verliebt — verliebt = влюбляться в = fall in love
verlieben sich in (Akkusativ) = влюбляться в = fall in love with
vermutlich = предположительно = probably
versuchen — versucht — versucht = пытаться = try
verweisen — verweist — verwiesen — verwies = ссылаться; указывать = refer
verzichten — verzichtet — verzichtet = отказываться = give up
verändern — verändert — verändert = изменить (существенно) = change
vorgegeben = заданный = predetermined
wofür = для чего = for what
wütend auf (Akkusativ) = (сильно) злой на = angry at
zustimmen — stimmt zu — zugestimmt = соглашаться = agree
die Überraschung — Überraschungen = сюрприз = surprise
das Übungsbuch — Übungsbücher = учебник с упражнениями = exercise book
ähnlich = похожий = similar
überlegen — überlegt — überlegt = обдумывать = consider
überreichen — reicht über — überreicht — reichte über = вручать = hand over
der Actionfilm — Actionfilme = боевик = action film
das Afrika = Африка = Africa
die Ampel — Ampeln = светофор = traffic light
der Arbeitstag — Arbeitstage = рабочий день = workday
die Aufforderung — Aufforderungen = требование; призыв = demand; request
der Ausflug — Ausflüge = экскурсия = excursion
der Autor — Autoren = автор = author
die Bahnhofstraße — Bahnhofstraßen = вокзальная улица = station street
der Baum — Bäume = дерево = tree
der Bayer — Bayer = баварец = Bavarian
der Belang — Belange = важность, значение = importance
der Bereich — Bereiche = область = area
der Berufsverkehr = час пик = rush hour
die Beschreibung — Beschreibungen = описание = description
der Betreff — Betreffe = тема (письма) = subject (letter)
der Bezug auf (Akkusativ) — Bezüge = отношение к, ссылка на, связь с = reference to
das Bioprodukt — Bioprodukte = биопродукт = organic product
die Bitte um (Akkusativ) — Bitten = просьба о = request for
der Blumenstrauß — Blumensträuße = букет цветов = bouquet of flowers
der Blödsinn = чушь = nonsense
der Bus — Busse = автобус = bus
der Cent — Cents = цент = cent
das Computerspiel — Computerspiele = компьютерная игра = computer game
die Datei — Dateien = файл = file
das Datum — Daten = дата = date
der Deckel — Deckel = крышка = lid
der Dialog — Dialoge = диалог = dialogue
die Diskussion — Diskussionen = дискуссия = discussion
der Druck — Drücke = давление; печать = pressure; printing
die Ehe — Ehen = брак = marriage
das Ei — Eier = яйцо = egg
die Einladung zu (Dativ) — Einladungen = приглашение на = invitation to
die Einzelheit — Einzelheiten = деталь = detail
englisch = английский = English
die Entspannung — Entspannungen = расслабление = relaxation
das Erbe — Erben = наследство = inheritance
die Erklärung — Erklärungen = объяснение = explanation
der Ernst = серьёзность = seriousness
der Experte — Experten = эксперт = expert
extra = дополнительно; экстра = extra
feminin = женский = feminine
das Ferienziel — Ferienziele = место отдыха = holiday destination
der Flohmarkt — Flohmärkte = блошиный рынок = flea market
die Forderung — Forderungen = требование = demand
das Foto — Fotos = фотография = photo
Frankfurt = Франкфурт = Frankfurt
das Freizeitverhalten — Freizeitverhalten = поведение в свободное время = leisure behavior
der Frieden — Frieden = мир = peace
der Frühling — Frühlinge = весна = spring
die Fähigkeit — Fähigkeiten = способность = ability
das Gas — Gase = газ = gas
die Gefahr — Gefahren = опасность = danger
das Gehalt — Gehälter = зарплата; содержание = salary; content
das Geräusch — Geräusche = шум = noise
das Geschirr — Geschirre = посуда = dishes
das Geschäft — Geschäfte = магазин; дело = shop; business
das Getränk — Getränke = напиток = drink
die Grundschule — Grundschulen = начальная школа = primary school
die Gruppe — Gruppen = группа = group
die Hauptaussage — Hauptaussagen = основное утверждение = main statement
die Hochzeit — Hochzeiten = свадьба = wedding
die Hotline — Hotlines = горячая линия = hotline
der Inhalt — Inhalte = содержание = content
die Institution — Institutionen = учреждение = institution
italienisch = итальянский = Italian
der Junge — Jungen = мальчик; юноша = boy; young man
der Juniorchef — Juniorchefs = младший руководитель = junior boss
der Kindergarten — Kindergärten = детский сад = kindergarten
das Kleid — Kleider = платье = dress
das Kleinkind — Kleinkinder = малыш = toddler
die Kleinstadt — Kleinstädte = небольшой город = small town
die Komposita = составные слова (слова из нескольких) = compound words
die Konjunktion — Konjunktionen = союз = conjunction
der Kontakt — Kontakte = контакт = contact
die Krise — Krisen = кризис = crisis
der Käse — Käse = сыр = cheese
der Körper — Körper = тело = body
der Künstler — Künstler = художник; артист = artist
der Laden — Läden = магазин = shop
die Laune — Launen = настроение = mood
die Leistung — Leistungen = достижение; мощность = achievement; performance
der Lernerfolg — Lernerfolge = успех в обучении = learning success
das Licht — Lichter = свет = light
das Lied — Lieder = песня = song
die Medizin — Medizinen = медицина = medicine
der Meinungsmacher — Meinungsmacher = формирующий мнение = opinion maker
das Milchprodukt — Milchprodukte = молочный продукт = dairy product
das Mitglied — Mitglieder = член = member
das Mittel — Mittel = средство = means
der Mittwoch — Mittwoche = среда = Wednesday
das Modalwort — Modalwörter = модальное слово = modal word
der Moment — Momente = момент = moment
das Motiv — Motive = мелодия; повод; сюжет; узор = motif; reason; plot; pattern
der Mut = смелость = courage
das Mädchen — Mädchen = девочка = girl
das Nachtleben — Nachtleben = ночная жизнь = nightlife
der Nobelpreis — Nobelpreise = Нобелевская премия = Nobel Prize
die Oma — Omas = бабушка = grandma
der Pfeffer — Pfeffer = перец = pepper
die Politik — Politiken = политика = politics
der Polizist — Polizisten = полицейский = policeman
polnisch = польский = Polish
der Postman — Postmen = почтальон = postman
das Prinzip — Prinzipien = принцип = principle
das Präsens — Präsen = настоящее время = present tense
die Präsentation — Präsentationen = презентация = presentation
der Prüfer — Prüfer = экзаменатор = examiner
der Prüfungspartner — Prüfungspartner = партнёр по экзамену = exam partner
die Prüfungsteile = части экзамена = exam parts
das Radio — Radios = радио = radio
der Ratschlag — Ratschläge = совет = advice
der Raum — Räume = комната; пространство = room; space
die Reaktion auf (Akkusativ) — Reaktionen = реакция на = reaction to
das Regal — Regale = полка = shelf
die Reparatur — Reparaturen = ремонт = repair
der Ring — Ringe = кольцо = ring
der Rollstuhl — Rollstühle = инвалидная коляска = wheelchair
das Rad — Räder = колесо; велосипед = wheel; bike
der Schaden — Schäden = ущерб = damage
der Schneider — Schneider = портной = tailor
die Schuld — Schulden = вина; долг = guilt; debt
die Schwierigkeit — Schwierigkeiten = трудность = difficulty
der Schal — Schals = шарф = scarf
der Silvesterabend — Silvesterabende = канун Нового года = New Year's Eve
das Sportereignis — Sportereignisse = спортивное событие = sporting event
das Sprichwort — Sprichwörter = пословица = proverb
die Strecke — Strecken = участок (пути); расстояние = stretch; distance
der Stress — Stresse = стресс = stress
die Subjunktion — Subjunktionen = подчинительный союз = subjunction
das Synonym — Synonyme = синоним = synonym
der Süden = юг = south
die Tat — Taten = поступок = deed
die Teilinformationen = частичная информация = partial information
das Ticket — Tickets = билет = ticket
das Training — Trainings = тренировка = training
der Traum — Träume = мечта; сон = dream
der Turm — Türme = башня = tower
die Tätigkeit — Tätigkeiten = деятельность = activity
die Türkei = Турция = Turkey
die Umgebung — Umgebungen = окружение = surroundings
der Umzug — Umzüge = переезд = move
unbestimmt = неопределённый = indefinite
die Unterstützung — Unterstützungen = поддержка = support
die Verantwortung für (Akkusativ) — Verantwortungen = ответственность за = responsibility for
der Verbrauch — Verbräuche = потребление = consumption
der Verbraucher — Verbraucher = потребитель = consumer
die Verfügung — Verfügungen = распоряжение = disposal; decree
der Vergleich — Vergleiche = сравнение = comparison
die Veränderung — Veränderungen = изменение = change
der Vogel — Vögel = птица = bird
die Vorwahlnummer — Vorwahlnummern = код номера = area code
der Wagen — Wagen = вагон; машина = car; wagon
die Wahrscheinlichkeit — Wahrscheinlichkeiten = вероятность = probability
die Wand — Wände = стена = wall
warum = почему = why
der Weg — Wege = путь = path
die Weihnachten = Рождество = Christmas
der Weihnachtsmarkt — Weihnachtsmärkte = рождественский рынок = Christmas market
Wiesbaden = Висбаден = Wiesbaden
der Wille — Willen = воля = will
woran = на чём = on what
die Wortart — Wortarten = часть речи = part of speech
der Zeitungsartikel — Zeitungsartikel = газетная статья = newspaper article
der Zuschauer — Zuschauer = зритель = spectator
Zürich = Цюрих = Zurich
abends = по вечерам = in the evenings
abhängig von (Dativ) = зависимый от = dependent on
anfertigen — fertigt an — angefertigt — fertigte an = изготавливать = produce
angesichts (Genitiv) = в связи с = in view of
der Angestellte — Angestellten = служащий = employee
anhören — hört an — angehört — hörte an = слушать = listen to
anscheinend = по-видимому = apparently
anstatt (Dativ) = вместо = instead of
ausreichend = достаточный = sufficient
auswählen — wählt aus — ausgewählt = выбирать = choose
beantworten — beantwortet — beantwortet = отвечать = answer
bedienen — bedient — bedient = обслуживать = serve
bedingt = обусловленный = conditional
befinden — befindet — befunden — befand = находиться = be located
benachbart = соседний = adjacent
berechnen — berechnet — berechnet = вычислять = calculate
berühmt = знаменитый = famous
betragen — beträgt — betragen — betrug = составлять (сумму) = amount to
bewerben sich — bewirbt — beworben — bewarb = подавать заявку = apply
bewerben sich bei (Dativ) um (Akkusativ) = подавать заявку (кому?) на (кого? что?) = apply to for
bezeichnen — bezeichnet — bezeichnet — bezeichnete = обозначать = denote
bislang = до сих пор = so far
buchen — bucht — gebucht = бронировать = book
böse auf (Akkusativ) — böser — am bösesten = (среднее) недовольство, злость на = mad at
dadurch = этим; через это = thereby
dahin = туда = to there
damals = тогда = back then
daraus = из этого = from that
darum = поэтому; вокруг этого = therefore
deklinieren — dekliniert — dekliniert = склонять = decline
demgegenüber = напротив этого = in contrast
dick = толстый = thick; fat
diskutieren — diskutiert — diskutiert = обсуждать = discuss
dorthin = туда = to there
dunkel = тёмный = dark
ebenfalls = также = also
eingreifen — greift ein — eingegriffen — griff ein = вмешиваться = intervene
einhalten — hält ein — eingehalten — hielt ein = соблюдать = comply with
einheitlich = единообразный = uniform
einladen — lädt ein — eingeladen — lud ein = приглашать = invite
einreichen — reicht ein — eingereicht — reichte ein = подавать (документы) = submit
einschränken — schränkt ein — eingeschränkt — schränkte ein = ограничивать = restrict
emotional = эмоциональный = emotional
empfehlen — empfiehlt — empfohlen — empfahl = рекомендовать = recommend
entgegen (Dativ) = навстречу; против; вопреки = contrary to
entschließen sich — entschließt — entschlossen — entschloss = решиться = decide
entschließen sich zu (Dativ) = решиться на = decide on
entweder … oder … = или …, или … (строго одно) = either … or …
ob … oder … = или …, или … (безразличие) = whether … or …
erblich = наследственный = hereditary
erholen — erholt — erholt = отдыхать = recover
erstellen — erstellt — erstellt = создавать (отчёт, план) = create
der Erwachsene — Erwachsenen = взрослый = adult
eröffnen — eröffnet — eröffnet = открывать = open
euch = вас = you (plural)
falls = в случае если = in case
fast = почти = almost
fertigen — fertigt — gefertigt — fertigte = изготавливать = manufacture
finanzieren — finanziert — finanziert = финансировать = finance
formulieren — formuliert — formuliert = формулировать = formulate
garantieren — garantiert — garantiert = гарантировать = guarantee
gelingen — gelingt — ist gelungen — gelang = удаваться = succeed
so genannt = так называемый = so-called
genießen — genießt — genossen — genoss = наслаждаться = enjoy
geraten — gerät — ist geraten — geriet = оказаться; советовать = get into; advise
gespannt auf (Akkusativ) = взволнованный (в ожидании) = excited about
grübeln — grübelt — gegrübelt = размышлять; ломать голову = ponder
heiß — heißer — am heißesten = горячий = hot
heraus = наружу = out
herstellen — stellt her — hergestellt — stellte her = производить = produce
hinauf = вверх = up there
hinein = внутрь = inside
hingegen = напротив = on the other hand
hinnehmen — nimmt hin — hingenommen — nahm hin = принимать (как факт) = accept
hinter = позади = behind
hoffen — hofft — gehofft = надеяться = hope
hoffen auf (Akkusativ) = надеяться на = hope for
humanitär = гуманитарный = humanitarian
informieren — informiert — informiert = информировать = inform
interessant = интересный = interesting
je = каждый; чем = each; per
jedoch = однако = however
jährlich = ежегодный = annual
kalt — kälter — am kältesten = холодный = cold
keinesfalls = ни в коем случае = by no means
kirchlich = церковный = church-related
komisch = смешной; странный = funny; strange
konventionell = традиционный = conventional
leuchten — leuchtet — geleuchtet = светить = shine
merken — merkt — gemerkt = замечать = notice
modern = современный = modern
morgen = завтра = tomorrow
morgendlich = утренний = morning (adj)
möglicherweise = возможно = possibly
na = ну = well
nachlesen — liest nach — nachgelesen — las nach = перечитывать; проверять = look up
notieren — notiert — notiert = записывать = note down
per (Dativ) = через; с помощью = by means of
privat = частный = private
prägen — prägt — geprägt = формировать; чеканить = shape; mint
prüfen — prüft — geprüft = проверять = check
reinigen — reinigt — gereinigt = чистить = clean
retten — rettet — gerettet = спасать = save
rufen — ruft — gerufen — rief = звать; кричать = call; shout
ruhig — ruhiger — am ruhigsten = спокойный = calm
schalten — schaltet — geschaltet = переключать = switch
scheiden — scheidet — geschieden — schied = разводиться; отделять = separate; divorce
sicherlich = наверняка = certainly
siebziger = семидесятые = seventies
sofort = сразу = immediately
solcher = такой = such
sorgen — sorgt — gesorgt = заботиться = care
sorgen für (Akkusativ) = заботиться про (кого?) = take care of
sorgen sich um (Akkusativ) = беспокоиться о = worry about
sozial = социальный = social
stattdessen = вместо этого = instead
stockend = прерывистый = intermittent
stoppen — stoppt — gestoppt = останавливать = stop
streichen — streicht — gestrichen — strich = вычёркивать; красить = cancel; paint
streng = строгий = strict
stressen — stresst — gestresst = нервировать, напрягать = stress
super = супер = super
surfen — surft — gesurft = серфить = surf
tatkräftig = энергичный = energetic
teilnehmen — nimmt teil — teilgenommen — nahm teil = участвовать = participate
teilnehmen an (Dativ) = участвовать в = participate in
tief = глубоко, низко = deep; low
der Tote — die Toten = мёртвый = dead person
trennbar = отделимый = separable
trennen — trennt — getrennt = разделять = separate
trotzdem = несмотря на это = nevertheless
unterstreichen — unterstreicht — unterstrichen — unterstrich = подчёркивать = underline
unterstützen — unterstützt — unterstützt = поддерживать = support
unzufrieden = недовольный = dissatisfied
verantwortlich für (Akkusativ) = ответственный за = responsible for
verbinden — verbindet — verbunden — verband = соединять = connect
verheiraten — verheiratet — verheiratet = женить; выдавать замуж = marry
verlangen — verlangt — verlangt = требовать = demand
verrückt = сумасшедший = crazy
verschieben — verschiebt — verschoben — verschob = сдвигать; откладывать = postpone
vertagen — vertagt — vertagt = откладывать (заседание) = postpone
vertrauen — vertraut — vertraut = доверять = trust
verursachen — verursacht — verursacht = вызывать, причинять = cause
völlig = полностью = completely
wachsen — wächst — ist gewachsen — wuchs = расти = grow — grew
warnen vor (Dativ) — warnt — gewarnt — warnte = предупреждать о = warn about
weiterhin = далее = further
weltbekannt = всемирно известный = world-famous
wem = кому = whom
wild = дикий = wild
woher = откуда = from where
womit = c чем = with what
worüber = о чём = about what
wunderschön = прекрасный = wonderful
zunehmen — nimmt zu — zugenommen — nahm zu = увеличиваться; набирать вес = increase; gain weight
zuordnen — ordnet zu — zugeordnet = сопоставить; привести в соответствие = assign
zurzeit = в настоящее время = currently
zuständig für (Akkusativ) = ответственный, компетентный за = responsible for
zusätzlich = дополнительный = additional
zweifeln — zweifelt — gezweifelt — zweifelte = сомневаться = doubt
zweifeln an (Dativ) = сомневаться в = doubt in
zählen — zählt — gezählt = считать = count
das Öl — Öle = масло = oil
Österreich = Австрия = Austria
die Übersicht — Übersichten = обзор = overview
öffnen — öffnet — geöffnet = открывать = open
üben — übt — geübt = практиковать; упражняться = practice
überleben — überlebt — überlebt = выжить, пережить = survive
überreden zu (Dativ) — überredet — überredet = уговаривать на = persuade to
der Abbau — Abbauten = сокращение, демонтаж, распад = reduction; dismantling; decay
der Abfall — Abfälle = отходы, мусор = waste
der Absolvent — Absolventen = выпускник = graduate
die Abteilung — Abteilungen = отдел = department
die Achtung — Achtungen = внимание = attention
die Adresse — Adressen = адрес = address
das Akkusativsymbol — Akkusativsymbole = символ винительного падежа = accusative symbol
die Aktivität — Aktivitäten = активность = activity
die Altsprache — Altsprachen = древний язык = ancient language
der Anbieter — Anbieter = поставщик = provider
der Andrang — Andränge = наплыв = rush
der Anfänger — Anfänger = новичок = beginner
der Anhang — Anhänge = приложение (к письму); прицеп = attachment; trailer
die Ansage — Ansagen = объявление (в транспорте) = announcement
die Anschaffung — Anschaffungen = приобретение (покупка) = acquisition
der Ansprechpartner — Ansprechpartner = контактное лицо = contact person
die Anweisung — Anweisungen = инструкция = instruction
das Aquajogging = бег в воде = aqua jogging
der Arbeitsalltag — Arbeitsalltage = рабочие будни = work routine
der Arbeitsplatz — Arbeitsplätze = рабочее место = workplace
Asien = Азия = Asia
die Atmung — Atmungen = дыхание = breathing
das Audio — Audios = аудио = audio
der Aufbau — Aufbauten = структура; строительство = structure; construction
der Aufenthalt — Aufenthalte = пребывание = stay
das Aufgabenblatt — Aufgabenblätter = лист с заданиями = assignment sheet
der Aufräumtag — Aufräumtage = день уборки = cleanup day
der Auftrag — Aufträge = заказ = order
das Auge — Augen = глаз = eye
die Ausrüstung — Ausrüstungen = оборудование = equipment
die Ausstellung — Ausstellungen = выставка = exhibition
der Bahnhof — Bahnhöfe = вокзал = train station
die Bahnstrecke — Bahnstrecken = железнодорожная линия = railway line
der Bauch — Bäuche = живот = belly
die Baustelle — Baustellen = стройка = construction site
die Bedingung — Bedingungen = условие = condition
die Bedrohung — Bedrohungen = угроза = threat
die Begegnung — Begegnungen = встреча = encounter
der Bericht — Berichte = отчёт = report
der Berliner — Berliner = берлинец = Berliner (person from Berlin)
die Berufsausbildung — Berufsausbildungen = профессиональное обучение = vocational training
die Beschreibung — Beschreibungen = описание = description
die Betonung — Betonungen = ударение = emphasis; stress
der Betrieb — Betriebe = предприятие; эксплуатация = enterprise; operation
der Beweis für (Akkusativ) — Beweise = доказательство для = proof for
die Bewerbung um (Akkusativ) — Bewerbungen = заявка, резюме на = application for
die Biokost = биопродукты = organic food
die Biolade — Bioladen = биомагазин = organic food store
die Blume — Blumen = цветок = flower
Brasilien = Бразилия = Brazil
der Brenner — Brenner = горелка = burner
das Brot — Brote = хлеб = bread
der Buddhist — Buddhisten = буддист = Buddhist
das Budget — Budgets = бюджет = budget
das Bundesland — Bundesländer = федеральная земля = federal state
die Bundesrepublik — Bundesrepubliken = федеральная республика = federal republic
die Bundesstraße — Bundesstraßen = федеральная дорога = federal road
die Bushaltestelle — Bushaltestellen = автобусная остановка = bus stop
die Bühne — Bühnen = сцена = stage
der Bürger — Bürger = гражданин = citizen
die Bürgerin — Bürgerinnen = гражданка = citizen (female)
die Bürgerinitiative — Bürgerinitiativen = гражданская инициатива = citizens' initiative
die Charaktereigenschaft — Charaktereigenschaften = черта характера = character trait
der Chauffeur — Chauffeure = шофёр = chauffeur
die Choice — Choices = выбор = choice
der Code — Codes = код = code
der Computerkurs — Computerkurse = компьютерный курс = computer course
das Computerprogramm — Computerprogramme = компьютерная программа = computer program
die Delikatesse — Delikatessen = деликатес = delicacy
das Detail — Details = деталь = detail
der Diener — Diener = слуга = servant
die Dienstleistung — Dienstleistungen = услуга = service
der Dolmetscher — Dolmetscher = переводчик (устный) = interpreter
der Draht — Drähte = проволока = wire
das Ehepaar — Ehepaare = супружеская пара = married couple
das Eichhörnchen — Eichhörnchen = белка = squirrel
der Eindruck — Eindrücke = впечатление = impression
die Eingebung — Eingebungen = озарение = inspiration
die Einigung — Einigungen = объединение = agreement
die Einlage — Einlagen = вклад; стелька = deposit; insole
die Einleitung — Einleitungen = введение = introduction
der Empfänger — Empfänger = получатель = recipient
die Endposition — Endpositionen = конечная позиция = end position
das Engagement — Engagements = участие; приверженность = commitment
England = Англия = England
der Enthusiasmus — Enthusiasmen = энтузиазм = enthusiasm
der Entschluss — Entschlüsse = решение = decision
die Entschuldigung — Entschuldigungen = извинение = apology
die Entspannung — Entspannungen = расслабление = relaxation
die Enttäuschung — Enttäuschungen = разочарование = disappointment
das Ereignis — Ereignisse = событие = event
der Erfahrungsbericht — Erfahrungsberichte = отчёт об опыте = experience report
das Erfahrungsgedächtnis — Erfahrungsgedächtnisse = долговременная память (память опыта) = long-term memory
die Ernte — Ernten = урожай = harvest
das Experiment — Experimente = эксперимент = experiment
die Explosion — Explosionen = взрыв = explosion
der Fachkräftemangel — Fachkräftemängel = нехватка специалистов = shortage of specialists
die Fachsprache — Fachsprachen = профессиональный язык = technical language
die Fahrkarte — Fahrkarten = билет на транспорт = ticket (for transport)
die Fahrprüfung — Fahrprüfungen = экзамен по вождению = driving test
der Fahrradstand — Fahrradstände = велостоянка = bike rack
die Fahrt — Fahrten = поездка = trip
das Fasching — Faschinge = карнавал = carnival
die Faulheit — Faulheiten = лень = laziness
das Feld — Felder = поле = field
das Fett — Fette = жир = fat
die Feuerwehr — Feuerwehren = пожарная служба = fire brigade
der Filter — Filter = фильтр = filter
der Fisch — Fische = рыба = fish
die Fitness = фитнес = fitness
das Fitnessstudio — Fitnessstudios = фитнес-студия = fitness studio
die Fledermaus — Fledermäuse = летучая мышь = bat
der Flug — Flüge = полёт = flight
das Fragewort — Fragewörter = вопросительное слово = question word
der Frankfurter — Frankfurter = франкфуртец = person from Frankfurt
Frankreich = Франция = France
der Freitag — Freitage = пятница = Friday
der Freizeittrend — Freizeittrends = тренд свободного времени = leisure trend
die Fremdsprache — Fremdsprachen = иностранный язык = foreign language
der Friede — Frieden = мир = peace
das Futur — Future = будущее (время) = future tense
der Fußball — Fußbälle = футбол = football
die Fünfzehnjährige — Fünfzehnjährigen = пятнадцатилетняя = fifteen-year-old (female)
fünfzehnjährig = пятнадцатилетний = fifteen-year-old
die Fürstin — Fürstinnen = княгиня = princess
der Gatte — Gatten = супруг = spouse (male)
das Gebiet — Gebiete = область = area
der Gebrauch — Gebräuche = использование; обычай = use; custom
das Gebäude — Gebäude = здание = building
die Gebührenerhöhung — Gebührenerhöhungen = повышение сборов = fee increase
die Geduld = терпение = patience
der Gegensatz — Gegensätze = противоположность = opposite
die Gehirnströme = мозговые волны = brainwaves
der Geist — Geister = дух = spirit
das Gelenk — Gelenke = сустав = joint
die Gemeinde — Gemeinden = община = community
der Genuss — Genüsse = наслаждение = enjoyment
der Geruch nach (Dativ) — Gerüche = запах (чего?) = smell of
die Geschäftsreise — Geschäftsreisen = командировка (деловая поездка) = business trip
die Gesundheit = здоровье = health
das Gesundheitsprogramm — Gesundheitsprogramme = программа здоровья = health program
der Gesundheitszustand — Gesundheitszustände = состояние здоровья = health condition
das Gift — Gifte = яд = poison
der Glaube — Glauben = вера = faith
der Grad — Grade = градус; степень = degree
das Grammatikkapitel — Grammatikkapitel = глава по грамматике = grammar chapter
die Grenze — Grenzen = граница = border
Griechenland = Греция = Greece
die Großeltern = бабушка и дедушка = grandparents
die Grundregel — Grundregeln = основное правило = basic rule
die Grundstufe — Grundstufen = начальный уровень = basic level
die Größe — Größen = размер = size
das Halbjahr — Halbjahre = полугодие = half-year
die Halle — Hallen = зал = hall
das Halloween = Хэллоуин = Halloween
der Handel — Handels = торговля = trade
die Hauptaussage — Hauptaussagen = основное утверждение = main statement
der Hausbewohner — Hausbewohner = житель дома = house resident
die Haushaltspflicht — Haushaltspflichten = домашняя обязанность = household duty
die Heimat — Heimaten = родина = homeland
die Heizung — Heizungen = отопление = heating
die Helenenstraße — Helenenstraßen = улица Хеленен = Helenen Street
her = сюда = here
der Herbst — Herbste = осень = autumn
das Hindernis — Hindernisse = препятствие = obstacle
die Hindus = индусы = Hindus
der Hit — Hits = хит = hit
der Hoax — Hoaxes = обман; мистификация = hoax
das Hobby — Hobbys = хобби = hobby
der Hof — Höfe = двор = courtyard
die Hosenträger = подтяжки = suspenders
der Händler — Händler = торговец = dealer
die Höflichkeit — Höflichkeiten = вежливость = politeness
der Hörtext — Hörtexte = аудиотекст = listening text
der Impuls — Impulse = импульс = impulse
das Indefinitpronomen — Indefinitpronomen = неопределённое местоимение = indefinite pronoun
der Insasse — Insassen = обитатель; пассажир = occupant; passenger
die Integration — Integrationen = интеграция = integration
das Interphon — Interphone = домофон = intercom
das Interview — Interviews = интервью = interview
der Jeck — Jecken = шут; карнавальный персонаж = jester; carnival character
der Jude — Juden = еврей = Jew
das Kamel — Kamele = верблюд = camel
der Karfreitag — Karfreitage = Страстная пятница = Good Friday
der Kasus — Kasus = падеж = case
der Keller — Keller = подвал = basement
der Kerl — Kerle = парень = guy
die Kerze — Kerzen = свеча = candle
der Kilometer — Kilometer = километр = kilometer
der Kirchenkritiker — Kirchenkritiker = критик церкви = church critic
die Klammer — Klammern = скобка = bracket
das Klavier — Klaviere = пианино = piano
das Kleintier — Kleintiere = мелкое животное = small animal
der Knopf — Knöpfe = кнопка = button
das Koma — Komas = кома = coma
der Konditionalsatz — Konditionalsätze = условное предложение = conditional clause
der Konditor — Konditoren = кондитер = confectioner
der Konflikt — Konflikte = конфликт = conflict
der Konkurrent — Konkurrenten = конкурент = competitor
der Konsum — Konsume = потребление = consumption
die Kontrolle — Kontrollen = контроль = control
das Konzept — Konzepte = концепция = concept
der Konzern — Konzerne = концерн = corporation
die Kostenerstattung — Kostenerstattungen = возмещение затрат = reimbursement
das Kostüm — Kostüme = костюм = costume
der Kreis — Kreise = круг; район = circle; district
der Kreislauf — Kreisläufe = круговорот = circulation
das Krokodil — Krokodile = крокодил = crocodile
die Kulanzregelung — Kulanzregelungen = правило доброй воли = goodwill rule
der Kummer — Kummer = горе; печаль = sorrow
die Kundennummer — Kundennummern = номер клиента = customer number
der König — Könige = король = king
die Körnerfresserei = поедание зёрен = grain eating
die Kündigung — Kündigungen = увольнение; расторжение = dismissal; termination
die Lage — Lagen = положение; местоположение = situation; location
die Landstraße — Landstraßen = загородная дорога = country road
das Lebensjahr — Lebensjahre = год жизни = year of life
das Lebensmittel — Lebensmittel = продукт питания = food product
die Lebensumstände = жизненные обстоятельства = living conditions
das Leid — Leiden = страдание, горе = suffering; grief
die Leitung — Leitungen = руководство; провод = management; wire
das Liebesnest — Liebesnester = любовное гнёздышко = love nest
die Lohnnebenkosten = дополнительные расходы на зарплату = additional labor costs
der Londoner — Londoner = лондонец = Londoner (person from London)
das Lotto — Lottos = лотерея = lottery
Luxemburg = Люксембург = Luxembourg
der Lärm — Lärme = шум = noise
die Lösungsmöglichkeit — Lösungsmöglichkeiten = возможность решения = possible solution
der Lückentext — Lückentexte = текст с пропусками = cloze test
Madrid = Мадрид = Madrid
der Main = Майн (река) = Main (river)
der Majoran = майоран = marjoram
Mallorca = Майорка = Mallorca
der Mantel — Mäntel = пальто = coat
der Marathon — Marathons = марафон = marathon
die Marine — Marinen = морской флот = navy
das Material — Materialien = материал = material
der Maurer — Maurer = каменщик = bricklayer
das Meer — Meere = море = sea
das Meeresufer — Meeresufer = морской берег = seashore
die Menge — Mengen = количество = quantity
die Miete — Mieten = аренда = rent
der Mieter — Mieter = арендатор = tenant
das Milieu — Milieus = среда = milieu
die Milliarde — Milliarden = миллиард = billion
das Mittagessen — Mittagessen = обед = lunch
die Modalpartikel — Modalpartikeln = модальная частица = modal particle
die Mode — Moden = мода = fashion
das Museum — Museen = музей = museum
die Musikveranstaltung — Musikveranstaltungen = музыкальное мероприятие = music event
die Muskelkraft = мышечная сила = muscular strength
die Muskulatur — Muskulaturen = мускулатура = musculature
die Mühe — Mühen = усилие = effort
die Natur — Naturen = природа = nature
die Nebenwirkung — Nebenwirkungen = побочный эффект = side effect
die Nomen = существительные = nouns
der Notruf — Notrufe = экстренный вызов = emergency call
das Obst = фрукты = fruit
das Opfer — Opfer = жертва = victim
die Organisation — Organisationen = организация = organization
die Orthopädie — Orthopädien = ортопедия = orthopedics
das Osterfest = Пасхальный праздник = Easter festival
die Ostereier = пасхальные яйца = Easter eggs
das Ostern = Пасха = Easter
der Parkplatz — Parkplätze = парковочное место = parking space
das Pech = невезение = bad luck
die Pension — Pensionen = пансион = pension
das Personal = персонал = staff
das Pferd — Pferde = лошадь = horse
die Pflanze — Pflanzen = растение = plant
das Pflanzenschutzmittel — Pflanzenschutzmittel = средство защиты растений = plant protection agent
die Pflegekraft — Pflegekräfte = медработник по уходу = caregiver
die Physik — Physiken = физика = physics
das Picknick — Picknicks = пикник = picnic
die Pluralendung — Pluralendungen = окончание множественного числа = plural ending
der Pole — Polen = поляк = Pole
der Polizeibesuch — Polizeibesuche = визит полиции = police visit
der Poll — Polls = опрос = poll
der Popstar — Popstars = поп-звезда = pop star
das Postamt — Postämter = почтовое отделение = post office
die Produktion — Produktionen = производство = production
der Professor — Professoren = профессор = professor
die Prognose — Prognosen = прогноз = prognosis
das Projekt — Projekte = проект = project
das Präfix — Präfixe = префикс = prefix
die Präzisionsuhr — Präzisionsuhren = точные часы = precision clock
die Qualität — Qualitäten = качество = quality
der Rabatt — Rabatte = скидка = discount
das Radiointerview — Radiointerviews = радио-интервью = radio interview
der Rasen — Rasen = газон = lawn
das Rathaus — Rathäuser = ратуша (здание мерии, местного самоуправления) = town hall
die Realität — Realitäten = реальность = reality
die Rechnung — Rechnungen = счёт; расчёт = bill; calculation
die Rechtspartei — Rechtsparteien = правая партия = right-wing party
die Regierung — Regierungen = правительство = government
der Reinfall — Reinfälle = провал (неудача) = flop
die Reinigung — Reinigungen = уборка = cleaning
der Reiseveranstalter — Reiseveranstalter = туроператор = tour operator
der Reporter — Reporter = репортёр = reporter
die Rose — Rosen = роза = rose
die Ruhe — Ruhen = покой = calm
das Rätoromanisch = романсийский язык = Romansh (language)
das Rätsel — Rätsel = загадка = riddle
der Rückgang — Rückgänge = снижение = decline
Saarland = Саарланд = Saarland
der Sachverhalt — Sachverhalte = обстоятельство дела = circumstance of the case
der Salat — Salate = салат = salad
der Samstag — Samstage = суббота = Saturday
der Sandstrand — Sandstrände = песчаный пляж = sandy beach
das Satzende — Satzenden = конец предложения = end of sentence
das Schema — Schemata = схема = scheme
der Schiedsrichter — Schiedsrichter = судья (в спорте), арбитр = referee
das Schlafengehen = отход ко сну = going to bed
die Schlagzeile — Schlagzeilen = заголовок = headline
der Schluss — Schlüsse = вывод; конец = conclusion; end
der Schmerz — Schmerzen = боль = pain
die Schnittstelle — Schnittstellen = интерфейс = interface
der Schokoladennikolaus — Schokoladennikoläuse = шоколадный Николаус = chocolate Santa Claus
schriftlich = письменный = written
der Schritt — Schritte = шаг = step
das Schuhmodell — Schuhmodelle = модель обуви = shoe model
der Schulfreund — Schulfreunde = школьный друг = school friend
die Schulzeit — Schulzeiten = школьное время = school time
das Schwimmbad — Schwimmbäder = бассейн = swimming pool
schön — schöner — am schönsten = красивый = beautiful
die Schönheit — Schönheiten = красота = beauty
die Sehnsucht nach (Dativ) — Sehnsüchte = тоска по = longing for
das Sekretariat — Sekretariate = секретариат = secretariat
die Sekretärin — Sekretärinnen = секретарь = secretary
das Seminar — Seminare = семинар = seminar
der Senior — Senioren = пожилой человек = senior
die Servicezeit — Servicezeiten = время обслуживания = service time
die Show — Shows = шоу = show
die Sicherheit — Sicherheiten = безопасность = safety
die Sicht — Sichten = вид; обзор = view; sight
das Silbenrätsel — Silbenrätsel = слоговая загадка = syllable puzzle
der Sitz — Sitze = сиденье = seat
das Smartphone — Smartphones = смартфон = smartphone
die Software — Softwares = программное обеспечение = software
der Sohn — Söhne = сын = son
der Spam — Spams = спам = spam
Spanien = Испания = Spain
der Spaziergänger — Spaziergänger = пешеход, прогуливающийся человек = pedestrian; walker
der Speicherplatz — Speicherplätze = место для хранения = storage space
der Sperrmüllservice — Sperrmüllservices = служба вывоза крупногабаритного мусора = bulky waste service
die Spinne — Spinnen = паук = spider
das Sportprogramm — Sportprogramme = спортивная программа = sports program
der Spracherwerb — Spracherwerbe = освоение языка = language acquisition
die Sprachprüfung — Sprachprüfungen = языковой экзамен = language exam
die Spülmaschine — Spülmaschinen = посудомоечная машина = dishwasher
das Stadion — Stadien = стадион = stadium
die Stadthalle — Stadthallen = городской зал = city hall
der Stadtrat — Stadträte = городской совет = city council
der Standesbeamter — Standesbeamte = сотрудник ЗАГСа = registrar
der Start — Starts = старт = start
die Steinzeitmenschen = люди каменного века = Stone Age people
der Stellenabbau — Stellenabbauten = сокращение штатов = staff reduction
der Stoff — Stoffe = материал; ткань = material; fabric
der Strauß — Sträuße = букет; страус = bouquet; ostrich
die Straßenbahn — Straßenbahnen = трамвай = tram
der Streik — Streiks = забастовка = strike
der Streit — Streite = спор = dispute
das Studienfach — Studienfächer = учебный предмет = field of study
der Studierende — Studierenden = студент = student
das Studium — Studien = учёба; исследование = studies; research
der Superlativ — Superlative = превосходная степень = superlative
die Szene — Szenen = сцена = scene
die Tante — Tanten = тётя = aunt
der Onkel — Onkel = дядя = uncle
der Enkel — Enkel = внук = grandson
der Tarifpartner — Tarifpartner = тарифный партнёр = tariff partner
die Tarifpartnerschaft — Tarifpartnerschaften = тарифное партнёрство = tariff partnership
die Taxis = такси = taxis
der Techniker — Techniker = техник = technician
der Teig — Teige = тесто = dough
die Teigwaren = макаронные изделия = pasta
der Theaterschuhmacher — Theaterschuhmacher = театральный сапожник = theatrical shoemaker
die Theorie — Theorien = теория = theory
die Tierhaltung — Tierhaltungen = содержание животных = animal husbandry
der Tod — Tode = смерть = death
der Trend — Trends = тренд = trend
die Treppe — Treppen = лестница = staircase
der Tanz — Tänze = танец = dance
die Unterkunft — Unterkünfte = жильё = accommodation
der Unterschied — Unterschiede = различие = difference
die Variante — Varianten = вариант = variant
der Vegetarier — Vegetarier = вегетарианец = vegetarian
der Veranstalter — Veranstalter = организатор = organizer
die Veranstaltungshinweise = информация о мероприятиях = event information
der Verbstamm — Verbsträmme = основа глагола = verb stem
die Verfilmung — Verfilmungen = экранизация = film adaptation
der Verkauf — Verkäufe = продажа = sale
der Verkäufer — Verkäufer = продавец = seller
der Verlag — Verlage = издательство = publisher
die Verpflegung — Verpflegungen = питание = catering; food
die Versorgung — Versorgungen = обеспечение = supply
die Verspätung — Verspätungen = опоздание = delay
die Verständnisbarriere — Verständnisbarrieren = барьер понимания = comprehension barrier
der Vertrag — Verträge = договор = contract
die Volkshochschule — Volkshochschulen = народный университет = adult education center
die Vollpension — Vollpensionen = полный пансион = full board
voraus = вперёд = ahead
die Vorbereitung — Vorbereitungen = подготовка = preparation
das Vorjahr — Vorjahre = предыдущий год = previous year
die Vorsicht = осторожность = caution
der Vorverkauf — Vorverkäufe = предварительная продажа = presale
der Wandel — Wandel = изменение = change
die Ware — Waren = товар = goods
die Wechselpräposition — Wechselpräpositionen = переменный предлог = two-way preposition
die Weihnachtszeit — Weihnachtszeiten = рождественское время = Christmas time
der Wein — Weine = вино = wine
die Wendung — Wendungen = оборот; поворот = phrase; turn
das Werk — Werke = произведение; завод = work; factory
der Wert — Werte = ценность = value
das Wesen — Wesen = существо; сущность = being; essence
der Wetterbericht — Wetterberichte = прогноз погоды = weather report
Wien = Вена = Vienna
die Wirklichkeit — Wirklichkeiten = действительность = reality
der Wissenschaftler — Wissenschaftler = учёный = scientist
die Wolke — Wolken = облако = cloud
das Wortfeld — Wortfelder = группа связанных слов = word field
das Yoga — Yogas = йога = yoga
die Zahlenangabe — Zahlenangaben = указание числа = number specification
das Zeugnis — Zeugnisse = свидетельство; аттестат = certificate; report card
der Zucker — Zucker = сахар = sugar
die Zusammenfassung — Zusammenfassungen = краткое изложение = summary
der Zusammenhang — Zusammenhänge = связь = context; connection
der Zusatzstoff — Zusatzstoffe = добавка = additive
der Zweck — Zwecke = цель = purpose
die Zweisprachigkeit — Zweisprachigkeiten = двуязычие = bilingualism
abbauen — baut ab — abgebaut = разбирать; сокращать = dismantle; reduce
der Abgeordnete — Abgeordneten = депутат = member of parliament
der Anwalt — Anwälte = адвокат = lawyer
ablehnen — lehnt ab — abgelehnt — lehnte ab = отклонять = reject
abnehmen — nimmt ab — abgenommen — nahm ab = снимать; худеть = take off; lose weight
abstürzen — stürzt ab — ist abgestürzt — stürzte ab = падать; разбиваться = crash
abwertend = уничижительный = derogatory
achten auf (Akkusativ) — achtet — geachtet — achtete = обращать внимание на (кого? что?) = pay attention to
die Adjektivendung — Adjektivendungen = окончание прилагательного = adjective ending
alleinerziehend = одинокий родитель = single parent
altmodisch = старомодный = old-fashioned
anbraten — brät an — angebraten — briet an = обжаривать = fry (lightly)
andererseits = с другой стороны = on the other hand
angeben — gibt an — angegeben — gab an = указывать; хвастаться = indicate; brag
angefertigen — fertigt an — angefertigt — fertigte an = изготавливать = produce
angepasst = приспособленный = adapted
anhalten — hält an — angehalten — hielt an = останавливать = stop
anhand (Genitiv) = на основе = based on
anregen — regt an — angeregt — regte an = побуждать; стимулировать = encourage
anwenden — wendet an — angewendet — wendete an = применять = apply
arm — ärmer — am ärmsten = бедный = poor
aufbauen — baut auf — aufgebaut — baute auf = строить; основывать = build; establish
auffallen — fällt auf — ist aufgefallen — fiel auf = бросаться в глаза = stand out
aufgeregt = взволнованный = excited
aufhören mit (Dativ) — hört auf — aufgehört — hörte auf = прекращать (что?) = stop (doing something)
aufnehmen — nimmt auf — aufgenommen — nahm auf = записывать; принимать = record; take up
aufpassen — passt auf — aufgepasst — passte auf = присматривать = watch out
aufregend = захватывающий, волнующий = exciting
aufräumen — räumt auf — aufgeräumt — räumte auf = убирать = tidy up
aufwachen — wacht auf — ist aufgewacht — wachte auf = просыпаться = wake up
ausführlich = подробный = detailed
ausgeben — gibt aus — ausgegeben — gab aus = тратить = spend
aushandeln — handelt aus — ausgehandelt — handelte aus = договариваться = negotiate
austauschen — tauscht aus — ausgetauscht — tauschte aus = обменивать = exchange
auswendig = наизусть = by heart
auszeichnen — zeichnet aus — ausgezeichnet — zeichnete aus = отличать; награждать = distinguish; award
außerhalb (Genitiv) = вне = outside of
bedauern — bedauert — bedauert — bedauerte = сожалеть = regret
bedürfen — bedarf — bedurft — bedurfte = нуждаться = require
beeinflussen — beeinflusst — beeinflusst — beeinflusste = влиять = influence
beeinträchtigen — beeinträchtigt — beeinträchtigt — beeinträchtigte = ухудшать, вредить = impair
begeistert = восторженный = enthusiastic
begreifen — begreift — begriffen — begriff = понимать = comprehend
begründen — begründet — begründet — begründete = обосновывать = justify
behalten — behält — behalten — behielt = сохранять = keep
beilegen — legt bei — beigelegt — legte bei = прилагать = enclose
bekennen — bekennt — bekannt — bekannte = признавать = confess
belaufen — beläuft — belaufen — belief = составлять (сумму) = amount to
beliebt = популярный = popular
bellen — bellt — gebellt — bellte = лаять = bark
bemalt = расписной = painted
beobachten — beobachtet — beobachtet — beobachtete = наблюдать = observe
beraten — berät — beraten — beriet = советовать = advise
bereiten — bereitet — bereitet — bereitete = готовить = prepare
bereuen — bereut — bereut — bereute = сожалеть = regret
beruflich = профессиональный = professional
beruhigen — beruhigt — beruhigt — beruhigte = успокаивать = calm
beschließen — beschließt — beschlossen — beschloss = решать = decide
beschreiben — beschreibt — beschrieben — beschrieb = описывать = describe
beschädigen — beschädigt — beschädigt — beschädigte = повреждать = damage
beschäftigen sich mit (Dativ) — beschäftigt — beschäftigt — beschäftigte = заниматься (чем?) = be occupied with
besichtigen — besichtigt — besichtigt — besichtigte = осматривать = visit
besonder = особый = special
bestellen — bestellt — bestellt = заказывать = order
bestimmen — bestimmt — bestimmt = определять = determine
betonen — betont — betont — betonte = подчёркивать = emphasize
bevorzugen — bevorzugt — bevorzugt — bevorzugte = предпочитать = prefer
beweisen — beweist — bewiesen — bewies = доказывать = prove
beziehen — bezieht — bezogen — bezog = относиться; переезжать = relate to; move (house)
bilingual = двуязычный = bilingual
billig = дешёвый = cheap
bisher = до сих пор = so far
bisschen = немного = a little
bissen — beißt — gebissen — biss = кусать = bite — bit
blau = синий = blue
brechen — bricht — gebrochen — brach = ломать = break — broke
bunt — bunter — am buntesten = яркий; разноцветный = colorful
die CD — CDs = компакт-диск = CD
dennoch = тем не менее = nevertheless
dienen — dient — gedient — diente = служить = serve
die Doppelkonnektoren = двойные соединители = double connectors
dramatisch = драматичный = dramatic
dreimal = трижды = three times
durchgegangen = пройденный = gone through
dänisch = датский = Danish
eingeschlafen = заснувший = fallen asleep
einigen — einigt — geeinigt — einigte = договариваться = agree
einkaufen — kauft ein — eingekauft — kaufte ein = покупать = shop
einliefern — liefert ein — eingeliefert — lieferte ein = доставлять = admit (to hospital); deliver
einnehmen — nimmt ein — eingenommen — nahm ein = принимать; занимать = take; occupy
einsetzen — setzt ein — eingesetzt — setzte ein = использовать; вставлять = use; insert
einzeln = отдельный = individual
elektrisch = электрический = electric
empfangen — empfängt — empfangen — empfing = принимать; встречать = receive; welcome
entdecken — entdeckt — entdeckt — entdeckte = обнаруживать = discover
entsprechen — entspricht — entsprochen — entsprach = соответствовать = correspond
entsprechend = соответственно = accordingly
entwerfen — entwirft — entworfen — entwarf = разрабатывать = design
erfinden — erfindet — erfunden — erfand = изобретать = invent
erlernen — erlernt — erlernt = изучать = learn
erläutern — erläutert — erläutert = пояснять = explain
erneut = вновь = again
ernst = серьёзный = serious
erreichbar = доступный = reachable
erschrocken = испуганный = frightened
ersetzen — ersetzt — ersetzt = заменять = replace
erteilen — erteilt — erteilt = давать (разрешение) = grant
erwachen — erwacht — ist erwacht = пробуждаться = awake
erziehen — erzieht — erzogen — erzog = воспитывать = raise; educate
familiär = семейный = familial
faul — fauler — am faulsten = ленивый = lazy
fehlen — fehlt — gefehlt — fehlte = отсутствовать = be missing
ferner = далее = furthermore
fernsehen — sieht fern — ferngesehen — sah fern = смотреть телевизор = watch TV
fliehen — flieht — ist geflohen — floh = убегать = flee
fliehen vor (Dativ) = убегать от = flee from
französische = французский = French
friedlich = мирный = peaceful
fundiert = обоснованный = well-founded
fügen — fügt — gefügt = добавлять = add
füttern — füttert — gefüttert = кормить = feed
gefährlich = опасный = dangerous
gehörend = принадлежащий = belonging
geistig = духовный; умственный = mental
genug = достаточно = enough
geschehen — geschieht — ist geschehen — geschah = происходить = happen
gratulieren — gratuliert — gratuliert = поздравлять = congratulate
gratulieren zu (Dativ) = поздравлять с = congratulate on
die Gratulation — Gratulationen = поздравление = congratulations
grün = зелёный = green
gründen — gründet — gegründet = основывать = found
gründlich = тщательный = thorough
hektisch = лихорадочный = hectic
herein = внутрь = in here
herum = вокруг = around
hierbei = при этом = hereby
hinunter = вниз = down (wards)
hinweg = через = over
hinzugeben — gibt hinzu — hinzugegeben — gab hinzu = добавлять = add
höflich = вежливый = polite
ideal = идеальный = ideal
indem = тем, что = by (doing something)
inklusive = включительно, включённый = including
innen = внутри = inside
irgendwas = что-нибудь = anything
irgendwo = где-нибудь = somewhere
jedenfalls = в любом случае = in any case
jeglicher = любой = any
jetzig = нынешний = current
kabarettistisch = кабаретный = cabaret-like
kennenlernen — lernt kennen — kennengelernt — lernte kennen = знакомиться = get to know
klappen — klappt — geklappt = получается = work out
klettern — klettert — geklettert = лазать = climb
klopfen — klopft — geklopft = стучать = knock
kommend = приходящий = coming
komplett = полный = complete
korrekt = правильный = correct
krank — kränker — am kränksten = больной = sick
kriegen — kriegt — gekriegt — kriegte = получить, взять, достать = get
hinkriegen — er kriegt hin — hingekriegt — kriegte hin = справляться = manage
kritisch = критический = critical
künstlich = искусственный = artificial
laden — lädt — geladen — lud = загружать; приглашать = load; invite
landen — landet — gelandet — landete = приземляться = land
laufend = текущий = ongoing
lauten — lautet — gelautet = звучать = read as
lecker = вкусный = tasty
lehren — lehrt — gelehrt — lehrte = обучать = teach
leisten — leistet — geleistet = выполнять; оказывать = accomplish; provide
leiten — leitet — geleitet = руководить = lead
liefern — liefert — geliefert = поставлять = deliver
links = слева = left
logisch = логичный = logical
meistern — meistert — gemeistert = овладевать = master
melden — meldet — gemeldet = сообщать = report
messen — misst — gemessen — maß = измерять = measure
mitbringen — bringt mit — mitgebracht — brachte mit = приносить с собой = bring along
miteinander = друг с другом = with each other
mitkommen — kommt mit — ist mitgekommen — kam mit = идти вместе = come along
mitnehmen — nimmt mit — mitgenommen — nahm mit = брать с собой = take along
neben (Dativ) = рядом = next to
negativ = негативный = negative
nett = милый = nice
normal = нормальный = normal
notwendig = необходимый = necessary
nutzen — nutzt — genutzt = использовать = use
nötig = нужный = needed
offen = открытый = open
offiziell = официальный = official
optimal = оптимальный = optimal
pausenlos = без перерыва = nonstop
perfekt = идеальный = perfect
pflanzen — pflanzt — gepflanzt = сажать = plant
politisch = политический = political
positiv = позитивный = positive
probieren — probiert — probiert = пробовать = try
raten — rät — geraten — riet = советовать = advise
raten zu (Dativ) = советовать (по поводу) = advise to
rauben — raubt — geraubt = грабить = rob
rauchen — raucht — geraucht = курить = smoke
regelmäßig = регулярный = regular
regnen — regnet — geregnet = идти (о дожде) = rain
reif = зрелый = ripe
riechen — riecht — gerochen — roch = пахнуть = smell
riechen nach (Dativ) = пахнуть (чем?) = smell like
rosarot = розовый = pink
rund = круглый = round
räumen — räumt — geräumt = убирать = clear
rühren — rührt — gerührt = мешать = stir
scharf — schärfer — am schärfsten = острый = sharp
schauen — schaut — geschaut = смотреть = look
scheitern — scheitert — ist gescheitert = терпеть неудачу = fail
schief = кривой = crooked
schlagen — schlägt — geschlagen — schlug = бить = hit
schlimm = плохой = bad
die Schlittschuhe — Schlittschuhe = коньки = ice skates
schuld = виноват = guilty
schwimmen — schwimmt — geschwommen — schwamm = плавать = swim
schwitzen — schwitzt — geschwitzt = потеть = sweat
schätzen — schätzt — geschätzt = оценивать = estimate
schützen — schützt — geschützt = защищать = protect
sehnen sich — sehnt — gesehnt = тосковать = long
sehnen sich nach (Dativ) = тосковать по = long for
sinken — sinkt — ist gesunken — sank = тонуть; опускаться = sink
sogar = даже = even
somit = таким образом = thus
sommerlich = летний = summery
sonst = иначе; другой = otherwise
spannend = захватывающий = exciting
speichern — speichert — gespeichert = сохранять = save
spießig = мещанский = petty bourgeois
sprachlich = языковой = linguistic
sterben — stirbt — ist gestorben — starb = умирать = die — died
stoßen — stößt — gestoßen — stieß = толкать = push
streiten — streitet — gestritten — stritt = спорить = argue
städtisch = городской = urban
subjektiv = субъективный = subjective
tanzen — tanzt — getanzt = танцевать = dance
teilweise = частично = partially
telefonieren — telefoniert — telefoniert = звонить по телефону = telephone
total = полный = total
traurig = грустный = sad
treiben — treibt — getrieben — trieb = гнать; заниматься = drive; do
töten — tötet — getötet = убивать = kill
türkisch = турецкий = Turkish
umfangreich = обширный = extensive
umleiten — leitet um — umgeleitet = перенаправлять = divert
umsatteln — sattelt um — umgesattelt = переучиваться = change career
ungarisch = венгерский = Hungarian
unglaublich = невероятный = incredible
unpersönlich = безличный = impersonal
unpopulär = непопулярный = unpopular
unschätzbar = неоценимый = invaluable
unten = внизу = down
unterhalten — unterhält — unterhalten — unterhielt = развлекать; беседовать = entertain; converse
unterschiedlich = различный = different
unvergesslich = незабываемый = unforgettable
unüblich = необычный = unusual
verbessern — verbessert — verbessert = улучшать = improve
verbrauchen — verbraucht — verbraucht = потреблять = consume
verbreiten — verbreitet — verbreitet = распространять = spread
vereinen — vereint — vereint = объединять = unite
verfügen — verfügt — verfügt = располагать = have (at disposal)
vergangen = прошедший = past
verhalten — verhält — verhalten — verhielt = вести себя = behave
verletzen — verletzt — verletzt = ранить = injure
vermeiden — vermeidet — vermieden — vermied = избегать = avoid
vermuten — vermutet — vermutet = предполагать = assume
verneinen — verneint — verneint = отрицать = deny
vernichten — vernichtet — vernichtet = уничтожать = destroy
versetzen — versetzt — versetzt = переводить; переносить = transfer
vertreiben — vertreibt — vertrieben — vertrieb = изгонять; продавать = expel; sell
verärgert = раздражённый = annoyed
vollwertig = полноценный = wholesome
vorbehalten — behält vor — vorbehalten — behielt vor = сохранять за собой = reserve
vorbereiten sich — bereitet vor — vorbereitet = готовиться к = prepare
vorbereiten sich auf (Akkusativ) = готовиться к = prepare for
vorher = раньше = before
vorlesen — liest vor — vorgelesen — las vor = читать вслух = read aloud
wachsend = растущий = growing
wahr = истинный = true
wechseln — wechselt — gewechselt = менять = change
wehren — wehrt — gewehrt = сопротивляться = resist
weisen — weist — gewiesen — wies = указывать = point
weiterführen — führt weiter — weitergeführt — führte weiter = продолжать = continue
wert — werter — am wertesten = ценный = valuable
wiedergeben — gibt wieder — wiedergegeben — gab wieder = воспроизводить, передавать = reproduce
wiederholen — wiederholt — wiederholt = повторять = repeat
wozu = зачем = what for
würzen — würzt — gewürzt = приправлять = season
ziemlich = довольно = quite
zuhören — hört zu — zugehört = слушать = listen
zustellen — stellt zu — zugestellt — stellte zu = доставлять = deliver
zweimal = дважды = twice
zwingen — zwingt — gezwungen — zwang = заставлять = force
der Ältere — Älteren = пожилой человек = elder person
die Ölrechnung — Ölrechnungen = счёт за масло = oil bill
äußerst = чрезвычайно, крайне = extremely
ökologisch = экологический = ecological
östlich = восточный = eastern
überlebt = выживший = survivor
überraschen — überrascht — überrascht = удивлять = surprise
überraschend = удивительный = surprising
übertreffen — übertrifft — übertroffen — übertraf = превосходить = exceed
ebenso wie = также, как = just like
schüchtern = стеснительный = shy
gucken — guckt — geguckt = смотреть, глядеть = look
abhängen — es hängt ab — abgehängt — hing ab = зависеть = depend
abhängen von (Dativ) = зависеть от = depend on
erkundigen sich — erkundigt — erkundigt = поинтересоваться = inquire
erkundigen sich bei (Dativ) = поинтересоваться у (где?) = inquire at
unterscheiden sich — unterscheidet — unterschieden — unterschied = отличаться = differ
unterscheiden sich in (Dativ) von (Dativ) = отличаться в ... от ... = differ in ... from ...
liegen — es liegt — gelegen — lag = быть причиной; зависеть = lie (cause); depend
liegen an (Dativ) = быть причиной (чего?); зависеть от (чего?) = be due to; depend on
verlassen sich — verlässt — verlassen — verließ = полагаться = rely
verlassen sich auf (Akkusativ) = полагаться на (кого? что?) = rely on
nachfragen — fragt nach — nachgefragt — fragte nach = уточнять = inquire
nachfragen bei (Dativ) = уточнять у = inquire at
wundern sich — wundert — gewundert = удивляться = wonder
wundern sich über (Akkusativ) = удивляться по поводу = wonder about
das Heimweh nach (Dativ) — Heimweh = тоска по = homesickness for
die Bereitschaft zu (Dativ) — Bereitschaften = готовность к = readiness for
die Hoffnung auf (Akkusativ) — Hoffnungen = надежда на = hope for
die Erinnerung an (Akkusativ) — Erinnerungen = воспоминание о = memory of
das Zeichen für (Akkusativ) — Zeichen = знак для = sign for
beteiligt an (Dativ) = вовлечённый в = involved in
enttäuscht von (Dativ) = разочарованный в = disappointed with
geschieden von (Dativ) = разведённый с = divorced from
getrennt von (Dativ) = отделённый от = separated from
scharf auf (Akkusativ) = быть без ума от; очень хотеть (что-то) = keen on
überzeugt von (Dativ) = уверенный в = convinced of
verheiratet mit (Dativ) = женатый (замужем) c = married to
zornig auf (Akkusativ) = (очень сильно) злой на = furious at =