der Auflage = тираж
der Nachfolger = преемник
die Ausgabe = издание
die Vorgaben = требования
die Drucke = печать
die Zahl = число
die Nutzung = использование
die Einwilligung = согласие
der Verlages = издательство
die Links = ссылки
die Linksetzung = размещение ссылок
die Inhalte = содержание
die Seiten = страницы
die Gestaltung = оформление
die Urheberschaft = авторство
der Einfluss = влияние
die Überarbeitung = доработка
die Gestaltung = оформление
der Satz = набор текста
die Bindung = переплет

anpassen — angepasst = адаптировать, настраивать
verwenden — verwendet = использовать
bezeichnen — bezeichnet = обозначать, называть
schützen — geschützt = защищать
prüfen — geprüft = проверять
gelten — er gilt — gegolten — galt = считаться, действовать (о правилах)
ausführen — ausgeführt = выполнять
eingeben — er gibt ein — eingegeben — gab ein = вводить (данные)
abrufen — abgerufen — rief ab = запрашивать, извлекать (данные)
der Bedarf; bedarfen — er bedarf — bedurft — bedurfte = потребность; нуждаться { в чем-то? Genitiv }
verlinken — verlinkt = ссылаться

entsprechend = соответствующий
nebeneinander = рядом
urheberrechtlich = авторско-правовой
gesetzlich = законный
zugelassenen = разрешенный
vorherigen = предыдущий
angegebenen = указанный
sorgfältig = тщательный
wohl = благополучный
verlinkenden = ссылающийся
erkennbar = узнаваемый
distanziert = дистанцированный
hiermit = здесь

letzte Zahl = последнее число
alle Rechte vorbehalten = все права защищены


gemeinsam = общий
der Referenzrahmen = референтные рамки
der Bereich = область
das Gebiet = территория / сфера
das Auffrischen = обновление / повторение
die Sprachbausteine = языковые конструкции
schriftlich, mündlich = письменно, устно
der Ausdruck = выражение, распечатка
die Aufgabe = задача
die Bedingung = условие
die Beschreibung = описание
die Typen = типы
die Niveaustufe = уровень сложности
der Einsatz = использование
der Lösungsschlüssel = ключ решения
augmented = дополненный / расширенный
der Auftrag = задание
der Verlag = издательство

entsprechen — es entspricht — entsprochen — entsprach = соответствовать
vorbereiten — er bereitet vor — vorbereitet = готовиться
anbieten — angeboten — bot an = предлагать
bestehen — es besteht — bestanden — bestand = состоять из / проходить успешно
beziehen sich auf { Akkusativ } — es bezieht sich — bezogen — bezog = относиться к { чему? }
geübt; üben — geübt = опытный; практиковать
einüben — eingeübt = тренировать
angepasst = адаптированный
ergänzen — ergänzt = дополнять
festigen — gefestigt = укреплять
eignen — geeignet = подходить / быть пригодным
überprüfen — er überprüft — überprüft = проверять
stehen auf { Akkusativ } — gestanden — stand = стоять на { чем? }
mitwirken — er wirkt mit — mitgewirkt = участвовать

vorliegende = имеющийся
breit = широкий
jeweils = каждый / соответственно
weitgehend = в значительной степени
beispielhaft = показательный / примерный
umfangreich = обширный
festlegen — festgelegt = определять / устанавливать (правила)
dabei = при этом
dazu = для этого / к этому
behandeln — behandelt = обрабатывать / рассматривать / лечить
anschließen — angeschlossen — schloss an = присоединяться / следовать
gemäß = согласно / в соответствии с
erfahrungsgemäß = согласно опыту
schrittweise = пошаговый
unabhängig = независимый
anhand = на основе / с помощью
ebenfalls = также


die Ernährung = питание
die Diät = диета
die Steinzeit = каменный век
die Glyx-Diät = гликемическая диета
die Atkins = аткинская диета
das Low-Carb-Programm = низкоуглеводная программа
der Physiologe = физиолог
der Speiseplan = план питания
die Bevölkerung = население
das Gewicht; das Übergewicht = вес; избыточный вес
das Wunder = чудо
die Vorfahren = предки
die Nahrungsmittel = продукты питания
die Maßen = меры / умеренность
die Herstellung = производство
das Getreide = зерновые
die Getreidekörner = зерна
der Knochen = кость
die Spur = след
das Gnu = гну (животное)
die Steinmesser = каменные ножи
die Insekten = насекомые
die Gemüsesorten = виды овощей
das Fettpolster = жировая прослойка
das Hirn = мозг
das Knochenmark = костный мозг
der Lieferant = поставщик
die Ballaststoffe = пищевые волокна

verzehren — es verzeuht — verzehrt — verzelte = потреблять / сжигать
abnehmen — er nimmt ab — abgenommen — nahm ab = терять (вес)
ausmachen — ausgemacht = составлять, выключать, договариваться
melken — gemolken — molk = доить
fehlen — gefehlt = не хватать
jagen — gejagt = охотиться
stehen — gestanden — stand = стоять / находиться
anlegen — angelegt = создавать / наносить
mahlen — gemahlen — mahlte = молоть
kochen — gekocht = готовить / варить

ständig = постоянно
garantiert = гарантированный
deren = чей / чья / чьё
verdaulich = легкоусвояемый
zugleich = одновременно


die Proteine; das Fett; die Kohlenhydrate = белки; жир; углеводы
das Bedürfnis = потребность
die Gewohnheit = привычка
das Teilchen = частичка
das Zehntel = десятая часть
die Urbevölkerung = коренное население
das Lebensjahrzehnt = десятилетие жизни
die Forschung = исследование
die Lebenserwartung = ожидаемая продолжительность жизни
das Risiko = риск
die Unfälle = несчастные случаи
die Verletzungen = травмы
die Untersuchungen = исследования
der Jäger = охотник
die Sammlervölker = собирательные племена
die Stämme = племена
der Bluthochdruck = гипертония / высокое кровяное давление
der Cholesterinspiegel = уровень холестерина
der Schlankheitsratgeber = совет по похудению
der Schädel = череп
die Chemie = химия
die Mengen = количества
die Urahnen = предки
die Kräuter = травы

leben — gelebt = жить
aufwachsen — er wächst auf — ist aufgewachsen — wuchs auf = расти / воспитываться
sterben — er stirbt — ist gestorben — starb = умирать
bestätigen — bestätigt = подтверждать
leiden — gelitten — litt = страдать
übernehmen — er übernimmt — übernommen — nahm über = принимать на себя / копировать
abschauen — abgeschaut = копировать / перенимать
sammeln — gesammelt = собирать
scheinen — gescheint – schien = казаться

insofern = настолько, в той мере
vermutlich = вероятно
immerhin = всё же
deutlich = явно / очевидно
durchschnittlich = в среднем
keineswegs = отнюдь не
ebenso = также / одинаково
roh = сырой
tatsächlich = действительно


der Kasten = ящик / коробка
der Magen = желудок
der Darm = кишечник
die Petersilie = петрушка
der Schnittlauch = зеленый лук

einsetzen — er setzt ein — hat eingesetzt — setzte ein = использовать / применять
verdauen — er verdaut — hat verdaut – verdautte = переваривать
verringern — er verringert — hat verringert – verminderte = уменьшать / снижать