sein — ist gewesen — war — wäre = olmak  
und = ve  
in = içinde  
ein = bir  
haben — er hat — gehabt — hatte — hätte = sahip olmak  
zu = için  
es = o  
auch = ayrıca  
werden — er wird — ist geworden = olmak  
ich = ben  
nicht = değil  
mit = ile  
sie = o (dişil) / onlar  
sich = kendini  
für = için  
von = -den/-dan  
auf = üzerinde  
so = böyle  
wir = biz  
können — ich/er kann — konnte — könnte = yapabilmek  
dass = ki  
hier = burada  
an = -e/-a  
wie = nasıl  
man = bir (kişi)  
dieser = bu  
aber = ama  
er = o (eril)  
dann = sonra  
als = olarak  
ihr = siz / onun (dişil)  
aus = -den/-dan  
das Jahr = yıl  
noch = hala  
bei = yanında  
machen — gemacht = yapmak  
wenn = eğer  
mehr = daha fazla  
geben — er gibt — gegeben = vermek  
nur = sadece  
da = orada  
also = yani  
ganz = tamamen  
ja = evet  
oder = veya  
immer = her zaman  
jetzt = şimdi  
gut = iyi  
kommen — ist gekommen = gelmek  
schon = zaten  
alle = herkes  
nach = sonra  
gehen — ist gegangen = gitmek  
um = etrafında  
wollen — ich/er will — wollte = istemek  
vor = önce  
was = ne  
sehr = çok  
jeder = her  
groß = büyük  
einfach = basit  
mal = bir kez  
der Mensch = insan  
der andere = diğer  
kein = hiçbir  
Deutschland = Almanya  
mein = benim  
sagen — gesagt = söylemek  
doch = yine de  
viel = çok  
sehen — er sieht — gesehen = görmek  
wieder = tekrar  
über = üzerinde  
wer = kim  
weil = çünkü  
sollen — ich/er soll — sollte — sollte = gerekmek  
bis = kadar  
müssen — ich/er muss — musste — müsste = zorunda olmak  
neu = yeni  
heute = bugün  
natürlich = tabii ki  
uns = bizi  
finden — gefunden = bulmak  
unser = bizim  
denn = çünkü  
aller = tüm  
mir = bana  
wirklich = gerçekten  
eigentlich = aslında  
durch = boyunca  
der erste = ilk  
die Stadt = şehir  
seit = -den beri  
deutsch = Alman  
wo = nerede  
die Welt = dünya  
die Leute = insanlar  
der Tag = gün  
stehen — gestanden = durmak  
die Zeit = zaman  
damit = böylece  
mich = beni  
wissen — gewusst = bilmek  
arbeiten — gearbeitet = çalışmak  
klein = küçük  
leben — gelebt = yaşamak  
alt = eski  
wichtig = önemli  
das Kind = çocuk  
eben = işte  
erst = ilk  
etwas = bir şey  
rund = yuvarlak  
sondern = ama  
halt = dur  
das Haus = ev  
dafür = bunun için  
das Beispiel = örnek  
selbst = kendisi  
schön = güzel  
nehmen — er nimmt — genommen = almak  
denken an {Akk.} — gedacht = düşünmek  
bekommen — bekommen = almak  
ohne = -siz  
das Leben = hayat  
bleiben — ist geblieben = kalmak  
heißen — geheißen = denmek  
du = sen  
eigen = kendi  
dabei = bu sırada  
unter = altında  
liegen — gelegen = yatmak  
vielleicht = belki  
zeigen — gezeigt = göstermek  
gerade = tam şimdi  
das Land = ülke  
der Euro = euro  
weniger = daha az  
hoch = yüksek  
glauben an {Akk.} — geglaubt = inanmak  
drei = üç  
brauchen — gebraucht = ihtiyaç duymak  
richtig = doğru  
die Frau = kadın  
lang = uzun  
gar = hiç  
tun — getan = yapmak  
schaffen — geschafft = başarmak  
fast = neredeyse  
dürfen — ich/er darf — durfte — dürfte = izinli olmak  
ob = eğer  
weit = uzak  
dazu = buna  
ihn = onu  
möchten — ich/er möchte = istemek  
der Teil = parça  
schnell = hızlı  
genau = tam olarak  
bauen — gebaut = inşa etmek  
die Million = milyon  
gehören zu {Dat.} — gehört = ait olmak  
lassen — er lässt — gelassen = bırakmak  
sogar = hatta  
das Prozent = yüzde  
fahren — er fährt — ist gefahren = gitmek (araçla)  
jung = genç  
die Familie = aile  
das Problem = problem  
bringen — gebracht = getirmek  
der letzte = son  
der Ort = yer  
weiter = daha fazla  
die Idee = fikir  
das Wasser = su  
der Berliner = Berlinli  
nie = asla  
der nächste = bir sonraki  
ab = -den itibaren  
haben — er hat — gehabt = sahip olmak  
das Auto = araba  
nichts = hiçbir şey  
das Geld = para  
dort = orada  
einmal = bir kez  
weltweit = dünya çapında  
das Ende = son  
ihnen = onlara  
oft = sık sık  
vier = dört  
der Mann = adam  
besonders = özellikle  
ein bisschen = biraz  
die Woche = hafta  
irgendwie = bir şekilde  
lernen — gelernt = öğrenmek  
versuchen — versucht = denemek  
spielen — gespielt = oynamek  
die Geschichte = tarih / hikaye  
zurück = geri  
die Arbeit = iş
Europa = Avrupa  
davon = bundan  
kennen — gekannt = tanımak  
der Meter = metre  
einiger = bazı  
gegen = karşı  
die Stunde = saat  
schwer = ağır  
zusammen = birlikte  
der Fall = durum  
die Straße = sokak  
der Weg = yol  
entstehen — ist entstanden = ortaya çıkmak  
der Monat = ay  
halten — er hält — gehalten = tutmak  
das Mal = kez  
setzen {sich} — gesetzt = oturmak  
spät = geç  
anders = farklı  
beide = her ikisi  
ihm = ona  
stellen — gestellt = koymak  
die Musik = müzik  
deshalb = bu yüzden  
echt = gerçek  
fünf = beş  
gleich = aynı  
pro = başına  
das Bild = resim  
das Tier = hayvan  
führen — geführt = yönetmek  
stark = güçlü  
tatsächlich = gerçekten  
treffen {sich} — er trifft — getroffen = buluşmak  
die Sache = şey  
die Schule = okul  
warum = neden  
solcher = böyle  
sprechen — er spricht — gesprochen = konuşmak  
zehn = on  
helfen — er hilft — geholfen = yardım etmek  
verkaufen — verkauft = satmak  
früh = erken  
der Meister = usta  
das Unternehmen = şirket  
fühlen {sich} — gefühlt = hissetmek  
manchmal = bazen  
überhaupt = hiç  
der Kunde = müşteri  
entwickeln {sich} — entwickelt = geliştirmek  
etwa = yaklaşık  
mancher = bazı  
ein paar = birkaç  
zwischen = arasında  
die Art = tür  
das Jahrhundert = yüzyıl  
bereits = zaten  
kaum = neredeyse hiç  
klar = açık  
lang = uzun  
ne = değil mi  
nutzen — genutzt = kullanmak  
die Region = bölge  
bissch = biraz  
deswegen = bu yüzden  
erleben — erlebt = deneyimlemek  
toll = harika  
der Freund = arkadaş  
die Zukunft = gelecek  
essen — er isst — gegessen = yemek  
der Platz = yer  
der Spaß = eğlence  
schwierig = zor  
nun = şimdi  
beginnen — begonnen = başlamak  
deutsch = Alman  
sogenannter = sözde  
suchensuchen nach {Akk.} — gesucht = aramak  
zwar = gerçi  
die Grenze = sınır  
das Team = takım  
damals = o zamanlar  
darauf = üzerine  
selber = kendisi  
welcher = hangi  
ziehen — gezogen = çekmek  
der Anfang = başlangıç  
passieren — ist passiert = olmak  
verschieden = farklı  
das Gefühl = his  
der Raum = oda  
erreichen — erreicht = ulaşmak  
gerne = memnuniyetle  
sonst = yoksa  
kaufen — gekauft = satın almak  
laufen — er läuft — ist gelaufen = koşmak  
produzieren — produziert = üretmek  
trotzdem = yine de  
der Besucher = ziyaretçi  
das Ding = şey  
die Firma = firma  
die Hand = el  
der Kilometer = kilometre  
euch = size  
leicht = kolay  
möglich = mümkün  
verändern {sich} — verändert = değiştirmek  
der Moment = an  
während = sırasında  
die Angst = korku  
mittlerweile = bu arada  
die Natur = doğa  
allein = yalnız  
dadurch = bu sayede  
gelten — gegolten = geçerli olmak  
die Generation = nesil  
der Grund = neden  
eher = daha çok  
fallen — er fällt — ist gefallen = düşmek  
funktionieren — funktioniert = çalışmak  
das Stück = parça  
am = -de/-da  
sitzen — ist gesessen = oturmak  
unterwegs = yolda  
wenig = az  
wohl = iyi  
die Herausforderung = meydan okuma  
der Kopf = kafa  
die Seite = sayfa  
das Thema = konu  
fertig = hazır  
fragen — gefragt = sormak  
der Gast = misafir  
das Ziel = hedef  
darüber = üzerinde  
direkt = doğrudan  
komplett = tamamen  
schauen — geschaut = bakmak  
die Form = şekil  
das Projekt = proje  
die Wohnung = daire  
her = buraya  
sechs = altı  
sorgen für {Akk.} — gesorgt = endişelenmek  
bewegen {sich} — bewegt = hareket etmek  
bieten — geboten = sunmak  
kosten — gekostet = mal olmak  
rein = içeri  
sicher = güvenli  
überall = her yerde  
hinter = arkasında  
kurz = kısa  
tragen — er trägt — getragen = taşımak  
voll = dolu  
der Baum = ağaç  
die Eltern = ebeveynler  
die Mutter = anne  
die Tradition = gelenek  
herstellen — hergestellt = üretmek  
je = hiç  
lieben — geliebt = sevmek  
oben = yukarıda  
sozusagen = adeta  
steigen — ist gestiegen = yükselmek  
wegen = nedeniyle  
der Krieg = savaş  
die Kunst = sanat  
allerdings = ancak  
dauern — gedauert = sürmek  
hören — gehört = duymak  
meinen — gemeint = demek istemek  
merken — gemerkt = fark etmek  
das Dorf = köy  
das Museum = müze  
aussehen — ausgesehen = görünmek  
beliebt = popüler  
daran = ona  
extrem = aşırı  
gemeinsam = birlikte  
insgesamt = toplamda  
modern = modern  
verlieren — verloren = kaybetmek  
das Fleisch = et  
die Frage = soru  
teuer = pahalı  
verstehen — verstanden = anlamak  
der zweite = ikinci  
der Berg = dağ  
der Job = iş  
okay = tamam  
der Vater = baba  
darum = bu yüzden  
einzig = tek  
erzählen — erzählt = anlatmak  
mögen — ich/er mag — mochte = sevmek  
die Minute = dakika  
der Mitarbeiter = çalışan  
der Winter = kış  
bekannt = tanınmış  
besonder = özel
erkennen — erkannt = tanımak  
international = uluslararası  
nennen — genannt = adlandırmak  
normal = normal  
die Erfahrung = deneyim  
die Heimat = vatan  
die Technik = teknoloji  
hin = oraya  
jemand = birisi  
statt = yerine  
der Grad = derece  
der Künstler = sanatçı  
der Markt = pazar  
der Tourist = turist  
kriegen — gekriegt = almak  
raus = dışarı  
wachsen — ist gewachsen = büyümek  
ziemlich = oldukça  
die Energie = enerji  
das Foto = fotoğraf  
die Richtung = yön  
alle = herkes  
bestimmt = kesinlikle  
europäisch = Avrupa  
irgendwann = bir ara  
verbinden — verbunden = bağlamak  
der Blick = bakış  
das Buch = kitap  
die Möglichkeit = imkan  
der Name = isim  
knapp = kıt  
los = başlamak  
mehrere = birkaç  
quasi = adeta  
schlecht = kötü  
der Alltag = günlük hayat  
das Geschäft = iş  
frei = özgür  
freuen {sich} über / auf {Akk.} — gefreut = sevinmek  
gucken — geguckt = bakmak  
inzwischen = bu arada  
schreiben — geschrieben = yazmak  
stecken — gesteckt = sokmak  
verdienen — verdient = kazanmak  
wohnen — gewohnt = yaşamak  
die Hilfe = yardım  
der Preis = fiyat  
das Produkt = ürün  
das Restaurant = restoran  
das Schloss = kale  
der Schüler = öğrenci  
die USA = ABD  
die Ukraine = Ukrayna  
das Video = video  
digital = dijital  
erhalten — erhalten = korumak  
genießen — genossen = keyfini çıkarmak  
kämpfen — gekämpft = savaşmak  
persönlich = kişisel  
tanzen — getanzt = dans etmek  
das Licht = ışık  
der Sport = spor  
bedeuten — bedeutet = anlamına gelmek  
berühmt = ünlü  
bevor = önce  
drin = içinde  
egal = fark etmez  
entdecken — entdeckt = keşfetmek  
gleichzeitig = aynı zamanda  
neben = yanında  
sieben = yedi  
vorher = önceden  
ändern — geändert = değiştirmek  
die Situation = durum  
die Uhr = saat  
bald = yakında  
bezahlen — bezahlt = ödemek  
einige = bazı  
irgendwo = bir yerde  
offen = açık  
ungefähr = yaklaşık  
das Bier = bira  
das Gebäude = bina  
das Jahrzehnt = on yıl  
die Nähe = yakınlık  
die Person = kişi  
der Schweizer = İsviçreli  
der Wald = orman  
aktuell = güncel  
fehlen — gefehlt = eksik olmak  
genauso = aynı şekilde  
gewinnen — gewonnen = kazanmak  
hoffen auf {Akk.} — gehofft = ummak  
sozial = sosyal  
stammen — gestammt = köken almak  
vergangen = geçmiş  
zumindest = en azından  
öffentlich = kamuya açık  
die Farbe = renk  
das Glück = şans  
die Menge = miktar  
die Rolle = rol  
draußen = dışarıda  
erfolgreich = başarılı  
frisch = taze  
holen — geholt = getirmek  
kümmern sich — gekümmert = ilgilenmek  
laut = yüksek sesle  
perfekt = mükemmel  
reichen — gereicht = yeterli olmak  
scheinen — geschienen = görünmek  
schützen — geschützt = korumak  
selten = nadiren  
traditionell = geleneksel  
vorstellen sich — vorgestellt = tanıtmak  
warten auf {Akk.} — gewartet = beklemek  
die Gruppe = grup  
die Hauptstadt = başkent  
der Kollege = meslektaş  
der Traum = rüya  
anfangen — angefangen = başlamak  
bisher = şimdiye kadar  
daraus = bundan  
deutlich = belirgin  
dir = sana  
gern = memnuniyetle  
passen zu {Dat.} — gepasst = uymak  
relativ = göreceli  
schmecken — geschmeckt = tatmak  
täglich = günlük  
wirken — gewirkt = etkilemek  
wünschen — gewünscht = dilemek  
der Boden = zemin  
die Chance = şans  
China = Çin  
die Figur = figür  
das Holz = ahşap  
der Punkt = nokta  
die Regel = kural  
acht = sekiz  
bestehen — bestanden = oluşmak  
hart = sert  
klassisch = klasik  
nein = hayır  
weg = uzak  
zahlen — gezahlt = ödemek  
das Auge = göz  
die Gesellschaft = toplum  
die Höhe = yükseklik  
das Medium = medya  
die Politik = politika  
der Sinn = anlam  
die Tonne = ton  
der Wiener = Viyanalı  
der Zug = tren  
dich = seni  
gesamt = toplam  
lassen — er lässt — gelassen = bırakmak  
schließen — geschlossen = kapatmak  
wahrscheinlich = muhtemelen  
die Ausstellung = sergi  
die Marke = marka  
der Schnee = kar  
die Sprache = dil  
alleine = yalnız  
bayerisch = Bavyeralı  
daher = bu yüzden  
danach = sonra  
drehen — gedreht = döndürmek  
entscheiden — entschieden = karar vermek  
fest = sabit  
genug = yeterli  
schlagen — geschlagen = vurmak  
schließlich = sonuçta  
sofort = hemen  
vorbei = bitmiş  
zusätzlich = ek olarak  
die Alpen = Alpler  
das Brot = ekmek  
das Internet = internet  
die Miete = kira  
die Mitte = orta  
die Nacht = gece  
das Schiff = gemi  
die Weise = şekil  
betreiben — betrieben = işletmek  
eng = dar  
erfahren — erfahren = deneyimli  
feiern — gefeiert = kutlamak  
lesen — er liest — gelesen = okumak  
miteinander = birlikte  
nah = yakın  
regelmäßig = düzenli  
verlassen — er verlässt — verlassen = terk etmek  
die Information = bilgi  
absolut = kesinlikle  
außerdem = ayrıca  
beobachten — beobachtet = gözlemlemek  
nachhaltig = sürdürülebilir  
neun = dokuz
obwohl = rağmen  
riesig = devasa  
tief = derin  
total = tamamen  
unterschiedlich = farklı  
völlig = tamamen  
der Bereich = alan  
der Bewohner = sakin  
der Dom = katedral  
das Eis = buz  
das Fahrzeug = araç  
Gott = tanrı  
die Kirche = kilise  
die Kultur = kültür  
das Modell = model  
das Netz = ağ  
die Reise = seyahat  
die Schweiz = İsviçre  
der Strom = akım  
Venedig = Venedik  
Wien = Viyana  
aufgrund = nedeniyle  
drauf = üzerinde  
ehemalig = eski  
erklären — erklärt = açıklamak  
gelingen — gelungen = başarmak  
gründen — gegründet = kurmak  
halb = yarım  
legen — gelegt = koymak  
sagen — gesagt = söylemek  
der Beruf = meslek  
der König = kral  
Paris = Paris  
die Regierung = hükümet  
die Stelle = yer  
der Trend = eğilim  
erinnern {sich} an {Akk.} — erinnert = hatırlamak  
hängen — gehangen = asılmak  
langsam = yavaş  
liefern — geliefert = teslim etmek  
mindestens = en az  
na = peki  
niemand = hiç kimse  
politisch = politik  
unterstützen — unterstützt = desteklemek  
zerstören — zerstört = yok etmek  
zunächst = öncelikle  
die Aufgabe = görev  
der Betrieb = işletme  
der Bus = otobüs  
das Gericht = mahkeme  
das Material = malzeme  
die Ruhe = sükunet  
der Schritt = adım  
die Studie = çalışma  
bereit = hazır  
besonders = özellikle  
gewiss = kesin  
leiten — geleitet = yönetmek  
meist = çoğunlukla  
meistens = çoğunlukla  
mitten = ortasında  
neu = yeni  
seitdem = o zamandan beri  
speziell = özel  
spüren — gespürt = hissetmek  
umgehen — umgegangen = başa çıkmak  
verwenden — verwendet = kullanmak  
vorbereiten — vorbereitet = hazırlamak  
zählen — gezählt = saymak  
übernehmen — übernommen = üstlenmek  
der Arzt = doktor  
die Bevölkerung = nüfus  
die Bewegung = hareket  
die Bühne = sahne  
der Einsatz = kullanım  
der Einwohner = sakin  
die Hälfte = yarısı  
die Landschaft = manzara  
die Meinung = fikir  
die Pandemie = pandemi  
die Pause = mola  
der Sommer = yaz  
die Türkei = Türkiye  
ankommen — ist angekommen = varmak  
backen — gebacken = pişirmek  
bitte = lütfen  
dagegen = buna karşı  
darunter = altında  
einst = bir zamanlar  
gefährlich = tehlikeli  
grün = yeşil  
heutzutage = günümüzde  
innerhalb = içinde  
klingen — geklungen = ses çıkarmak  
leisten — geleistet = başarmak  
planen — geplant = planlamak  
plötzlich = aniden  
reden — geredet = konuşmak  
starten — gestartet = başlamak  
sterben — er stirbt — ist gestorben = ölmek  
stolz = gururlu  
technisch = teknik  
treten — getreten = basmak  
unglaublich = inanılmaz  
wahr = doğru  
überlegen — überlegt = düşünmek  
die App = uygulama  
der Beton = beton  
das Datum = tarih  
der Druck = baskı  
die Entscheidung = karar  
die Erde = dünya  
der Erfolg = başarı  
der Fisch = balık  
die Folge = sonuç  
der Geschmack = tat  
das Instrument = enstrüman  
der Kontakt = iletişim  
die Lösung = çözüm  
das Muss = zorunluluk  
die Produktion = üretim  
das Schnitzel = şinitzel  
beschäftigen — beschäftigt = meşgul etmek  
einzeln = tek tek  
entsprechend = uygun  
historisch = tarihi  
häufig = sıkça  
leider = maalesef  
längst = uzun zamandır  
möglichst = mümkün olduğunca  
teilweise = kısmen  
trotz = rağmen  
typisch = tipik  
öffnen — geöffnet = açmak  
das Fenster = pencere  
der Film = film  
das Gesicht = yüz  
der Lehrer = öğretmen  
die Liebe = aşk  
das Spiel = oyun  
das Werk = eser  
anschauen — angeschaut = izlemek  
besuchen — besucht = ziyaret etmek  
britisch = İngiliz  
ganz = tamamen  
lieb = sevgili  
lieber = tercihen  
nachdem = sonra  
privat = özel  
sammeln — gesammelt = toplamak  
schwarz = siyah  
testen — getestet = test etmek  
ähnlich = benzer  
die Ausbildung = eğitim  
das Bauwerk = yapı  
der Chef = şef  
der Döner = döner  
der Fan = hayran  
Frankreich = Fransa  
das Hotel = otel  
die Kamera = kamera  
die Kuh = inek  
die Küche = mutfak  
die Leidenschaft = tutku  
die Pflanze = bitki  
der Sohn = oğul  
die Sorge = endişe  
der Spargel = kuşkonmaz  
der Star = yıldız  
der Wert = değer  
der Westen = batı  
das Wort = kelime  
die Zahl = sayı  
bunt = renkli  
derzeit = şu anda  
ehrlich = dürüst  
endlich = nihayet  
erfinden — erfunden = icat etmek  
fangen — gefangen = yakalamak  
fliegen — ist geflogen = uçmak  
fotografieren — fotografiert = fotoğraf çekmek  
gebären — geboren = doğurmak  
handeln — gehandelt = hareket etmek  
interessant = ilginç  
per = başına  
rufen — gerufen = çağırmak  
stattfinden — stattgefunden = gerçekleşmek  
teilen — geteilt = paylaşmak  
vergessen — er vergisst — vergessen = unutmak  
vermitteln — vermittelt = iletmek  
weiß = beyaz  
die Anlage = tesis  
Bayern = Bavyera  
die Behörde = yetkili  
die Brücke = köprü  
die Entwicklung = gelişim  
Hallo = merhaba  
der Herr = bey  
das Herz = kalp
die Karriere = kariyer  
das Kilo = kilo  
die Milch = süt  
die Milliarde = milyar  
der Morgen = sabah  
München = Münih  
Russland = Rusya  
der Vorteil = avantaj  
Weihnachten = Noel  
das Zentrum = merkez  
das Zuhause = ev  
aufbauen — aufgebaut = inşa etmek  
dritter = üçüncü  
entfernen — entfernt = kaldırmak  
eröffnen — eröffnet = açmak  
gering = az  
momentan = şu anda  
normalerweise = normalde  
positiv = pozitif  
praktisch = pratik  
russisch = Rus  
studieren — studiert = okumak  
ständig = sürekli  
verbringen — verbracht = geçirmek  
Österreich = Avusturya  
überzeugen — überzeugt = ikna etmek  
Corona = korona  
Deutsch = Almanca  
das Essen = yemek  
der Experte = uzman  
das Fahrrad = bisiklet  
die Fahrt = yolculuk  
der Fuß = ayak  
das Gesetz = yasa  
die Größe = büyüklük  
die Maschine = makine  
die Mode = moda  
die Polizei = polis  
der Schutz = koruma  
der Stoff = kumaş  
die Tour = tur  
die Wahl = seçim  
der Weihnachtsbaum = Noel ağacı  
bestimmen — bestimmt = belirlemek  
bewusst = bilinçli  
folgen — gefolgt = takip etmek  
französisch = Fransızca  
glücklich = mutlu  
günstig = uygun  
reagieren auf {Akk.} — reagiert = tepki vermek  
retten — gerettet = kurtarmak  
spannend = heyecan verici  
trinken — getrunken = içmek  
wunderbar = harika  
zwölf = on iki  
der Bau = inşaat  
die Branche = sektör  
der Bruder = erkek kardeş  
der Club = kulüp  
das Dach = çatı  
das Ergebnis = sonuç  
Italien = İtalya  
der Körper = vücut  
der Landwirt = çiftçi  
das Lebensmittel = gıda  
das Meer = deniz  
das Motiv = motif  
der Nachbar = komşu  
die Qualität = kalite  
die Strecke = mesafe  
super = süper  
das System = sistem  
der Tisch = masa  
der Unterschied = fark  
die Verbindung = bağlantı  
das Vorbild = örnek  
der Wunsch = istek  
die Zutat = malzeme  
bilden — gebildet = oluşturmak  
eins = bir  
erwarten — erwartet = beklemek  
finden — gefunden = bulmak  
fällen — gefällt = düşürmek  
gestalten — gestaltet = tasarlamak  
global = küresel  
interessieren für {Akk.} — interessiert = ilgilenmek  
investieren — investiert = yatırım yapmak  
lösen — gelöst = çözmek  
offiziell = resmi  
organisieren — organisiert = organize etmek  
probieren — probiert = denemek  
streng = sıkı  
tausend = bin  
türkisch = Türkçe  
vegan = vegan  
verarbeiten — verarbeitet = işlemek  
verbessern — verbessert = iyileştirmek  
wesentlich = önemli  
wirtschaftlich = ekonomik  
zahlreich = çok sayıda  
der Bauer = çiftçi  
der Besuch = ziyaret  
die Botschaft = elçilik  
die Freiheit = özgürlük  
die Gefahr = tehlike  
das Konzept = konsept  
das Kostüm = kostüm  
die Luft = hava  
der Mieter = kiracı  
die Moschee = cami  
das Mädchen = kız  
der Norden = kuzey  
der Park = park  
die Pizza = pizza  
die Schokolade = çikolata  
die Show = gösteri  
der Staat = devlet  
der Stein = taş  
die Stimme = ses  
Tausend = bin  
der Tourismus = turizm  
der Urlaub = tatil  
der Weihnachtsmann = Noel baba  
der Weltkrieg = dünya savaşı  
anbieten — angeboten = teklif etmek  
begeistert = heyecanlı  
bereiten — vorbereitet = hazırlamak  
betreffen — betroffen = ilgilendirmek  
davor = önünde  
dein = senin  
dran = üzerinde  
einsetzen — eingesetzt = kullanmak  
erzeugen — erzeugt = üretmek  
faszinierend = büyüleyici  
gut = iyi  
hierher = buraya  
kalt = soğuk  
landen — gelandet = inmek  
morgens = sabahları  
nämlich = yani  
stimmen — gestimmt = oy vermek  
unbedingt = kesinlikle  
verteilen — verteilt = dağıtmak  
warm = sıcak  
weiterhin = devam ederek  
wählen — gewählt = seçmek  
zuerst = önce  
überleben — überlebt = hayatta kalmak  
das Alter = yaş  
das Angebot = teklif  
der Auftrag = görev  
Belgien = Belçika  
Großbritannien = Büyük Britanya  
das Handy = cep telefonu  
das Insekt = böcek  
der Kauf = satın alma  
die Kosten = maliyet  
das Model = model  
der Musiker = müzisyen  
die Plattform = platform  
der Protest = protesto  
der Quadratmeter = metrekare  
das Recht = hak  
das Rezept = reçete  
der Schuh = ayakkabı  
die Spur = iz  
der Tanz = dans  
der Ton = ton  
das Tor = kale  
das Training = antrenman  
die Umwelt = çevre  
der Vergleich = karşılaştırma  
das Wetter = hava  
aktiv = aktif  
aufwachsen — ist aufgewachsen = büyümek  
entfernt = uzak  
füllen — gefüllt = doldurmak  
greifen — gegriffen = tutmak  
irgendwas = bir şey  
jedoch = ancak  
jährlich = yıllık  
kennenlernen — kennengelernt = tanışmak  
lohnen — gelohnt = değmek  
profitieren — profitiert = faydalanmak  
schlimm = kötü  
sparen — gespart = tasarruf etmek  
verschwinden — ist verschwunden = kaybolmak  
wandern — ist gewandert = yürüyüş yapmak  
wechseln — gewechselt = değiştirmek  
üben — geübt = pratik yapmak  
die Architektur = mimari  
Asien = Asya  
der Auftritt = performans  
der Brite = İngiliz  
das Büro = ofis  
das Erlebnis = deneyim  
die Flasche = şişe  
das Gegenteil = zıt  
das Geheimnis = sır  
Indien = Hindistan
die Insel = ada  
das Interesse = ilgi  
die Lage = durum  
die Leistung = performans  
die Masse = kütle  
der Nationalpark = ulusal park  
der Patient = hasta  
Polen = Polonya  
der Roman = roman  
der Salat = salata  
die Seele = ruh  
der Song = şarkı  
die Steuer = vergi  
die Unterstützung = destek  
das Zimmer = oda  
aufnehmen — aufgenommen = kaydetmek  
sich befinden — sich befunden = bulunmak  
entwerfen — entworfen = tasarlamak  
fordern — gefordert = talep etmek  
hinten = arkada  
hinterher = ardından  
integrieren — integriert = entegre etmek  
jugendliche = genç  
lustig = eğlenceli  
mitnehmen — mitgenommen = yanına almak  
nahe = yakın  
nötig = gerekli  
rauchen — geraucht = sigara içmek  
rot = kırmızı  
schlafen — er schläft — geschlafen = uyumak  
schätzen — geschätzt = takdir etmek  
super = süper  
ukrainisch = Ukraynalı  
unabhängig = bağımsız  
unten = aşağıda  
verantwortlich = sorumlu  
vertrauen — vertraut = güvenmek  
wann = ne zaman  
zweimal = iki kez  
übrig = kalan  
die Alternative = alternatif  
die Altstadt = eski şehir  
die Antwort = cevap  
die Behinderung = engellilik  
die Brezel = pretzel  
der Bürger = vatandaş  
der Computer = bilgisayar  
das Detail = detay  
das Element = element  
der Engel = melek  
das Feld = alan  
die Fläche = yüzey  
der Gedanke = düşünce  
das Gemüse = sebze  
das Gespräch = konuşma  
das Handwerk = el sanatları  
die Industrie = endüstri  
die Kraft = güç  
der Käse = peynir  
der Laden = dükkan  
der Liter = litre  
die Mauer = duvar  
die Nachfrage = talep  
die Nummer = numara  
der Passagier = yolcu  
das Patent = patent  
der Plan = plan  
das Ruhrgebiet = Ruhr bölgesi  
die Schwester = kız kardeş  
der See = göl  
die Sicherheit = güvenlik  
das Umfeld = çevre  
der Unterricht = ders  
das Virus = virüs  
der Wanderer = gezgin  
der Wasserstoff = hidrojen  
die Werkstatt = atölye  
abends = akşamları  
ausprobieren — ausprobiert = denemek  
bedrohen — bedroht = tehdit etmek  
beispielsweise = örneğin  
dahinter = arkasında  
definitiv = kesinlikle  
dienen — gedient = hizmet etmek  
einzigartig = eşsiz  
falsch = yanlış  
fein = ince  
froh = mutlu  
heraus = dışarı  
inspirieren — inspiriert = ilham vermek  
kreativ = yaratıcı  
rechnen — gerechnet = hesaplamak  
schicken — geschickt = göndermek  
sicherlich = kesinlikle  
stoßen — gestoßen = çarpmak  
verbieten — verboten = yasaklamak  
verhindern — verhindert = engellemek  
vermutlich = muhtemelen  
verrückt = çılgın  
zuvor = önceden  
österreichisch = Avusturyalı  
der Abend = akşam  
der Arbeitsplatz = iş yeri  
der Architekt = mimar  
der Brandenburger = Brandenburglu  
der Brief = mektup  
Celsius = santigrat  
der Designer = tasarımcı  
das Fest = festival  
das Feuer = ateş  
der Flughafen = havaalanı  
der Garten = bahçe  
der Golf = golf  
die Haut = cilt  
der Inhalt = içerik  
der Karneval = karnaval  
das Klima = iklim  
das Konzert = konser  
die Krise = kriz  
die Maske = maske  
die Oberfläche = yüzey  
das Paar = çift  
der Partner = ortak  
der Politiker = politikacı  
der Rohstoff = ham madde  
die Runde = tur  
das Schwein = domuz  
der Stress = stres  
der Student = öğrenci  
der Teilnehmer = katılımcı  
der Test = test  
die Tochter = kız evlat  
die Tür = kapı  
die Variante = varyant  
die Vielfalt = çeşitlilik  
der Walzer = vals  
die Wand = duvar  
die Wolle = yün  
die Wurzel = kök  
ausschließlich = yalnızca  
begeistern — begeistert = heyecanlandırmak  
begleiten — begleitet = eşlik etmek  
brechen — er bricht — gebrochen = kırmak  
chinesisch = Çinli  
darin = içinde  
derselbe = aynı  
desto = o kadar  
durchaus = kesinlikle  
ersetzen — ersetzt = yerine koymak  
festhalten — festgehalten = tutmak  
feststellen — festgestellt = tespit etmek  
heben — gehoben = kaldırmak  
heimisch = yerli  
klappen — geklappt = başarmak  
kochen — gekocht = pişirmek  
kreieren — kreiert = yaratmak  
leiden — gelitten = acı çekmek  
niederländisch = Hollandalı  
nördlich = kuzey  
professionell = profesyonel  
servieren — serviert = servis etmek  
tot = ölü  
trainieren — trainiert = antrenman yapmak  
versorgen — versorgt = sağlamak  
warnen — gewarnt = uyarmak  
weder = ne de  
wär = sıcak  
übrigens = bu arada  
das Alphorn = alp kornosu  
das Ausland = yurt dışı  
das Bett = yatak  
die Börse = borsa  
die DDR = Doğu Almanya  
die Erfindung = icat  
das Flugzeug = uçak  
das Gas = gaz  
die Gegend = bölge  
das Geräusch = ses  
die Großstadt = büyük şehir  
Hamburg = Hamburg  
der Junge = erkek çocuk  
die Kleidung = giysi  
das Kunstwerk = sanat eseri  
der Kölner = Kölnlü  
der Lauf = koşu  
der Lebkuchen = zencefilli kurabiye  
der Motor = motor  
der Mut = cesaret  
die Möbel = mobilya  
nee = hayır  
die Niederlande = Hollanda  
das Phänomen = fenomen  
der Rest = kalan  
das Salz = tuz  
die Sicht = görüş  
die Szene = sahne  
der Süden = güney  
die Temperatur = sıcaklık  
der Tunnel = tünel  
der Verein = dernek
die Verfügung = emir / kullanım  
die Wirtschaft = ekonomi  
anlegen — angelegt = yatırım yapmak  
anstrengend = yorucu  
außen = dışarı  
beruflich = mesleki  
bestellen — bestellt = sipariş vermek  
billig = ucuz  
bislang = şimdiye kadar  
dennoch = yine de  
drinnen = içeride  
ernst = ciddi  
früher = eskiden  
gegenüber = karşısında  
gemütlich = rahat  
heutig = bugünkü  
irgendein = herhangi bir  
kontrollieren — kontrolliert = kontrol etmek  
malen — gemalt = boyamak  
mischen — gemischt = karıştırmak  
nachts = geceleri  
präsentieren — präsentiert = sunmak  
reduzieren — reduziert = azaltmak  
singen — gesungen = şarkı söylemek  
ungewöhnlich = alışılmadık  
verfolgen — verfolgt = takip etmek  
verzichten — verzichtet = vazgeçmek  
virtuell = sanal  
wunderschön = muhteşem  
zuständig = sorumlu  
das Bein = bacak  
das Blatt = yaprak  
die Bäckerei = fırın  
cool = havalı  
die Currywurst = currywurst  
das Dirndl = dirndl  
die Ecke = köşe  
der Eindruck = izlenim  
die Erinnerung = anı  
der Fehler = hata  
der Flüchtling = mülteci  
die Fotografie = fotoğrafçılık  
die Gemeinde = belediye  
die Gesundheit = sağlık  
das Glas = bardak  
der Glühwein = ısıtılmış şarap  
das Haar = saç  
der Hintergrund = arka plan  
das Hobby = hobi  
die Hoffnung = umut  
der Händler = satıcı  
der Impfstoff = aşı  
der Kaiser = imparator  
der Kampf = mücadele  
das Kilogramm = kilogram  
die Klasse = sınıf  
die Kohle = kömür  
das Krankenhaus = hastane  
die Krankheit = hastalık  
der Kurs = kurs  
die Lust = istek  
das Mitglied = üye  
das Mittel = araç  
das Objekt = nesne  
online = çevrimiçi  
die Partei = parti  
das Prinzip = ilke  
das Publikum = izleyici  
die Realität = gerçeklik  
die Ressource = kaynak  
die Sammlung = koleksiyon  
das Schweden = İsveç  
die Sekunde = saniye  
das Smartphone = akıllı telefon  
die Spende = bağış  
das Stroh = saman  
das Studium = eğitim  
die Technologie = teknoloji  
die Verantwortung = sorumluluk  
der Verkehr = trafik  
das Vorurteil = önyargı  
die Ware = mal  
die Welle = dalga  
die Werbung = reklam  
der Wind = rüzgar  
der Wissenschaftler = bilim insanı  
das Wochenende = hafta sonu  
der Wolf = kurt  
der Zucker = şeker  
angehen — angegangen = ele almak  
anschließend = ardından  
ansonsten = aksi takdirde  
aufgeben — aufgegeben = vazgeçmek  
aufstellen — aufgestellt = kurmak  
außerhalb = dışında  
beibringen — beigebracht = öğretmek  
beitragen — beigetragen = katkıda bulunmak  
belgisch = Belçikalı  
benutzen — benutzt = kullanmak  
circa = yaklaşık  
dahin = oraya  
entscheidend = belirleyici  
erforschen — erforscht = araştırmak  
errichten — errichtet = inşa etmek  
extra = ekstra  
gesund = sağlıklı  
herrschen — geherrscht = hüküm sürmek  
krank = hasta  
langfristig = uzun vadeli  
letztendlich = sonuçta  
links = sol  
motivieren — motiviert = motive etmek  
mussten — gemusst = zorunda kalmak  
nebenan = yanında  
niedrig = düşük  
niemals = asla  
ruhig = sakin  
sauber = temiz  
scharf = keskin  
scheitern — gescheitert = başarısız olmak  
selbstverständlich = tabii ki  
sichtbar = görünür  
süß = tatlı  
transportieren — transportiert = taşımak  
treiben — getrieben = sürüklemek  
trocken = kuru  
veröffentlichen — veröffentlicht = yayımlamak  
vorne = önde  
öfter = daha sık  
der Abstand = mesafe  
das Album = albüm  
der Alkohol = alkol  
die Aussicht = manzara  
die Band = grup  
die Basis = temel  
die Bedingung = koşul  
das Bewusstsein = bilinç  
das Bord = kenar  
Brasilien = Brezilya  
die Burg = kale  
der Cent = sent  
der Dank = teşekkür  
der Dollar = dolar  
das Drittel = üçte bir  
das Ei = yumurta  
der Fahrer = sürücü  
der Finger = parmak  
die Freude = sevinç  
das Geschenk = hediye  
der Hersteller = üretici  
die Herstellung = üretim  
der Hof = avlu  
Indonesien = Endonezya  
die Institution = kurum  
die KI (Künstliche Intelligenz) = yapay zeka  
der Kaugummi = sakız  
der King = kral  
der Klang = ses  
der Klimawandel = iklim değişikliği  
Köln = Köln  
die Lehrerin = öğretmen (kadın)  
der Look = görünüm  
der Mythos = mit  
das Oktoberfest = Oktoberfest  
das Original = orijinal  
der Post = posta  
das Risiko = risk  
der Rücken = sırt  
der Schaden = hasar  
der Schnitt = kesim  
der Schwarzwald = Kara Orman  
das Ski = kayak  
der Stil = stil  
das Studio = stüdyo  
das Symbol = sembol  
der Teig = hamur  
der Tod = ölüm  
die Umfrage = anket  
der Umsatz = ciro  
der Ursprung = köken  
das Viertel = çeyrek  
die Vorstellung = sunum  
der Wagen = araba  
das Wahrzeichen = simge  
der Weihnachtsmarkt = Noel pazarı  
der Wein = şarap  
achten — geachtet = saygı göstermek  
analog = analog  
anderthalb = bir buçuk  
aufmerksam = dikkatli  
bearbeiten — bearbeitet = işlemek  
behaupten — behauptet = iddia etmek  
benötigen — benötigt = gerektirmek  
dank = sayesinde  
derjenige = o  
dokumentieren — dokumentiert = belgelemek  
einstellen — eingestellt = işe almak  
elf = on bir  
entspannen — entspannt = rahatlamak  
entweder = ya ... ya da
ermöglichen — ermöglicht = mümkün kılmak  
faszinieren — fasziniert = büyülemek  
fertigen — gefertigt = üretmek  
fliehen — ist geflohen = kaçmak  
fürchten — gefürchtet = korkmak  
geraten — geraten = tavsiye etmek  
gewöhnen — gewöhnt = alışmak  
heiß = sıcak  
hinaus = dışarı  
hundert = yüz  
immerhin = en azından  
interessiert = ilgili  
konzentrieren sich — konzentriert = odaklanmak  
laden — geladen = yüklemek  
leer = boş  
magisch = büyülü  
maximal = maksimum  
mitmachen — mitgemacht = katılmak  
mobil = mobil  
passend = uygun  
real = gerçek  
recht = doğru  
reich = zengin  
reisen — gereist = seyahat etmek  
rennen — ist gerannt = koşmak  
runter = aşağı  
schneiden — geschnitten = kesmek  
schön = güzel  
sodass = öyle ki  
stören — gestört = rahatsız etmek  
trauen — getraut = güvenmek  
träumen von {Dat.} — geträumt = rüya görmek  
ursprünglich = orijinal  
verletzen — verletzt = yaralamak  
werfen — er wirft — geworfen = atmak  
wertvoll = değerli  
zeichnen — gezeichnet = çizmek  
zukünftig = gelecekteki  
überraschen — überrascht = şaşırtmak  
Afrika = Afrika  
die Agentur = ajans  
der Arbeitgeber = işveren  
die Bahn = tren  
der Bahnhof = tren istasyonu  
die Baustelle = inşaat alanı  
das Bulgarien = Bulgaristan  
der Bundestag = Federal Meclis  
das Dia = slayt  
der Durchschnitt = ortalama  
die EU = AB  
der Effekt = etki  
einfach = basit  
das Erbe = miras  
der Februar = şubat  
der Flug = uçuş  
die Forschung = araştırma  
das Frankfurt = Frankfurt  
die Gemeinschaft = topluluk  
das Grundeinkommen = temel gelir  
die Haltung = tutum  
der Hamburger = hamburger  
der Handwerker = zanaatkar  
die Heimatstadt = memleket  
die Identität = kimlik  
die Innenstadt = şehir merkezi  
Japan = Japonya  
der Kanal = kanal  
der Kebab = kebap  
die Kollektion = koleksiyon  
der Krebs = yengeç burcu  
Leipzig = Leipzig  
die Lokomotive = lokomotif  
die Macht = güç  
das Mehl = un  
der Müll = çöp  
die Nachricht = haber  
der Oldtimer = klasik araba  
Pakistan = Pakistan  
der Pariser = Parisli  
die Party = parti  
Potsdam = Potsdam  
das Programm = program  
der Rock = kaya  
die Schicht = katman  
die Spezialität = uzmanlık  
die Sportart = spor dalı  
die Spree = Spree Nehri  
der Start = başlangıç  
die Suche = arama  
das Tal = vadi  
der Teller = tabak  
der Termin = randevu  
der Turm = kule  
der Tänzer = dansçı  
der User = kullanıcı  
der VW = Volkswagen  
die Vergangenheit = geçmiş  
der Verkauf = satış  
die Veränderung = değişim  
der Volkswagen = Volkswagen  
die Weihnachtsgurke = Noel salatalığı  
das Wohnzimmer = oturma odası  
die Zeichnung = çizim  
der Zirkus = sirk  
der Zustand = durum  
der Abgeordnete = milletvekili  
anpassen sich — angepasst = uyum sağlamak  
austauschen — ausgetauscht = değiş tokuş etmek  
bedienen — bedient = hizmet etmek  
beeindrucken — beeindruckt = etkilemek  
beeindruckend = etkileyici  
beeinflussen — beeinflusst = etkilemek  
behalten — behalten = tutmak  
der Bekannte = tanıdık  
berühren — berührt = dokunmak  
beweisen — bewiesen = kanıtlamak  
diskutieren — diskutiert = tartışmak  
erstmal = önce  
erwachsen = yetişkin  
ewig = sonsuz  
exportieren — exportiert = ihraç etmek  
genügend = yeterli  
herkommen — gekommen = gelmek  
indem = -erek  
innen = içeride  
insbesondere = özellikle  
insofern = bu anlamda  
kaputt = bozuk  
offensichtlich = açıkça  
recyceln — recycelt = geri dönüştürmek  
schwimmen — geschwommen = yüzmek  
sowohl = hem  
spanisch = İspanyol  
treu = sadık  
umsetzen — umgesetzt = uygulamak  
verwandeln — verwandelt = dönüştürmek  
vorhanden = mevcut  
wahrnehmen — wahrgenommen = algılamak  
weitergehen — weitergegangen = devam etmek  
wert = değer  
wiederum = yine  
willkommen = hoş geldiniz  
das Abenteuer = macera  
die Anerkennung = takdir  
die Armee = ordu  
der Artikel = makale  
die Auswirkung = etki  
die Bank = banka  
der Bauch = karın  
der Beginn = başlangıç  
der Beitrag = katkı  
die Belastung = yük  
die Beziehung = ilişki  
der Bezug = ilişki  
die Blüte = çiçek  
die Brauerei = bira fabrikası  
das Bundesland = eyalet  
der Bürgermeister = belediye başkanı  
die Community = topluluk  
das Design = tasarım  
die Diagnose = teşhis  
der Diesel = dizel  
Düsseldorf = Düsseldorf  
die Ehre = onur  
die Emotion = duygu  
das Ensemble = topluluk  
der Esel = eşek  
das Experiment = deney  
der Follower = takipçi  
die Freundschaft = arkadaşlık  
die Fähigkeit = yetenek  
das Gebiet = bölge  
das Gerät = cihaz  
das Getreide = tahıl  
die Gewalt = şiddet  
Grönland = Grönland  
der Handel = ticaret  
die Initiative = girişim  
die Inspiration = ilham  
der Investor = yatırımcı  
der Keller = bodrum  
der Kredit = kredi  
das Kreuzfahrtschiff = yolcu gemisi  
die Kugel = top  
die Kulisse = dekor  
der Käufer = alıcı  
der Köhler = kömürcü  
die Landwirtschaft = tarım  
der Lohn = maaş  
der Müller = değirmenci  
der Oktober = ekim  
der Pist = tabanca  
der Planet = gezegen  
die Pommes = patates kızartması  
der Rattenfänger = fare avcısı  
der Reichstag = Reichstag  
die Reihe = sıra  
der Rhein = Ren Nehri  
der Sand = kum  
der Schluss = sonuç
die Schwierigkeit = zorluk  
die Schönheit = güzellik  
das Social = sosyal  
die Spitze = zirve  
die Staatsbürgerschaft = vatandaşlık  
die Station = istasyon  
die Stiftung = vakıf  
die Stimmung = ruh hali  
der Supermarkt = süpermarket  
der Trainer = antrenör  
der Verbraucher = tüketici  
die Version = versiyon  
das Volk = halk  
die Vorbereitung = hazırlık  
der West = batı  
die Wildkräuter = yabani otlar  
das Wunder = mucize  
die Wärme = sıcaklık  
das Zeichen = işaret  
der Zufall = tesadüf  
der Zuschauer = izleyici  
ansagen — angesagt = duyurmak  
ansehen — angesehen = izlemek  
anziehen — angezogen = giymek  
arm = fakir  
aufregend = heyecan verici  
aussterben — ausgestorben = nesli tükenmek  
automatisch = otomatik  
außergewöhnlich = olağanüstü  
behandeln — behandelt = tedavi etmek  
beziehen — bezogen = ilişkilendirmek  
blau = mavi  
bloß = sadece  
buchen — gebucht = rezervasyon yapmak  
diverser = çeşitli  
doppelt = iki kat  
drüber = üzerinde  
dunkel = karanlık  
durchschnittlich = ortalama  
dünn = ince  
effizient = verimli  
eingehen — eingegangen = girmek  
einheimisch = yerli  
elektrisch = elektrikli  
empfinden — empfunden = hissetmek  
erfüllen — erfüllt = yerine getirmek  
ergeben — ergeben = sonuçlanmak  
erledigen — erledigt = halletmek  
erschaffen — erschaffen = yaratmak  
fantastik = fantastik  
finanziell = finansal  
fördern — gefördert = desteklemek  
gelangen — gelangt = ulaşmak  
gestern = dün  
gigantisch = devasa  
grundsätzlich = temelde  
haben — er hat — gehabt = sahip olmak  
hauptsächlich = esas olarak  
herausfinden — herausgefunden = bulmak  
herkömmlich = geleneksel  
hinein = içeri  
hinzu = ek olarak  
hochwertig = yüksek kaliteli  
hoffentlich = umarım  
ideal = ideal  
irgendwelcher = herhangi bir  
italienisch = İtalyan  
jahrelang = yıllarca  
kleben — geklebt = yapıştırmak  
kompliziert = karmaşık  
künftig = gelecekte  
künstlich = yapay  
lebend = canlı  
lecker = lezzetli  
lenken — gelenkt = yönlendirmek  
letztlich = sonuçta  
olympisch = olimpik  
regional = bölgesel  
schießen — geschossen = ateş etmek  
sichern — gesichert = güvence altına almak  
sinken — gesenkt = düşmek  
sportlich = sportif  
trennen — getrennt = ayırmak  
umso = o kadar  
unterscheiden — unterschieden = ayırt etmek  
verbreiten — verbreitet = yaymak  
vereinen — vereint = birleştirmek  
vertreiben — vertrieben = dağıtmak  
weich = yumuşak  
widmen — gewidmet = adamak  
zentral = merkezi  
ökologisch = ekolojik  
die Ahnung = fikir  
der Anteil = pay  
der Arbeitnehmer = çalışan  
die Aufmerksamkeit = dikkat  
die Aufnahme = kayıt  
der Ausflug = gezi  
die Autobahn = otoban  
der Autor = yazar  
der Ball = top  
die Bedeutung = anlam  
der Bunker = sığınak  
die Butter = tereyağı  
der Charakter = karakter  
die Diversität = çeşitlilik  
das Dutzend = düzine  
die Ebene = düzlem  
die Fashion = moda  
die Fassade = cephe  
der Forscher = araştırmacı  
der Franzose = Fransız  
das Frühstück = kahvaltı  
das Gefängnis = hapishane  
das Gehalt = maaş  
das Gehirn = beyin  
das Gewicht = ağırlık  
der Gletscher = buzul  
das Gold = altın  
der Großteil = büyük kısım  
der Großvater = büyükbaba  
das Gut = mal  
die Handarbeit = el işi  
hey = hey  
das Highlight = öne çıkan  
der Himmel = gökyüzü  
der Holzmarkt = ahşap pazarı  
die Innovation = yenilik  
die Intelligenz = zeka  
der Juli = temmuz  
die Kartoffel = patates  
die Katastrophe = felaket  
die Kindheit = çocukluk  
der Klassiker = klasik  
der Kontinent = kıta  
die Koralle = mercan  
der Kranich = turna  
die Kräuter = otlar  
das Kurzem = kısa süre  
der Mauerfall = duvarın yıkılışı  
die Maßnahme = önlem  
das Mittelalter = orta çağ  
das Münster = katedral  
das Ohr = kulak  
die Oma = büyükanne  
das Opfer = kurban  
die Option = seçenek  
der Ost = doğu  
das Papier = kağıt  
die Perspektive = perspektif  
das Preußen = Prusya  
der Rassismus = ırkçılık  
der Respekt = saygı  
die Schneekugel = kar küresi  
die Schulter = omuz  
das Spanien = İspanya  
der Spieler = oyuncu  
der Stadtteil = semt  
der Strand = plaj  
die Struktur = yapı  
der Tipp = ipucu  
der Titel = başlık  
der Trick = hile  
die Tänzerin = dansçı  
die Universität = üniversite  
die Veranstaltung = etkinlik  
das Verkehrsmittel = ulaşım aracı  
der Versuch = deneme  
das Wachstum = büyüme  
das Weingut = şarap evi  
der Weizen = buğday  
das Werkzeug = alet  
der Wettbewerb = yarışma  
der Zoo = hayvanat bahçesi  
abbauen — abgebaut = sökmek  
der Angestellte = çalışan  
ausgehen — ausgegangen = dışarı çıkmak  
auskommen — ausgekommen = geçinmek  
ausstatten — ausgestattet = donatmak  
beschreiben — beschrieben = tarif etmek  
besetzen — besetzt = işgal etmek  
beteiligen — beteiligt = katılmak  
betrachten — betrachtet = incelemek  
breit = geniş  
brennen — gebrannt = yanmak  
dankbar = minnettar  
darstellen — dargestellt = temsil etmek  
dauerhaft = kalıcı  
dick = kalın  
diesmal = bu sefer  
ebenfalls = ayrıca  
ebenso = aynı şekilde  
bir yandan = einerseits  
einladen — eingeladen = davet etmek  
enden — geendet = sona ermek  
enorm = muazzam  
enthalten — enthalten = içermek  
entsorgen — entsorgt = bertaraf etmek  
erkunden — erkundet = keşfetmek  
erlauben — erlaubt = izin vermek
erneuerbar = yenilenebilir  
erscheinen — erschienen = görünmek  
exklusiv = özel  
finanzieren — finanziert = finanse etmek  
freiwillig = gönüllü  
geheim = gizli  
geil = harika  
gewaltig = muazzam  
großartig = harika  
grün = yeşil  
herum = etrafında  
jedenfalls = her halükarda  
kehren — gekehrt = dönmek  
mehrfach = birden fazla  
melden — gemeldet = bildirmek  
mutig = cesur  
nachdenken — nachgedacht = düşünmek  
nachher = sonra  
nix = hiçbir şey  
nähen — genäht = dikmek  
polnisch = Polonyalı  
ran = yakın  
reinigen — gereinigt = temizlemek  
richten — gerichtet = yönlendirmek  
schade = yazık  
senken — gesenkt = düşürmek  
sowieso = zaten  
traurig = üzgün  
unmöglich = imkansız  
unterrichten — unterrichtet = öğretmek  
von = -den/-dan  
verdanken — verdankt = borçlu olmak  
verhalten — verhalten = davranmak  
vorsichtig = dikkatli  
wachsend = büyüyen  
wahnsinnig = çılgın  
wenigstens = en azından  
zugleich = aynı zamanda  
übersetzen — übersetzt = çevirmek  
die Aktion = eylem  
der Antrieb = tahrik  
die Anzahl = sayı  
der Apfelstrudel = elmalı turta  
der April = nisan  
der Arbeiter = işçi  
das Atelier = atölye  
der Ausblick = manzara  
das Baujahr = yapım yılı  
der Bayer = Bavyeralı  
der Besitzer = sahip  
das Brandenburg = Brandenburg  
das Brotbier = bira ekmeği  
der Bäcker = fırıncı  
das Chaos = kaos  
der Chinese = Çinli  
das Christkind = Noel bebeği  
die Demokratie = demokrasi  
das Eiweiß = protein  
die Emission = emisyon  
die Etage = kat  
der Fahrgast = yolcu  
die Faszination = büyülenme  
die Flucht = kaçış  
der Fokus = odak  
der Fortschritt = ilerleme  
der Fotograf = fotoğrafçı  
die Freizeit = boş zaman  
der Fund = buluntu  
der Fußball = futbol  
die Galerie = galeri  
der Geburtstag = doğum günü  
der Gegner = rakip  
die Gelegenheit = fırsat  
das Gewürz = baharat  
der Hafen = liman  
die Hast = acele  
der Haushalt = hane halkı  
die Haustür = kapı  
der Hund = köpek  
das Immunsystem = bağışıklık sistemi  
das Island = İzlanda  
der Jakobsweg = Santiago yolu  
der Journalist = gazeteci  
jung = genç  
der Kaffee = kahve  
die Kasse = kasa  
die Kinderarbeit = çocuk işçiliği  
das Kino = sinema  
der Klotz = kütük  
die Konkurrenz = rekabet  
der Konzern = şirket  
die Kälte = soğuk  
das Label = etiket  
der Ladepunkt = şarj noktası  
der Lebensraum = yaşam alanı  
das Leder = deri  
die Linie = hat  
der Macher = yapımcı  
die Media = medya  
der Migrant = göçmen