der Abend — Abende = вечір  
Guten Abend! = Добрий вечір!  
alles = все  
antworten — geantwortet = відповідати  
Sie antworten = Ви відповідаєте  
auch = також  
auf (Akkusativ, Dativ) = на  
aus (Dativ) = з  
Ich komme aus Syrien. = Я приходжу з Сирії.  
die Aussage — Aussagen = твердження  
bisschen = трохи  
Er spricht ein bisschen Englisch. = Він трохи розмовляє англійською.  
bitte = будь ласка  
danke = дякую  
dann = потім  
das = це  
der = той  
Deutsch = німецька  
Ich spreche Deutsch. = Я розмовляю німецькою.  
der Dialog — Dialoge = діалог  
die = та  
Wie geht‘s? = Як справи?  
dir = тобі  
Wie geht es dir? = Як твої справи?  
du = ти  
Bist du aus Polen? = Ти з Польщі?  
ein, eine = один; одна  
die Entschuldigung = вибачення  
er = він  
es = це  
die Form — Formen = форма  
die Frage — Fragen = питання  
fragen — gefragt = питати  
die Frau — Frauen = жінка  
ganz = зовсім; повністю  
Es geht mir ganz gut. = Мені зовсім добре.  
gehen — ist gegangen — ging = йти  
Es geht mir gut. = Мені добре.  
die Grammatik = граматика  
gut — besser — am besten = хороший  
hallo = привіт  
heißen — geheißen = називатися  
Ich heiße Anna. = Мене звати Анна.  
der Herr — Herren = пан  
hören — gehört = чути  
ich = я  
Ihnen = вам  
Wie geht es Ihnen? = Як ваші справи?  
ihr = ви  
im (Dativ) = у  
Fragen Sie im Kurs. = Запитуйте на курсі.  
ja = так  
klar = ясно  
Ja, klar. = Так, ясно.  
kommen — ist gekommen = приходити  
der Kurs — Kurse = курс  
der Kursteilnehmer — Kursteilnehmer = учасник курсу  
die Kursteilnehmerin — Kursteilnehmerinnen = учасниця курсу  
das Land — Länder = країна  
lesen — gelesen — las = читати  
der Mann — Männer = чоловік  
mein, meine = мій; моя  
mit (Dativ) = з  
morgen = завтра  
Bis morgen! = До завтра!  
die Nacht — Nächte = ніч  
Gute Nacht! = Добраніч!  
der Name — Namen = ім’я  
nein = ні  
Nein, danke. = Ні, дякую.  
neu = новий  
nicht = не  
oder = або  
die Person — Personen = особа  
richtig = правильно  
Das ist richtig! = Це правильно!  
der Satz — Sätze = речення  
schreiben — geschrieben — schrieb = писати  
sehr = дуже  
sein — ist gewesen — war = бути  
Seid ihr aus Afghanistan? = Ви з Афганістану?  
sie = вона; вони  
Sie = ви  
so = так  
die Sprache — Sprachen = мова  
sprechen mit (Dativ) über (Akkusativ) — gesprochen — sprach = говорити  
supergut = супердобре  
der Tag — Tage = день  
Guten Tag, Herr Maier. = Добрий день, пане Майєр.  
Tschüss = Бувай  
Tschüss, bis bald! = Бувай, до скорої зустрічі!  
und = і  
was = що  
Was machst du morgen? = Що ти робиш завтра?  
welche = які  
Welche Sprachen sprichst du? = Які мови ти розмовляєш?  
wer = хто  
Wer ist das? = Хто це?  
das Wiedersehen = побачення  
Auf Wiedersehen! = До побачення!  
wie = як  
Wie heißt du? = Як тебе звати?  
wissen — gewusst — wusste = знати  
wo = де  
Wo wohnst du? = Де ти живеш?  
woher = звідки  
Woher kommst du? = Звідки ти?  
das Wort — Wörter = слово  
aber = але  
die Adresse — Adressen = адреса  
alt — älter — am ältesten = старий  
anmelden sich — angemeldet = записуватися  
die Anmeldung = реєстрація  
arbeiten — gearbeitet = працювати  
das Bild — Bilder = зображення  
der Bruder — Brüder = брат  
buchstabieren — buchstabiert = букставати  
dein, deine = твій; твоя  
einmal = один раз  
Noch einmal, bitte. = Ще раз, будь ласка.  
die Eltern (Pl.) = батьки  
falsch = неправильно  
die Familie — Familien = сім’я  
der Familienname — Familiennamen = прізвище  
der Familienstand = сімейний стан  
das Formular — Formulare = бланк  
geschieden = розлучений  
die Geschwister (Pl.) = брати і сестри  
Hast du Geschwister? = У тебе є брати чи сестри?  
haben — hat — gehabt — hatte = мати  
die Handynummer — Handynummern = номер мобільного  
Wie ist deine Handynummer? = Який твій номер мобільного?  
die Hausnummer — Hausnummern = номер будинку  
das Heimatland — Heimatländer = батьківщина  
hier = тут  
Ihr, Ihre = ваш; ваша  
Wie ist Ihre Adresse? = Яка ваша адреса?  
in (Dativ, Akkusativ) = в  
die Information — Informationen = інформація  
das Jahr — Jahre = рік  
jetzt = зараз  
kein, keine = жоден; жодна  
das Kind — Kinder = дитина  
Ich habe keine Kinder. = У мене немає дітей.  
der Kindergarten — Kindergärten = дитячий садок  
der Kontakt — Kontakte = контакт  
leben — gelebt = жити  
Wo lebst du? = Де ти живеш?  
ledig = неодружений; незаміжня  
die E-Mail — E-Mails = електронна пошта  
möchten — gemocht = хотіти  
die Mutter — Mütter = мати  
nach (Dativ) = до  
der Nachname — Nachnamen = прізвище  
noch = ще  
die Postleitzahl — Postleitzahlen = поштовий індекс  
die Schwester — Schwestern = сестра  
die Schwägerin = невістка  
die Schwiegertochter = невістка  
der Schwiegervater = тесть  
der Sohn — Söhne = син  
die Straße — Straßen = вулиця  
die Telefonnummer — Telefonnummern = номер телефону  
die Tochter — Töchter = дочка  
über (Akkusativ) = про  
Der Zug nach Basel fährt über Stuttgart. = Поїзд до Базеля їде через Штутгарт.  
der Vater — Väter = батько  
vergleichen — verglichen = порівнювати  
verheiratet = одружений; заміжня  
Sind Sie verheiratet? = Ви одружені?  
verwitwet = овдовілий; овдовіла  
viel, viele — mehr — am meisten = багато  
Wie viele Kinder haben Sie? = Скільки у вас дітей?  
der Vorname — Vornamen = ім’я  
vorstellen sich — vorgestellt = представлятися  
welcher, welche, welches = який; яка; яке  
willkommen = ласкаво просимо  
Herzlich willkommen! = Сердечно ласкаво просимо!  
wir = ми  
wohnen — gewohnt = жити  
der Wohnort = місце проживання  
die Zahl — Zahlen = число  
zu (Dativ) = до  
Das ist jetzt leider zu spät. = Це, на жаль, тепер запізно.  
also = отже  
an (Dativ, Akkusativ) = на  
Am Samstag ist kein Deutschkurs. = У суботу немає курсу німецької.  
andere = інші  
benutzen — benutzt = використовувати  
das Blatt — Blätter = лист  
der Bleistift — Bleistifte = олівець  
das Buch — Bücher = книга  
da = там  
der Deutschkurs = курс німецької  
Der Deutschkurs ist am Montag. = Курс німецької у понеділок.  
der Dienstag = вівторок  
doch = однак  
der Donnerstag = четвер  
endlich = нарешті  
erklären — erklärt = пояснювати  
erzählen — erzählt = розповідати  
das Familienfoto = сімейне фото  
der Feiertag — Feiertage = свято  
das Fenster = вікно  
das Foto = фото  
der Freitag = п’ятниця  
der Freund — Freunde = друг  
Hast du schon Freunde hier? = У тебе вже є друзі тут?  
für (Akkusativ) = для  
Sie nehmen die Wohnung für 750 Euro. = Вони беруть квартиру за 750 євро.  
genau = точно  
gestern = вчора  
groß = великий  
der Gruß — Grüße = привітання  
Viele Grüße = Багато привітань  
die Hausaufgabe — Hausaufgaben = домашнє завдання  
das Heft — Hefte = зошит  
heute = сьогодні  
ihr = ваш  
immer = завжди  
die Karte — Karten = карта  
klein = маленький  
knifflig = хитромудрий  
der Kugelschreiber (Kuli) — Kugelschreiber = кулькова ручка  
das Kursbuch = підручник курсу  
der Kursraum = аудиторія курсу  
die Lampe — Lampen = лампа  
die Landkarte — Landkarten = карта місцевості  
langsam = повільно  
der Lehrer — Lehrer = вчитель  
die Lehrerin — Lehrerinnen = вчителька  
lernen — gelernt = вчитися  
liebe, lieber = дорогий; дорога  
Liebe Laura, … = Дорога Лауро, …  
die Liste — Listen = список  
machen — gemacht = робити  
mir = мені  
der Mittwoch = середа  
der Montag = понеділок  
natürlich = звісно  
Noch einmal langsam bitte! – Natürlich. = Ще раз повільно, будь ласка! – Звісно.  
nett = приємний  
das Papier = папір  
der Papierkorb = кошик для паперу  
die Pause — Pausen = перерва  
das Problem — Probleme = проблема  
der Projektor = проектор  
der Radiergummi = гумка  
der Raum = кімната  
der Rucksack = рюкзак  
die Sache — Sachen = річ  
sagen — gesagt — sagte = казати  
der Samstag = субота  
sehen — gesehen — sah = бачити  
Was sehen Sie? = Що ви бачите?  
die Seite = сторінка  
der Schlüssel — Schlüssel = ключ  
schnell = швидко  
der Sonntag = неділя  
der Spaß = веселощі  
spielen — gespielt = грати  
Spielen Sie die Dialoge. = Грайте діалоги.  
der Spitzer = точилка  
der Stuhl — Stühle = стілець  
die Tabelle = таблиця  
die Tafel = дошка  
die Tasche = сумка  
der Text = текст  
der Tisch — Tische = стіл  
die Tür = двері  
übermorgen = післязавтра  
die Übung — Übungen = вправа  
das Übungsbuch = робочий зошит  
verstehen — verstanden — verstand = розуміти  
vorgestern = позавчора  
die Wand = стіна  
die Woche = тиждень  
das Wochenende = вихідні  
das Wörterbuch — Wörterbücher = словник  
zeigen — gezeigt = показувати  
der Zettel — Zettel = записка  
zusammen = разом  
Wir gehen zusammen ins Kino. = Ми йдемо разом у кіно.  
Im Supermarkt = У супермаркеті  
das Angebot — Angebote = пропозиція  
die Antwort — Antworten = відповідь  
der Apfel — Äpfel = яблуко  
der Apfelsaft = яблучний сік  
die Aufgabe — Aufgaben = завдання  
die Babynahrung = дитяче харчування  
die Banane — Bananen = банан  
der Becher — Becher = чашка  
ein Becher Joghurt = чашка йогурту  
das Beispiel — Beispiele = приклад  
das Bier = пиво  
die Birne — Birnen = груша  
das Bistro = бістро  
die Blaubeere — Blaubeeren = чорниця  
die Bohne — Bohnen = квасоля  
brauchen — gebraucht = потребувати  
das Brot — Brote = хліб  
das Brötchen — Brötchen = булочка  
der Cent — Cent = цент  
die Cola — Cola, Colas = кола  
der Couscous = кускус  
denn = адже  
diese, dieser, dieses = цей; ця; це  
die Dose — Dosen = банка  
durch (Akkusativ) = через  
das Ei — Eier = яйце  
der Einkaufszettel = список покупок  
einige = деякі  
die Erbse — Erbsen = горох  
die Erdbeere — Erdbeeren = полуниця  
essen — gegessen — aß = їсти  
etwas = щось  
fertig = готовий  
der Fisch — Fische = риба  
die Flasche — Flaschen = пляшка  
das Fleisch = м’ясо  
frisch = свіжий  
das Frühstück = сніданок  
frühstücken — gefrühstückt = снідати  
gemeinsam = разом  
das Gemüse = овочі  
gern = охоче  
Ich esse gern Tomaten. = Я охоче їм помідори.  
das Getränk — Getränke = напій  
das Glas — Gläser = склянка  
gleich = однаковий; відразу  
das Gramm — Gramm = грам  
die Himbeere — Himbeeren = малина  
der Honig = мед  
der Joghurt — Joghurts = йогурт  
der Kaffee = кава  
die Kartoffel — Kartoffeln = картопля  
der Käse = сир  
kaufen — gekauft = купувати  
der Keks — Kekse = печиво  
die Kichererbse — Kichererbsen = нут  
das Kilo — Kilos = кілограм  
die Kirsche — Kirschen = вишня  
die Kiwi — Kiwis = ківі  
die Kontrolle — Kontrollen = контроль  
kosten — gekostet = коштувати  
der Kuchen = торт  
der Kunde — Kunden = клієнт  
die Kundin — Kundinnen = клієнтка  
kurz = короткий  
das Lammfleisch = баранина  
das Lebensmittel — Lebensmittel = продукт харчування  
die Limonade (Limo) — Limonaden (Limos) = лимонад  
der Liter — Liter = літр  
man = хтось  
die Mandarine — Mandarinen = мандарин  
die Mango — Mangos = манго  
der Markt — Märkte = ринок  
die Marmelade — Marmeladen = джем  
das Mehl = борошно  
meistens = здебільшого  
die Mengenangabe = вказівка кількості  
die Melone — Melonen = диня  
die Milch = молоко  
das Milchprodukt — Milchprodukte = молочний продукт  
mögen — gemocht = подобатися  
die Möhre — Möhren = морква  
müssen — gemusst = мусити  
nehmen — genommen — nahm = брати  
die Nudel — Nudeln = локшина  
nur = лише  
das Obst = фрукти  
der Obstsalat = фруктовий салат  
das Olivenöl = оливкова олія  
die Orange — Orangen = апельсин  
ordnen — geordnet = впорядковувати  
die Packung — Packungen = упаковка  
eine Packung Reis = упаковка рису  
die Paprika — Paprikas = перець  
der Partner — Partner = партнер  
die Partnerin — Partnerinnen = партнерка  
das Pfund = фунт  
der Pilz — Pilze = гриб  
planen — geplant = планувати  
der Preis — Preise = ціна  
pro (Akkusativ) = за  
Die Äpfel kosten 2,50 € pro Kilo. = Яблука коштують 2,50 € за кілограм.  
der Pudding = пудинг  
der Reis = рис  
das Rindfleisch = яловичина  
der Saft — Säfte = сік  
die Sahne = вершки  
der Salat — Salate = салат  
das Salz = сіль  
sich = себе  
schmecken — geschmeckt = смакувати  
die Schokolade = шоколад  
schön = гарний  
das Schweinefleisch = свинина  
sonst = інакше  
stehen — ist gestanden — stand = стояти  
streichen — gestrichen = викреслювати  
das Stück — Stücke = шматок  
ein Stück Kuchen = шматок торта  
die Tasse — Tassen = чашка  
der Tee = чай  
teuer = дорогий  
der Tipp — Tipps = порада  
die Tomate — Tomaten = помідор  
die Traube — Trauben = виноград  
trinken — getrunken — trank = пити  
unterstreichen — unterstrichen = підкреслювати  
verbinden — verbunden = з’єднувати  
der Verkäufer — Verkäufer = продавець  
die Verkäuferin — Verkäuferinnen = продавчиня  
von (Dativ) = від  
das Wasser = вода  
der Wein = вино  
die Zitrone — Zitronen = лимон  
der Zucker = цукор  
die Zwiebel — Zwiebeln = цибуля  
Von morgens bis abends = Від ранку до вечора  
abends = увечері  
der Alltag = будні  
anrufen — angerufen — rief an = телефонувати  
Ich rufe dich an. = Я тобі зателефоную.  
die Arbeit = робота  
aufstehen sich — ist sich aufgestanden — stand sich auf = вставати  
beginnen — begonnen — begann = починати  
beide = обидва  
das Bett — Betten = ліжко  
bis (Akkusativ) = до  
das Büro — Büros = офіс  
der Computer — Computer = комп’ютер  
das Computerspiel — Computerspiele = комп’ютерна гра  
erst = спочатку  
Wir lernen erst Deutsch, dann gehen wir spazieren. = Ми спочатку вчимо німецьку, потім гуляємо.  
fernsehen — ferngesehen = дивитися телевізор  
der Film — Filme = фільм  
die Freundin — Freundinnen = подруга  
früh = рано  
der Fußball = футбол  
Ich spiele gern Fußball. = Я охоче граю у футбол.  
geöffnet = відкритий  
grillen — gegrillt = смажити на грилі  
halb = половина  
Es ist halb zwölf. = Зараз пів на дванадцяту.  
der Hunger = голод  
die Idee — Ideen = ідея  
das Interview — Interviews = інтерв’ю  
kochen — gekocht = готувати  
können — gekonnt — konnte = могти  
lecker = смачний  
leider = на жаль  
manchmal = іноді  
der Mittag = полудень  
mittags = опівдні  
die Mittagspause = обідня перерва  
der Morgen = ранок  
morgens = вранці  
müde = втомлений  
die Musik = музика  
der Nachmittag = післяобідній час  
nachmittags = після обіду  
nachts = вночі  
nie = ніколи  
der Notizzettel = нотатка  
oft = часто  
die Pizza = піца  
putzen — geputzt = прибирати  
schade = шкода  
schlafen — geschlafen — schlief = спати  
der Schluss = кінець  
Um eins haben wir Schluss. = О першій у нас кінець.  
die Schule — Schulen = школа  
spät = пізно  
spazieren — ist spazieren gegangen = гуляти  
das Spiel — Spiele = гра  
der Sport = спорт  
die Stunde — Stunden = година  
der Stundenplan = розклад занять  
der Supermarkt = супермаркет  
telefonieren — telefoniert = телефонувати  
tun — getan — tat = робити  
die Uhr = годинник  
Die Uhr steht im Wohnzimmer. = Годинник стоїть у вітальні.  
die Uhrzeit = час  
Es ist 14 Uhr. = Зараз 14 година.  
um (Akkusativ) = о  
der Unterricht = заняття  
das Viertel = чверть  
Es ist Viertel vor zehn. = Зараз чверть до десятої.  
vor (Dativ) = перед  
der Vormittag = передобідній час  
vormittags = до обіду  
wann = коли  
die Wohnung — Wohnungen = квартира  
zeichnen — gezeichnet = малювати  
die Zeit = час  
zu Hause = вдома  
Ich bin zu Hause. = Я вдома.
Auf Wohnungssuche = На пошуки квартири  
ab (Dativ) = від  
Die Wohnung ist ab 1.5. frei. = Квартира вільна з 1 травня.  
der Altbau = стара будівля  
die Angabe — Angaben = інформація  
die Anzeige — Anzeigen = оголошення  
das Arbeitszimmer = робочий кабінет  
das Bad — Bäder = ванна  
baden — gebadet = купатися  
die Badewanne = ванна  
das Badezimmer = ванна кімната  
der Balkon — Balkone = балкон  
der Bauernhof — Bauernhöfe = ферма  
bei (Dativ) = біля  
bekommen — bekommen — bekam = отримувати  
Meine Blumen bekommen jeden Tag Wasser. = Мої квіти отримують воду щодня.  
der Besichtigungstermin = час огляду  
besser = краще  
billig = дешевий  
breit = широкий  
circa = приблизно  
die Diele = передпокій  
direkt = прямо  
dort = там  
draußen = надворі  
dringend = терміново  
dunkel = темний  
die Dusche = душ  
das Einfamilienhaus = односімейний будинок  
einkaufen — eingekauft = купувати  
das Elektrogerät — Elektrogeräte = електроприлад  
das Erdgeschoss = перший поверх  
ersetzen — ersetzt = замінювати  
der Euro — Euros = євро  
der Fernseher — Fernseher = телевізор  
finden — gefunden — fand = знаходити  
die Firma — Firmen = фірма  
der Flur — Flure = коридор  
frei = вільний  
die Garage — Garagen = гараж  
der Garten — Gärten = сад  
der Gast — Gäste = гість  
das Geld — Gelder = гроші  
gemütlich = затишний  
gepflegt = доглянутий  
das Gerät — Geräte = пристрій  
das Geschäft — Geschäfte = магазин  
das Gespräch — Gespräche = розмова  
die Größe = розмір  
grün = зелений  
hängen — gehangen = вішати  
hässlich = потворний  
die Hauptsache = головне  
das Haus — Häuser = будинок  
das Haustier — Haustiere = домашня тварина  
die Heizung = опалення  
helfen — geholfen — half = допомагати  
hell = світлий  
der Herd = плита  
die Hilfe = допомога  
hinten = ззаду  
das Hochhaus = багатоповерхівка  
ihr, ihre = ваш; ваша  
die Immobilie — Immobilien = нерухомість  
insgesamt = загалом  
interessant = цікавий  
jeder, jede, jedes = кожен; кожна; кожне  
der Juni = червень  
die Kaffeemaschine = кавоварка  
kalt = холодний  
die Kaution = застава  
der Keller — Keller = підвал  
das Kinderzimmer = дитяча кімната  
der Kleiderschrank = шафа для одягу  
die Küche — Küchen = кухня  
der Kühlschrank — Kühlschränke = холодильник  
lang = довгий  
lassen — gelassen — ließ = залишати  
Lass uns in einem anderen Geschäft schauen. = Давай подивимося в іншому магазині.  
laut = гучний  
gerne — lieber — am liebsten = охоче  
liegen — ist gelegen — lag = лежати  
Die Wohnung liegt direkt an der Hauptstraße. = Квартира розташована прямо на головній вулиці.  
maximal = максимально  
das Mehrfamilienhaus = багатоквартирний будинок  
die Miete = оренда  
mindestens = щонайменше  
die Möbel (Pl.) = меблі  
möbliert = мебльований  
modern = сучасний  
der Monat — Monate = місяць  
die Monatsmiete — Monatsmieten = місячна оренда  
der Müll = сміття  
neben (Dativ) = поруч  
die Nebenkosten — Nebenkosten = додаткові витрати  
ohne (Akkusativ) = без  
das Obergeschoss = верхній поверх  
der Ort — Orte = місце  
die Pflanze — Pflanzen = рослина  
der Plan — Pläne = план  
der Platz — Plätze = місце  
Wir brauchen mehr Platz. = Нам потрібно більше місця.  
der Quadratmeter — Quadratmeter = квадратний метр  
das Regal — Regale = полиця  
das Reihenhaus = рядовий будинок  
ruhig = тихий  
schauen — geschaut = дивитися  
das Schlafzimmer = спальня  
schmal = вузький  
der Schrank — Schränke = шафа  
der Sessel — Sessel = крісло  
singen — gesungen — sang = співати  
sitzen — gesessen — saß = сидіти  
das Sofa — Sofas = диван  
sofort = негайно  
sollen — gesollt = мусити  
Sollen wir ins Kino gehen? = Чи підемо в кіно?  
das Sonderangebot — Sonderangebote = спеціальна пропозиція  
die Sonne = сонце  
sonstiges = інше  
die Sprachschule = мовна школа  
spülen — gespült = мити (посуд)  
die Spülmaschine — Spülmaschinen = посудомийна машина  
die Stadt — Städte = місто  
suchen — gesucht = шукати  
super = супер  
der Teppich = килим  
die Terrasse — Terrassen = тераса  
die Toilette — Toiletten = туалет  
toll = класний  
die Traumwohnung = квартира мрії  
unbedingt = обов’язково  
ungemütlich = незатишний  
unser, unsere = наш; наша  
warum = чому  
waschen — gewaschen = прати  
die Waschmaschine = пральна машина  
das WC = туалет  
wegziehen — ist weggezogen = переїжджати  
weiter = далі  
wenn = коли  
werden — ist geworden — wurde = ставати  
wichtig = важливий  
die Wohnungsanzeige = оголошення про квартиру  
die Wohnungssuche = пошук квартири  
das Wohnzimmer = вітальня  
wunderschön = чудовий  
wünschen — gewünscht = бажати  
zahlen — gezahlt = платити  
die Zeitung — Zeitungen = газета  
das Zentrum = центр  
das Zimmer — Zimmer = кімната  
zu Fuß = пішки  
In der Stadt unterwegs = По місту  
die Ampel — Ampeln = світлофор  
die Ankunftszeit = час прибуття  
die Ansage — Ansagen = оголошення  
die Apotheke — Apotheken = аптека  
der Arzt — Ärzte = лікар  
die Ärztin — Ärztinnen = лікарка  
die Auskunft = інформація  
außerdem = крім того  
außerplanmäßig = позапланово  
das Auto — Autos = автомобіль  
die Bahn = поїзд  
der Bahnhof — Bahnhöfe = вокзал  
der Ball — Bälle = м’яч  
die Bank = банк  
bezahlen — bezahlt = платити  
die Bibliothek = бібліотека  
das Bürgerbüro = бюро для громадян  
der Bus — Busse = автобус  
die Bushaltestelle — Bushaltestellen = автобусна зупинка  
das Café — Cafés = кафе  
dafür = для цього  
dritte = третій  
die Durchsage = оголошення  
einfach = просто  
die Einzelfahrkarte = одноразовий квиток  
erste = перший  
der Erwachsene — Erwachsenen = дорослий  
fahren — ist gefahren — fuhr = їхати  
der Fahrgast — Fahrgäste = пасажир  
die Fahrkarte = квиток  
das Fahrrad — Fahrräder = велосипед  
fallen — ist gefallen — fiel = падати  
fast = майже  
der Flughafen — Flughäfen = аеропорт  
das Gebäude — Gebäude = будівля  
geben — gegeben — gab = давати  
gegenüber (Dativ) = навпроти  
geradeaus = прямо  
das Gleis — Gleise = колія  
gültig = дійсний  
halten — gehalten — hielt = зупинятися  
die Haltestelle — Haltestellen = зупинка  
der Hauptbahnhof = головний вокзал  
hinter (Dativ) = позаду  
das Hotel — Hotels = готель  
der Informationsschalter = інформаційна стійка  
der Intercity (IC) = міжміський поїзд  
das Jobcenter = центр зайнятості  
das Kino — Kinos = кінотеатр  
die Kirche = церква  
das Krankenhaus — Krankenhäuser = лікарня  
die Krankenkasse = медична страховка  
die Kreuzung = перехрестя  
die Kurzstrecke = коротка відстань  
die Linie = лінія  
links = ліворуч  
die Lösung — Lösungen = рішення  
der Meter — Meter = метр  
der Metzger = м’ясник  
die Minute — Minuten = хвилина  
die Mobilität = мобільність  
das Motorrad — Motorräder = мотоцикл  
nachfragen — nachgefragt = перепитувати  
nächster, nächste, nächstes = наступний; наступна; наступне  
nichts = нічого  
öffentlich = громадський  
die Orientierung = орієнтація  
der Park — Parks = парк  
die Parkgebühr — Parkgebühren = плата за паркування  
der Parkplatz — Parkplätze = парковка  
die Polizei = поліція  
die Position = позиція  
die Post = пошта  
praktisch = практичний  
rechts = праворуч  
das Rathaus = ратуша  
die Regionalbahn = регіональний поїзд  
das Restaurant — Restaurants = ресторан  
die Ruhe = спокій  
der Schienenersatzverkehr = заміна залізничного транспорту  
das Schwimmbad — Schwimmbäder = басейн  
selten = рідко  
sowieso = у будь-якому разі  
später = пізніше  
der Stadtplan — Stadtpläne = план міста  
der Stadtwald = міський ліс  
steigen — ist gestiegen — stieg = підніматися  
die Straßenbahn — Straßenbahnen = трамвай  
die Tageskarte = денний квиток  
das Taxi — Taxis = таксі  
überall = всюди  
umsteigen — ist umgestiegen = пересідати  
ungefähr = приблизно  
unter (Dativ) = під  
die Verfügung = розпорядження  
das Verkehrsmittel — Verkehrsmittel = транспортний засіб  
verstanden = зрозуміло  
verzögern — verzögert = затримувати  
die Volkshochschule (VHS) = народний університет  
voll = повний  
vorbei = повз  
vorne = спереду  
warten — gewartet = чекати  
der Weg = дорога  
der Winter — Winter = зима  
der Wochenmarkt = тижневий ринок  
wohin = куди  
wollen — gewollt = хотіти  
der Zug — Züge = поїзд  
zweimal = двічі  
zweite = другий  
zwischen (Dativ) = між  
anfangen — angefangen — fing an = починати  
der Arbeitstag — Arbeitstage = робочий день  
die Ausbildung — Ausbildungen = навчання  
ausfüllen — ausgefüllt = заповнювати  
die Aushilfe — Aushilfen = помічник  
der Automechaniker = автомеханік  
die Automechanikerin = автомеханік (жінка)  
backen — gebacken = пекти  
der Bäcker = пекар  
die Bäckerin = пекарка  
bald = скоро  
berichten — berichtet = повідомляти  
der Beruf — Berufe = професія  
beruflich = професійний  
die Bürokauffrau = офісна працівниця  
der Bürokaufmann = офісний працівник  
der Chef — Chefs = шеф  
die Chefin — Chefinnen = шефиня  
das Computerprogramm — Computerprogramme = комп’ютерна програма  
das Computersystem — Computersysteme = комп’ютерна система  
dauern — gedauert = тривати  
dreimal = тричі  
der Fahrer — Fahrer = водій  
fangen — gefangen — fing = ловити  
der Feierabend = кінець робочого дня  
flexibel = гнучкий  
fotografieren — fotografiert = фотографувати  
freundlich = дружній  
der Führerschein = водійські права  
der Fußballspieler = футболіст  
die Gitarre — Gitarren = гітара  
halbtags = неповний робочий день  
die Hausfrau — Hausfrauen = домогосподарка  
der Hausmann — Hausmänner = домогосподар  
der Hund — Hunde = собака  
installieren — installiert = встановлювати  
die Kantine — Kantinen = їдальня  
kaputt = зламаний  
die Kasse — Kassen = каса  
der Kassierer = касир  
die Kassiererin — Kassiererinnen = касирка  
die Kauffrau = продавчиня  
der Kellner — Kellner = офіціант  
die Kellnerin — Kellnerinnen = офіціантка  
klingeln — geklingelt = дзвонити  
der Koch — Köche = кухар  
die Köchin — Köchinnen = кухарка  
der Kollege — Kollegen = колега  
die Kollegin — Kolleginnen = колежанка  
das Konzert — Konzerte = концерт  
korrigieren — korrigiert = виправляти  
das Kraftfahrzeug (KFZ) = автомобіль  
der Krankenpfleger — Krankenpfleger = медбрат  
die Krankenschwester — Krankenschwestern = медсестра  
kreativ = креативний  
langweilig = нудний  
die Leute (Pl.) = люди  
die Mathematik = математика  
der Mechaniker — Mechaniker = механік  
der Mensch — Menschen = людина  
das Mittagessen = обід  
der Moment — Momente = момент  
der Musiklehrer = вчитель музики  
die Musiklehrerin = вчителька музики  
der Nachtdienst = нічна зміна  
organisieren — organisiert = організовувати  
der Pizzafahrer = доставник піци  
die Pizzeria = піцерія  
die Pflege = догляд  
prüfen — geprüft = перевіряти  
pünktlich = пунктуальний  
das Radio — Radios = радіо  
rechnen — gerechnet = рахувати  
der Rentner — Rentner = пенсіонер  
die Reparatur = ремонт  
reparieren — repariert = ремонтувати  
der Reporter = репортер  
der Roman — Romane = роман  
schlimm = поганий  
der Schüler — Schüler = учень  
die Schülerin — Schülerinnen = учениця  
servieren — serviert = подавати  
der Stress = стрес  
der Student — Studenten = студент  
die Studentin — Studentinnen = студентка  
studieren — studiert = навчатися  
der Taxifahrer = таксист  
die Taxifahrerin = таксистка  
der Techniker = технік  
das Telefon — Telefone = телефон  
der Traumberuf = професія мрії  
treffen — getroffen — traf = зустрічати  
die Universität — Universitäten = університет  
unterrichten — unterrichtet = викладати  
vielleicht = можливо  
wählen — gewählt = обирати  
die Werkstatt = майстерня  
das Wiederhören = до чуттів  
Auf Wiederhören! = До чуттів!  
zuerst = спочатку  
Beim Arzt = У лікаря  
das Altenpflegeheim = будинок для літніх людей  
anbei = у додатку  
die Anrede = звертання  
Sehr geehrter Herr Maier, … = Шановний пане Майєр, …  
der Arm — Arme = рука  
atmen — geatmet = дихати  
das Auge — Augen = око  
der Bauch = живіт  
das Bein — Beine = нога  
die Bauchschmerzen (Pl.) = біль у животі  
der Bescheid = повідомлення  
Ich sage dir Bescheid. = Я тобі повідомлю.  
die Besserung = покращення  
Gute Besserung! = Швидкого одужання!  
der Betreff = тема  
bevor = перед тим як  
bleiben — ist geblieben — blieb = залишатися  
der Brief — Briefe = лист  
der Briefteil — Briefteile = частина листа  
die Brust = груди  
danach = після цього  
das Datum = дата  
dürfen — gedurft = мати дозвіл  
der Ellbogen/Ellenbogen = лікоть  
der Empfänger — Empfänger = отримувач  
das Entschuldigungsschreiben = лист-вибачення  
erkälten sich — erkältet = застудитися  
die Erkältung = застуда  
euer, eure = ваш; ваша  
das Fieber = лихоманка  
der Finger — Finger = палець  
freundlich = дружній  
Mit freundlichen Grüßen = З найкращими побажаннями  
geehrter, geehrte = шановний; шановна  
Sehr geehrte Frau Müller, … = Шановна пані Мюллер, …  
das Gesicht = обличчя  
die Gesundheit = здоров’я  
die Gesundheitskarte = медична картка  
die Grippe = грип  
die Gruppe — Gruppen = група  
das Haar — Haare = волосся  
der Hals = горло  
der Hals-Nasen-Ohren-Arzt (HNO) = лор  
das Halsweh = біль у горлі  
die Hand — Hände = рука  
der Hausarzt — Hausärzte = сімейний лікар  
heiß = гарячий  
der Husten = кашель  
Hustensaft = сироп від кашлю  
das Knie — Knie = коліно  
der Kopf — Köpfe = голова  
die Kopfschmerzen (Pl.) = головний біль  
der Körper — Körper = тіло  
der Körperteil — Körperteile = частина тіла  
krank = хворий  
die Krankheit = хвороба  
die Krankmeldung = повідомлення про хворобу  
der März = березень  
das Medikament — Medikamente = ліки  
der Mund = рот  
der Nacken = шия  
die Nase = ніс  
die Notfallsprechstunde = екстрений прийом  
das Ohr — Ohren = вухо  
der Orthopäde = ортопед  
der Patient — Patienten = пацієнт  
die Patientin — Patientinnen = пацієнтка  
per = через  
das Pflaster — Pflaster = пластир  
das Praktikum — Praktika = практика  
die Praktikumsbetreuerin = кураторка практики  
die Praxis — Praxen = практика; кабінет  
die Praxisgemeinschaft = спільна практика  
rauchen — geraucht = курити  
regelmäßig = регулярно  
das Rezept — Rezepte = рецепт  
rot = червоний  
der Rücken = спина  
rund = круглий  
die Salbe — Salben = мазь  
schicken — geschickt = надсилати  
der Schmerz — Schmerzen = біль  
der Schnupfen = нежить  
die Schulter — Schultern = плече  
schwanger = вагітна  
sein, seine = його  
die Sprechstunde = години прийому  
die Sprechstundenhilfe = помічниця на прийомі  
das Sprechzimmer = кабінет прийому  
stark = сильний  
die Stirn = лоб  
die Tablette — Tabletten = таблетка  
der Termin — Termine = призначення  
der Tropfen — Tropfen = крапля  
die Unterschrift = підпис  
die Untersuchung = обстеження  
der Verband = пов’язка  
verschieden = різний  
die Vorsorge = профілактика  
das Wartezimmer = приймальня  
der Wechsel = зміна  
wechseln — gewechselt = змінювати  
wehtun — wehgetan — tat weh = боліти  
wieder = знову  
wiederkommen — ist wiedergekommen = повертатися  
der Zahn — Zähne = зуб  
der Zeh — Zehen = палець ноги  
zurzeit = наразі  
Gestern und heute = Вчора і сьогодні  
aufwachsen — ist aufgewachsen = виростати  
beantworten — beantwortet = відповідати  
der Besuch = візит  
die Bewegung — Bewegungen = рух  
bilden — gebildet = формувати  
die Blume — Blumen = квітка  
der Dienst = служба  
extra = додатково  
das Ferienhaus — Ferienhäuser = дача  
früher = раніше  
sein/wurden geboren — ist/wurde geboren — war = народитися  
Ich bin in Kabul geboren. = Я народився в Кабулі.  
gerade = щойно  
gucken — geguckt = дивитися  
der Hausflur = під’їзд  
heiraten — geheiratet = одружуватися  
das Hobby — Hobbys = хобі  
der Ingenieur = інженер  
die Insel — Inseln = острів  
die Inselrundfahrt = тур островом  
kennen — gekannt = знати  
der Koffer — Koffer = валіза  
letzte = останній  
das Meer = море  
der Mond = місяць  
der Nachbar — Nachbarn = сусід  
die Nachbarin — Nachbarinnen = сусідка  
die Natur = природа  
packen — gepackt = пакувати  
die Postkarte — Postkarten = листівка  
die Reise — Reisen = подорож  
das Schiff — Schiffe = корабель  
der Seehund — Seehunde = тюлень  
der Ski = лижа  
der Strand — Strände = пляж  
stressig = стресовий  
das Studium = навчання  
stundenlang = годинами  
die Suppe — Suppen = суп  
süß = солодкий  
das Tennis = теніс  
der Tourist — Touristen = турист  
unregelmäßig = нерегулярно  
der Urlaub = відпустка  
verdienen — verdient = заробляти  
warten — gewartet = чекати  
das Wetter = погода  
Wir gehen shoppen! = Ми йдемо за покупками!  
anziehen — angezogen — zog an = одягати  
der Anzug — Anzüge = костюм  
beige = бежевий  
bequem = зручний  
besser = краще  
bestimmt = напевно  
blau = синій  
blöd = дурний  
die Bluse — Blusen = блузка  
braun = коричневий  
bringen — gebracht — brachte = приносити  
denken an (Akkusativ) — gedacht — dachte = думати  
der Einkaufsbummel = прогулянка за покупками  
eng = тісний  
euch = вас  
die Farbe — Farben = колір  
furchtbar = жахливий  
gefallen — ist gefallen — gefiel = подобатися  
Die Bluse gefällt mir. = Мені подобається ця блузка.  
gegenseitig = взаємно  
gelb = жовтий  
genauso = так само  
glauben an (Akkusativ) — geglaubt = вірити  
grau = сірий  
günstig = вигідний  
das Hemd — Hemden = сорочка  
die Hose — Hosen = штани  
ihm = йому  
die Jacke — Jacken = куртка  
die Jeans — Jeans = джинси  
der Jogginganzug = спортивний костюм  
der Kassenbon = чек  
das Kaufhaus — Kaufhäuser = універмаг  
die Klamotten (Pl.) = одяг  
klasse = класний  
das Kleid — Kleider = сукня  
die Kleidung — Kleidung = одяг  
das Kleidungsstück — Kleidungsstücke = предмет одягу  
lila = бузковий  
der Mantel — Mäntel = пальто  
die Mode = мода  
das Modell = модель  
die Mütze = шапка  
online = онлайн  
die Ordnung = порядок  
Das ist in Ordnung. = Це нормально.  
das Paar — Paare = пара  
passen — gepasst = пасувати  
positiv = позитивний  
probieren — probiert = приміряти  
der Prospekt — Prospekte = проспект  
der Pullover = светр  
raten — geraten — riet = радити  
der Rock = спідниця  
der Schal = шарф  
der Schuh — Schuhe = взуття  
schwarz = чорний  
sicher = впевнений  
die Socke — Socken = шкарпетка  
der Sportschuh = спортивне взуття  
die Strickjacke = кофта  
der Strumpf — Strümpfe = панчоха  
tragen — getragen — trug = носити  
das T-Shirt — T-Shirts = футболка  
typisch = типовий  
überhaupt = взагалі  
umtauschen — umgetauscht = обмінювати  
uns = нас  
vergessen — vergessen — vergaß = забувати  
der Wintermantel = зимове пальто  
zurück = назад  
Endlich Frühling! = Нарешті весна!  
die Achtung = увага  
Achtung! = Увага!  
der April = квітень  
aufregen sich — aufgeregt = хвилюватися  
Ich bin ganz aufgeregt. = Я дуже схвильований.  
der August = серпень  
bauen — gebaut = будувати  
der Baum — Bäume = дерево  
besuchen — besucht = відвідувати  
bewölkt = хмарно  
die Braut — Bräute = наречена  
der Dank = подяка  
Vielen Dank! = Дуже дякую!  
darüber = про це  
die Deutschlandkarte = карта Німеччини  
der Dezember = грудень  
eben = щойно  
Na, da muss es eben ein Freitag sein. = Ну, тоді це має бути п’ятниця.  
einladen — eingeladen = запрошувати  
die Einladung = запрошення  
einverstanden = згоден  
das Eis = лід  
der Februar = лютий  
die Feier — Feiern = святкування  
feiern — gefeiert = святкувати  
das Fest — Feste = свято  
freuen sich auf (Akkusativ) — gefreut = радіти  
froh = радісний  
Frohe Ostern! = Щасливого Великодня!  
der Frühling = весна  
fühlen — gefühlt = відчувати  
die Gartenparty — Gartenpartys = вечірка в саду  
der Geburtstag = день народження  
die Geburtstagstorte = торт на день народження  
das Geschenk — Geschenke = подарунок  
glücklich = щасливий  
der Glückstag = щасливий день  
der Grad = градус  
hageln — gehagelt = град йде  
Es hagelt. = Йде град.  
der Handschuh — Handschuhe = рукавичка  
der Hase = заєць  
der Herbst = осінь  
die Himmelsrichtung — Himmelsrichtungen = напрямок неба  
die Hochzeit — Hochzeiten = весілля  
die Hochzeitsfeier = весільне святкування  
die Jahreszahl = рік (число)  
die Jahreszeit — Jahreszeiten = пора року  
der Januar = січень  
der Juli = липень  
der Kalender — Kalender = календар  
lieben — geliebt = любити  
der Luftballon — Luftballons = повітряна куля  
lustig = веселий  
der Mai = травень  
die Mama = мама  
minus = мінус  
Es sind minus 15 Grad. = Мінус 15 градусів.  
mitbringen — mitgebracht — brachte mit = приносити з собою  
nass = мокрий  
nebelig = туманний  
der Norden = північ  
der November = листопад  
nun = тепер  
der Oktober = жовтень  
das Oktoberfest = Октоберфест  
die Oma = бабуся  
der Osten = схід  
das Osterei — Ostereier = пасхальне яйце  
das Osterfest = Великдень  
der Osterhase = пасхальний заєць  
das Ostern = Великдень  
der Papa = тато  
räumen — geräumt = прибирати  
reden — geredet = розмовляти  
regnen — geregnet = дощить  
Es regnet. = Йде дощ.  
samstags = по суботах  
der Schatz = скарб  
scheinen — geschienen — schien = світити  
Die Sonne scheint. = Сонце світить.  
schenken — geschenkt = дарувати  
schlecht = поганий  
der Schnee = сніг  
der Schneemann = сніговик  
schneien — geschneit = сніжити  
Es schneit. = Йде сніг.  
der Schokoladenkuchen = шоколадний торт  
der Sekt = ігристе вино  
der September = вересень  
der Sommer = літо  
sonnig = сонячно  
die Spezialität — Spezialitäten = спеціалітет  
das Standesamt = РАЦС  
stellen — gestellt = ставити  
der Süden = південь  
tanzen — getanzt = танцювати  
der Teller — Teller = тарілка  
die Torte — Torten = торт  
trocken = сухий  
unglücklich = нещасливий  
der Unglückstag = нещасливий день  
warm = теплий  
das Weihnachten = Різдво  
der Weihnachtsbaum — Weihnachtsbäume = ялинка  
die Weihnachtsfeier = різдвяна вечірка  
das Weihnachtsgeschenk = різдвяний подарунок  
der Weihnachtsmann = Санта-Клаус  
das Westdeutschland = Західна Німеччина  
der Westen = захід  
der Wetterbericht = прогноз погоди  
wieso = чому  
Chatten, mailen, sich informieren = Чатити, писати листи, дізнаватися  
die Abendkasse = вечірня каса  
abholen — abgeholt = забирати  
aktuell = актуальний  
alle = усі  
anklicken — angeklickt = клікати  
die App = додаток  
aussuchen — ausgesucht = вибирати  
der Benutzername = ім’я користувача  
bestellen — bestellt = замовляти  
chatten — gechattet = чатити  
die Datei — Dateien = файл  
dich = тебе  
diskutieren — diskutiert = обговорювати  
drucken — gedruckt = друкувати  
der Eintritt — Eintritte = вхід  
empfehlen — empfohlen = рекомендувати  
die Empfehlung — Empfehlungen = рекомендація  
flirten — geflirtet = фліртувати  
der Flohmarkt — Flohmärkte = блошиний ринок  
das Forum = форум  
funktionieren — funktioniert = працювати  
gebraucht = вживаний  
googeln — gegoogelt = гуглити  
herausfinden — herausgefunden — fand heraus = дізнаватися  
herunterladen — heruntergeladen = завантажувати  
hochladen — hochgeladen = вивантажувати  
informieren sich — informiert = дізнаватися  
international = міжнародний  
das Internet = інтернет  
das Kennwort — Kennwörter = пароль  
die Kinokarte = квиток у кіно  
klicken — geklickt = клікати  
der Kommentar — Kommentare = коментар  
kostenlos = безкоштовно  
das Kulturcafé = культурне кафе  
der/die Leser/in = читач; читачка  
löschen — gelöscht = видаляти  
mailen — gemailt = надсилати пошту  
mich = мене  
mitkommen — ist mitgekommen — kam mit = приєднуватися  
Kommen deine Eltern mit? = Твої батьки приєднаються?  
mitmachen — mitgemacht = брати участь  
nachschauen — nachgeschaut = перевіряти  
Schauen wir doch mal im Internet nach. = Давай подивимося в інтернеті.  
der Neffe = племінник  
nervös = нервовий  
Newsletter = інформаційний бюлетень  
oben = зверху  
die Politik = політика  
prima = чудово  
das Programm — Programme = програма  
die Radtour — Radtouren = велопрогулянка  
der Regen = дощ  
der Regenschirm = парасолька  
die Reihenfolge = послідовність  
reservieren — reserviert = бронювати  
die Reservierung = бронювання  
die Rolle — Rollen = роль  
sinken — ist gesunken — sank = тонути  
das Smartphone = смартфон  
speichern — gespeichert = зберігати  
das Spielzeug = іграшка  
starten — gestartet = починати  
die Startseite = початкова сторінка  
steigen — ist gestiegen — stieg = підніматися  
das Straßenfest = вуличний фестиваль  
das Symbol — Symbole = символ  
tauschen — getauscht = обмінювати  
die Temperatur — Temperaturen = температура  
das Theater = театр  
der Treffpunkt = місце зустрічі  
unternehmen — unternommen — unternahm = робити  
die Verabredung — Verabredungen = домовленість  
die Veranstaltung — Veranstaltungen = подія  
der Veranstaltungstipp — Veranstaltungstipps = порада щодо події  
der Vorschlag — Vorschläge = пропозиція  
die Welt = світ  
die Wettervorhersage = прогноз погоди  
die Wirtschaft = економіка  
das Würstchen = сосиска  
zeitweise = час від часу  
zuhören — zugehört = слухати  
zuschauen — zugeschaut = дивитися  
Mit Bus und Bahn = На автобусі та поїзді  
abfahren — ist abgefahren — fuhr ab = відправлятися  
die Abfahrt — Abfahrten = відправлення  
ankommen — ist angekommen — kam an = прибувати  
die Ankunft — Ankünfte = прибуття  
der Anschluss = пересадка  
der Anschlusszug — Anschlusszüge = пересадковий поїзд  
ausblenden — ausgeblendet = приховувати  
ausfallen — ist ausgefallen — fiel aus = скасовуватися  
aussteigen — ist ausgestiegen — stieg aus = виходити  
das Autofahren = водіння автомобіля  
der Automat = автомат  
das Bahnfahren = поїздка на поїзді  
der Bahnsteig = платформа  
bitten — gebeten = просити  
buchen — gebucht = бронювати  
die Dauer = тривалість  
defekt = несправний  
deshalb = тому  
drehen — gedreht = повертати  
drüben = там  
die Einfahrt — Einfahrten = в’їзд  
einsteigen — ist eingestiegen — stieg ein = сідати  
erhalten — erhalten = отримувати  
erreichen — erreicht = досягати  
der Fahrkartenschalter = каса квитків  
der Fahrplan — Fahrpläne = розклад  
der Fernbus = міжміський автобус  
fliegen — ist geflogen — flog = літати  
das Flugzeug — Flugzeuge = літак  
der Grund = причина  
der Halt = зупинка  
hin = туди  
die Hinfahrt — Hinfahrten = поїздка туди  
der/die Mitarbeiter/in = працівник; працівниця  
mitnehmen — mitgenommen — nahm mit = брати з собою  
nah = близько  
nämlich = а саме  
die Nummer = номер  
die Option = варіант  
passieren — passiert = відбуватися  
das Pech = невдача  
planmäßig = за планом  
preiswert = недорогий  
die Reisemöglichkeit — Reisemöglichkeiten = можливість подорожі  
das Reiseziel = пункт призначення  
die Richtung — Richtungen = напрямок  
die Rückfahrt — Rückfahrten = поїздка назад  
der/die Schaffner/in = кондуктор; кондукторка  
das Schild — Schilder = табличка  
schwarzfahren — ist schwarzgefahren — fuhr schwarz = їздити без квитка  
schwierig = складний  
der/die Senior/in = літня людина  
der Serviceschalter = сервісна стійка  
sondern = а  
sparen — gespart = економити  
die Station = станція  
die Störung — Störungen = збій  
die Strafe — Strafen = штраф  
die Strecke — Strecken = маршрут  
umsteigen — ist umgestiegen — stieg um = пересідати  
die Umwelt = довкілля  
unterwegs = в дорозі  
die Verbindung — Verbindungen = зв’язок  
verehrt, verehrte = шановний; шановна  
„Verehrte Fahrgäste, achten Sie bitte auf die Durchsagen!“ = „Шановні пасажири, звертайте увагу на оголошення!“  
verpassen — verpasst = пропускати  
verschlafen — verschlafen — verschlief = проспати  
verspätet = із запізненням  
die Verspätung — Verspätungen = затримка  
die Vorsicht = обережність  
wenig = мало  
wohl = мабуть  
die Zeitschrift — Zeitschriften = журнал  
der Zoo = зоопарк  
Unsere neue Wohnung = Наша нова квартира  
ablesen — abgelesen — las ab = зчитувати  
die Ablesung = зчитування  
abstellen — abgestellt = ставити  
Wir stellen das Fahrrad in der Garage ab. = Ми ставимо велосипед у гараж.  
afrikanisch = африканський  
das Altglas = старе скло  
aufschließen — aufgeschlossen = відчиняти  
ausführen — ausgeführt = виконувати  
ausgeben — ausgegeben — gab aus = витрачати  
ausziehen — ist ausgezogen — zog aus = виселятися  
beachten — beachtet = звертати увагу  
bedeuten — bedeutet = означати  
der Beinbruch = перелом ноги  
berufstätig = працюючий  
die Beschwerde — Beschwerden = скарга  
besichtigen — besichtigt = оглядати  
der Bezirk = район  
der Biomüll = біосміття  
die Biotonne = біоконтейнер  
das Brett = дошка  
der Briefkasten — Briefkästen = поштова скринька  
darum = тому  
dass = що  
die Ecke = кут  
die Einbauküche = вбудована кухня  
einrichten — eingerichtet = облаштовувати  
die Einweihungsparty = вечірка з нагоди новосілля  
die Einwurfzeit — Einwurfzeiten = час доставки  
einziehen — ist eingezogen — zog ein = вселятися  
der Einzug = вселення  
entsorgen — entsorgt = утилізувати  
erfolgen — ist erfolgt = відбуватися  
der Fahrradständer = велостійка  
die Fernwärme = централізоване опалення  
das Gas = газ  
Gassi gehen — ist Gassi gegangen — ging Gassi = гуляти з собакою  
Pablo geht mit seinem Hund Gassi. = Пабло гуляє зі своїм собакою.  
gehören — gehört = належати  
gesondert = окремо  
der Glascontainer = контейнер для скла  
der/die Hausbewohner/in = мешканець; мешканка будинку  
der/die Hausmeister/in = доглядач; доглядачка будинку  
die Hausordnung = правила будинку  
die Hausregel — Hausregeln = правило будинку  
die Hausreinigung = прибирання будинку  
die Hausverwaltung = управління будинком  
herzlich = сердечно  
hoch = високий  
Hof = двір  
hoffen — gehofft = сподіватися  
jemand = хтось  
der Kellerzugang = доступ до підвалу  
der Kinderwagen = дитячий візок  
die Kleinmöbel (Pl.) = дрібні меблі  
die Kommode = комод  
kündigen — gekündigt = розривати (договір)  
legen — gelegt = класти  
leidtun — leidgetan — tat leid = шкодувати  
Es tut mir leid. = Мені шкода.  
der/die Lieferant/in = постачальник; постачальниця  
liefern — geliefert = доставляти  
der/die Makler/in = ріелтор; ріелторка  
der/die Mieter/in = орендар; орендарка  
der/die Mitbewohner/in = співмешканець; співмешканка  
die Mitteilung = повідомлення  
die Müllabfuhr = вивіз сміття  
die Nachbarschaft = сусідство  
die Nachricht = повідомлення  
der Nachtisch = десерт  
die Nähe = близькість  
ordnungsgerecht = відповідно до порядку  
privat = приватний  
reichlich = вдосталь  
der Restmüll = залишкове сміття  
schließlich = зрештою  
schonen — geschont = берегти  
setzen — gesetzt = садити  
sogar = навіть  
sorgen — gesorgt = піклуватися  
sorgfältig = ретельний  
Spaziergang = прогулянка  
der Spiegel = дзеркало  
der Stellplatz — Stellplätze = паркувальне місце  
die Tiefgarage = підземний гараж  
die Tonne = бочка  
trennen — getrennt = розділяти  
die Treppe = сходи  
das Treppenhaus = сходова клітка  
übernehmen — übernommen — übernahm = переймати  
umziehen — ist umgezogen — zog um = переїжджати  
der Umzug = переїзд  
der Umzugskarton — Umzugskartons = коробка для переїзду  
die Vase — Vasen = ваза  
der Verbraucherzähler = лічильник споживання  
vereinbaren — vereinbart = домовлятися  
der/die Vermieter/in = орендодавець; орендодавиця  
vermieten — vermietet = здавати в оренду  
vorhanden = наявний  
wegen (Genitiv) = через  
weil = тому що  
weiterhin = надалі  
die Wohngemeinschaft = спільне проживання  
die Wohnungsbesichtigung = огляд квартири  
der Wunsch — Wünsche = бажання  
der Zähler = лічильник  
der Zugang — Zugänge = доступ  
zuletzt = востаннє  
zuzüglich = додатково  
Auf dem Amt = У держустанові  
abgeben — abgegeben — gab ab = здавати  
ablehnen — abgelehnt = відхиляти  
abmelden sich — abgemeldet = виписуватися  
die Abmeldung = виписка  
ähnlich = подібний  
das Amt = установа  
das Amtsdeutsch = офіційна німецька  
ändern — geändert = змінювати  
der/die Angehörige — Angehörigen = родич; родичка  
ankreuzen — angekreuzt = відмічати  
die Anschrift = адреса  
der Antrag — Anträge = заява  
der/die Antragsteller/in = заявник; заявниця  
die Arbeitsagentur = агенція з працевлаштування  
die Arbeitserlaubnis = дозвіл на роботу  
das Arbeitslosengeld = допомога по безробіттю  
der Arbeitsplatz — Arbeitsplätze = робоче місце  
die Arbeitsvermittlung = посередництво в працевлаштуванні  
der Aufenthalt = перебування  
die Aufenthaltserlaubnis = дозвіл на перебування  
aufrufen — aufgerufen — rief auf = викликати  
der Ausbildungsplatz = місце навчання  
das Ausländeramt = відділ у справах іноземців  
die Ausländerbehörde = управління у справах іноземців  
der Ausweis = посвідчення  
beantragen — beantragt = подавати заяву  
bearbeiten — bearbeitet = обробляти  
die Behörde = орган влади  
die Berufsberatung = професійна консультація  
das Berufsinformationszentrum = центр інформації про професії  
der/die Cousin/e = двоюрідний брат; сестра  
dabei = при цьому  
das Dokument = документ  
der/die Ehepartner/in = чоловік; дружина  
die Eheschließung — Eheschließungen = укладення шлюбу  
das Einwohnermeldeamt = відділ реєстрації мешканців  
der/die Enkel/in = онук; онука  
das Enkelkind — Enkelkinder = онук; онука  
entschuldigen sich — entschuldigt = вибачатися  
das Familienbuch = сімейна книга  
die Familienkasse = сімейна каса  
das Familienmitglied — Familienmitglieder = член сім’ї  
fehlen — gefehlt = бракувати  
das Finanzamt = податкова служба  
die Geburt — Geburten = народження  
das Geburtsdatum — Geburtsdaten = дата народження  
das Geburtsland = країна народження  
der Geburtsname = прізвище при народженні  
der Geburtsort = місце народження  
die Geburtsurkunde = свідоцтво про народження  
genehmigen — genehmigt = затверджувати  
das Geschlecht — Geschlechter = стать  
herein = всередину  
hingehen — ist hingegangen — ging hin = ходити  
die Integration = інтеграція  
der Integrationskurs = інтеграційний курс  
das Kindergeld = допомога на дитину  
der/die Lebenspartner/in = партнер; партнерка по життю  
der Lichtbildausweis = посвідчення з фото  
losfahren — ist losgefahren — fuhr los = вирушати  
männlich = чоловічий  
die Nichte — Nichten = племінниця  
notieren — notiert = записувати  
der Personalausweis = особистий паспорт  
der Reisepass — Reisepässe = закордонний паспорт  
die Schwiegereltern (Pl.) = свекри; тестеві  
die Staatsangehörigkeit = громадянство  
das Team = команда  
der Teil = частина  
die Unterlagen (Pl.) = документи  
unterschreiben — unterschrieben = підписувати  
die Urkunde — Urkunden = свідоцтво  
vollständig = повністю  
die Webseite — Webseiten = вебсайт  
weiblich = жіночий  
wiederholen — wiederholt = повторювати  
die Zulassungsstelle = реєстраційна служба  
zuständig = відповідальний  
die Schule, und dann? = Школа, а потім?  
das Abitur (Abi) = атестат зрілості  
ablegen — abgelegt = складати  
eine Prüfung ablegen = Складати іспит  
abschließen — abgeschlossen = завершувати  
anbieten — angeboten — bot an = пропонувати  
der/die Anfänger/in = початківець; початківиця  
die Architektur = архітектура  
das Ausland = закордон  
der Autounfall — Autounfälle = автопригода  
beenden — beendet = закінчувати  
die Beratung = консультація  
der Bereich = сфера  
die Berufsausbildung = професійне навчання  
die Berufsschule = професійно-технічна школа  
besonders = особливо  
der Bildungsweg = шлях освіти  
die Büroorganisation = організація офісу  
das Chaos = хаос  
die Decke = стеля  
das Ende = кінець  
die Energie = енергія  
enthalten — enthalten = містити  
entscheiden sich — entschieden = вирішувати  
erforderlich = необхідний  
die Fitness = фітнес  
fliehen — ist geflohen — floh = тікати  
fortgeschritten = просунутий  
der/die Frisör/in = перукар; перукарка  
genial = геніальний  
hoffentlich = сподіваюся  
jobben — gejobbt = підробляти  
die Kategorie — Kategorien = категорія  
kaufmännisch = комерційний  
die Kenntnisse (Pl.) = знання  
die Kommunikation = комунікація  
kompakt = компактний  
kürzen — gekürzt = скорочувати  
die Kursgebühr = плата за курс  
das Kurzprogramm = коротка програма  
der Lebensweg — Lebenswege = життєвий шлях  
die Lehre = навчання  
das Lehrmaterial = навчальний матеріал  
das Material = матеріал  
miserabel = жалюгідний  
mittlere = середній  
das Prost = тост  
die Prüfung = іспит  
das Prüfungstraining = підготовка до іспиту  
der Realschulabschluss = середня освіта  
reisen — ist gereist = подорожувати  
rhythmisch = ритмічний  
schaffen — geschafft = впоратися  
die Schulzeit = шкільний час  
seit = з  
das Semester — Semester = семестр  
separat = окремо  
die Situation — Situationen = ситуація  
städtisch = міський  
die Terminplanung = планування часу  
der Test — Tests = тест  
das Thema — Themen = тема  
die Theorie = теорія  
trainieren — trainiert = тренувати  
das Training = тренування  
der Trick — Tricks = трюк  
die Überraschung — Überraschungen = сюрприз  
die Überschrift — Überschriften = заголовок  
umschreiben — umgeschrieben — schrieb um = переписувати  
verlieben sich — verliebt = закохуватися  
verlieren — verloren — verlor = втрачати  
Vorbereitung = підготовка  
die Vorkenntnisse (Pl.) = попередні знання  
das Vorstellungsgespräch = співбесіда  
die Weiterbildung — Weiterbildungen = підвищення кваліфікації  
das Yoga = йога  
das Zeitmanagement = управління часом  
das Zertifikat = сертифікат  
das Zeugnis = свідоцтво  
zufrieden = задоволений  
Auf Arbeitssuche = У пошуках роботи  
der/die Ansprechpartner/in = контактна особа  
der Aushilfsjob = тимчасова робота  
aussehen — ausgesehen — sah aus = виглядати  
der/die Auszubildende (Azubi) — Auszubildende = учень; учениця  
der/die Bäckereifachverkäufer/in = продавець у пекарні  
bedanken sich — bedankt = дякувати  
bedienen — bedient = обслуговувати  
beeilen sich — beeilt = поспішити  
begründen — begründet = обґрунтовувати  
das Beratungsgespräch = консультаційна бесіда  
das Berufsfeld — Berufsfelder = професійна сфера  
der/die Bewerber/in = кандидат; кандидатка  
bieten — geboten — bot = пропонувати  
eindecken — eingedeckt = накривати  
genug = достатньо  
Grundschule = початкова школа  
handwerklich = ручний  
das Holz = дерево  
der/die Informatiker/in = інформатик; інформатикиня  
die Kneipe = паб  
kostenfrei = безкоштовно  
die Küchenhilfe = помічник на кухні  
die Laufbahn = кар’єра  
der Lebenslauf — Lebensläufe = резюме  
lückenlos = безперервний  
melden sich — gemeldet = повідомляти  
die Mittelschule = середня школа  
der/die Modedesigner/in = модельєр; модельєрка  
das Muster = зразок  
nötig = необхідний  
ob = чи  
persönlich = особистий  
professionell = професійний  
die Reinigungsarbeiten (Pl.) = прибиральні роботи  
die Rente — Renten = пенсія  
der/die Restaurantfachmann/-frau = фахівець ресторанної справи  
spezial = спеціальний  
statt = замість  
die Stelle = посада  
das Stellenangebot = пропозиція роботи  
die Stellensuche = пошук роботи  
die Struktur = структура  
sympathisch = симпатичний  
die Teilzeit = неповний робочий день  
die Teilzeitstelle = посада на неповний день  
tippen — getippt = набирати  
der Tippfehler = друкарська помилка  
der/die Tischler/in = столяр; столярка  
üben — geübt = вправлятися  
die Übersiedlung = переселення  
unprofessionell = непрофесійний  
unsympathisch = неприємний  
unzufrieden = незадоволений  
verrückt = божевільний  
das Volleyball = волейбол  
die Vollzeit = повний робочий день  
die Vollzeitstelle = посада на повний день  
die Voraussetzung — Voraussetzungen = передумова  
die Vorlage — Vorlagen = шаблон  
zuverlässig = надійний  
Ein Einkaufsbummel = Прогулянка за покупками  
die Accessoires (Pl.) = аксесуари  
anhaben — angehabt = носити  
die Apfelschorle = яблучний напій  
die Aubergine — Auberginen = баклажан  
die Ausrüstung = спорядження  
der Babyartikel — Babyartikel = дитячі товари  
die Badesachen (Pl.) = купальні речі  
der Bart — Bärte = борода  
die Bekleidung = одяг  
bestimmt = точно  
Der Mantel ist bestimmt sehr teuer. = Пальто точно дуже дороге.  
blond = блондин  
braten — gebraten = смажити  
bummeln — gebummelt = прогулюватися  
bunt = кольоровий  
das Camping = кемпінг  
der Champignon — Champignons = печериця  
die Currywurst = ковбаска з карі  
die Dame — Damen = дама  
darin = у ньому  
dick = товстий  
der/die Dieb/in = злодій; злодійка  
das Ding — Dinge = річ  
der Duft = аромат  
dünn = тонкий  
das Duschgel = гель для душу  
egal = байдуже  
das Ehepaar = подружжя  
einfarbig = однотонний  
die Elektronik = електроніка  
der Fahrradhelm = велосипедний шолом  
fantastisch = фантастичний  
das Fast Food = фастфуд  
die Flipflops (Pl.) = шльопанці  
frittieren — frittiert = смажити у фритюрі  
die Gemüselasagne = овочева лазанья  
gepunktet = у горошок  
das Gericht = страва  
gestreift = смугастий  
glatt = гладкий  
die Glatze = лисина  
das Gold = золото  
griechisch = грецький  
die Gulaschsuppe = суп-гуляш  
der Gürtel = ремінь  
die Haarpflege = догляд за волоссям  
das Hauptgericht = основна страва  
die Hautpflege = догляд за шкірою  
hübsch = гарненький  
die Kamera = камера  
kariert = у клітинку  
das Kompliment — Komplimente = комплімент  
der Kopfhörer = навушники  
die Kosmetiktasche = косметичка  
die Krawatte = краватка  
das Küchengerät — Küchengeräte = кухонний прилад  
laufen — ist gelaufen — lief = бігати  
die Lieblingsfarbe = улюблений колір  
lockig = кучерявий  
das Make-up = макіяж  
die Maus = миша  
das Mineralwasser = мінеральна вода  
das Modegeschäft = магазин моди  
der Modeschmuck = біжутерія  
nachher = потім  
die Naturkosmetik = натуральна косметика  
das Navigationsgerät (Navi) = навігатор  
der Ofen = піч  
der Ohrring — Ohrringe = сережка  
die Parfümerie = парфумерія  
die Pfanne = сковорідка  
plötzlich = раптово  
der/die Polizist/in = поліцейський; поліцейська  
der Schafskäse = овечий сир  
scharf = гострий  
schauen — geschaut = дивитися  
das Schaufenster = вітрина  
schick = стильний  
schlank = стрункий  
der Schmuck = прикраси  
das Schnäppchen = вигідна покупка  
das Schnitzel = шніцель  
der Schnurrbart = вуса  
der Schrei = крик  
die Schuhgröße = розмір взуття  
die Shorts = шорти  
das Silber = срібло  
der Snack — Snacks = перекус  
die Spielwaren (Pl.) = іграшки  
das Steak = стейк  
stehlen — gestohlen — stahl = красти  
der Stiefel — Stiefel = чобіт  
die Süßigkeiten = солодощі  
das Tattoo — Tattoos = татуювання  
der Toaster = тостер  
ungarisch = угорський  
die Unterwäsche = спідня білизна  
das Vanilleeis = ванільне морозиво  
der/die Vegetarier/in = вегетаріанець; вегетаріанка  
vegetarisch = вегетаріанський  
wandern — ist gewandert = ходити пішки  
der Wanderschuh — Wanderschuhe = туристичне взуття  
der Wecker = будильник  
wirklich = справді  
wunderbar = чудовий  
zubereiten — zubereitet = готувати  
die Zucchini = цукіні  
Bei der Arbeit = На роботі  
absetzen — abgesetzt = списувати  
die Abteilung — Abteilungen = відділ  
angeben — angegeben — gab an = вказувати  
der Anruf — Anrufe = дзвінок  
der/die Anrufer/in = той, хто телефонує  
der/die Arbeitgeber/in = роботодавець; роботодавиця  
der Arbeitsauftrag — Arbeitsaufträge = робоче завдання  
der Arbeitsbeginn = початок роботи  
der Arbeitsschutz = охорона праці  
der Arbeitsvertrag — Arbeitsverträge = трудовий договір  
der Aufzug = ліфт  
der Außendienst = виїзний сервіс  
ausmachen — ausgemacht = домовлятися  
der/die Beauftragte = уповноважений; уповноважена  
bereit = готовий  
bereitstellen — bereitgestellt = надавати  
besprechen — besprochen = обговорювати  
die Besprechung = нарада  
betätigen — betätigt = натискати  
betreffen — betroffen = стосуватися  
bewahren — bewahrt = зберігати  
bewegen — bewegt = рухати  
der Bildschirm = екран  
der Brand = пожежа  
die Brandbekämpfung = гасіння пожеж  
der Brandfall = випадок пожежі  
der Brandmelder = пожежний сповіщувач  
der Brandschutz = протипожежний захист  
brennen — gebrannt — brannte = горіти  
die Buchhaltung = бухгалтерія  
danken — gedankt = дякувати  
deutlich = чітко  
echt = справжній  
die Einweisung = інструктаж  
die Elektrik = електрика  
der Entwurf — Entwürfe = проєкт  
erlauben — erlaubt = дозволяти  
erwarten — erwartet = очікувати  
erwischen — erwischt = спіймати  
der Feuerlöscher = вогнегасник  
die Flamme — Flammen = полум’я  
folgen — gefolgt = слідувати  
gefährden — gefährdet = загрожувати  
gestalten — gestaltet = оформляти  
gesund = здоровий  
die Grafik — Grafiken = графіка  
der/die Grafiker/in = графік; графкиня  
die Hektik = метушня  
heraussuchen — herausgesucht = вибирати  
hinfahren — ist hingefahren — fuhr hin = їхати туди  
höflich = ввічливий  
der Internetzugang = доступ до інтернету  
der Kabelsalat = плутанина кабелів  
kennzeichnen — gekennzeichnet = позначати  
die Kerze — Kerzen = свічка  
das Konto — Konten = рахунок  
die Kontoverbindung = банківські реквізити  
kopieren — kopiert = копіювати  
die Kraft — Kräfte = сила  
die Kundenbetreuung = обслуговування клієнтів  
der Laptop = ноутбук  
das Marketing = маркетинг  
die Mehrfachsteckdose = подовжувач  
mitschreiben — mitgeschrieben — schrieb mit = записувати разом  
die Nachbereitung = подальша обробка  
nennen — genannt = називати  
die Personalabteilung = відділ кадрів  
das Personalbüro = офіс персоналу  
der/die Personalleiter/in = керівник; керівниця персоналу  
das Protokoll = протокол  
reagieren — reagiert = реагувати  
die Regel — Regeln = правило  
der Rettungswagen = швидка допомога  
die Rückfrage = зворотне запитання  
das Sekretariat = секретаріат  
die Sicherheit = безпека  
die Steckdose = розетка  
die Steuer = податок  
das Teelicht — Teelichter = чайна свічка  
überlasten — überlastet = перевантажувати  
unbürokratisch = небюрократичний  
unterstützen — unterstützt = підтримувати  
verabschieden sich — verabschiedet = прощатися  
verbessern — verbessert = покращувати  
verboten = заборонено  
das Verhalten = поведінка  
verlegen — verlegt = переносити  
vermeiden — vermieden = уникати  
die Vermeidung = уникнення  
die Versicherung — Versicherungen = страхування  
der Vertrieb = продаж  
verwenden — verwendet = використовувати  
vorbeikommen — ist vorbeigekommen — kam vorbei = заходити  
vorbereiten — vorbereitet = готувати  
die Vorschrift — Vorschriften = припис  
der Werbeflyer = рекламна листівка  
die Werbeagentur = рекламна агенція  
der/die Werbetexter/in = рекламний текстописець; текстописиця  
In der Schule = У школі  
aggressiv = агресивний  
anders = інакше  
die Angst — Ängste = страх  
aufhören — aufgehört = припиняти  
aufpassen — aufgepasst = стежити  
ausreichend = достатньо  
befriedigend = задовільно  
die Begrüßung — Begrüßungen = привітання  
beraten — beraten = консультувати  
der Bericht — Berichte = звіт  
das Berufskolleg = професійний коледж  
der Berufswunsch = бажана професія  
die Biologie = біологія  
das Bundesland = федеральна земля  
die Chemie = хімія  
damals = тоді  
dieselbe = той самий  
das Diplom = диплом  
der Elternabend = батьківські збори  
der Elternsprechtag = день спілкування з батьками  
der/die Englischlehrer/in = вчитель; вчителька англійської  
die Erdkunde = географія  
etwa = приблизно  
das Fach — Fächer = предмет  
die Fachhochschule = вищий спеціалізований заклад  
die Fachhochschulreife = кваліфікація для вступу до вищого закладу  
der Fluss — Flüsse = річка  
formell = формальний  
der/die Fotograf/in = фотограф; фотографка  
freiwillig = добровільно  
die Gesamtschule = загальноосвітня школа  
die Geschichte = історія  
das Gipsbein = гіпс на нозі  
das Glück = щастя  
das Gymnasium = гімназія  
das Halbjahr = півріччя  
die Hauptschule = основна школа  
hinfallen — ist hingefallen — fiel hin = падати  
der Integrationsverein = інтеграційна асоціація  
der/die Jugendliche — Jugendlichen = підліток; підлітка  
der Junge = хлопець  
die Kindertagesstätte (Kita) — Kindertagesstätten (Kitas) = дитячий садок  
die Klasse = клас  
die Klassenarbeit = класна робота  
der/die Klassenlehrer/in = класний керівник; керівниця  
der Knöchel = щиколотка  
der Korb = кошик  
die Kunst = мистецтво  
das Lieblingsfach — Lieblingsfächer = улюблений предмет  
lösen — gelöst = вирішувати  
die Lust = бажання  
das Mädchen — Mädchen = дівчина  
mangelhaft = незадовільно  
die Mathearbeit = контрольна з математики  
die Meinung — Meinungen = думка  
die Nachhilfe = додаткові заняття  
normal = нормальний  
die Note — Noten = оцінка  
die Oberschule = середня школа  
olympisch = олімпійський  
die Pflicht = обов’язок  
die Physik = фізика  
der/die Pilot/in = пілот; пілотка  
die Planung = планування  
die Realschule = реальна школа  
die Rede = промова  
die Religion = релігія  
das Schaubild = схема  
schrecklich = жахливий  
die Schulform = форма школи  
der/die Schulleiter/in = директор; директорка школи  
die Schulpflicht = обов’язкова освіта  
das Schulsystem = шкільна система  
selbst = сам  
der/die Sozialpädagoge/-pädagogin = соціальний педагог; педагогиня  
der Sportunterricht = урок фізкультури  
streng = суворий  
die Tagesordnung = порядок денний  
der Teenager — Teenager = підліток  
teilnehmen — teilgenommen — nahm teil = брати участь  
das Tier — Tiere = тварина  
der/die Tierpfleger/in = доглядач; доглядачка тварин  
träumen — geträumt = мріяти  
traurig = сумний  
turnen — geturnt = займатися гімнастикою  
umknicken — umgeknickt = підвернути  
unfair = несправедливий  
ungenügend = недостатньо  
die Uniform = уніформа  
Gesund sein und gesund bleiben = Бути здоровим і залишатися здоровим  
die Akupunktur = акупунктура  
die Alternative = альтернатива  
anerkannt = визнаний  
die Anweisung — Anweisungen = інструкція  
die Auflistung = список  
die Behandlung — Behandlungen = лікування
belegen — belegt = займати  
die Bescheinigung — Bescheinigungen = довідка  
der Boden — Böden = підлога  
dagegen = проти  
damit = з цим  
der Eiswürfel — Eiswürfel = кубик льоду  
empfindlich = чутливий  
engagieren sich — engagiert = брати участь  
entspannen sich — entspannt = розслаблятися  
die Entspannung = розслаблення  
erfahren — erfahren — erfuhr = дізнаватися  
erstatten — erstattet = відшкодовувати  
fit = у формі  
gesamt = загальний  
gesundheitlich = за станом здоров’я  
die Gymnastik = гімнастика  
das Handgelenk = зап’ястя  
das Hausmittel — Hausmittel = домашній засіб  
die Haut = шкіра  
hiermit = цим  
hierzu = до цього  
hochlegen — hochgelegt = піднімати  
holen — geholt = приносити  
klagen — geklagt = скаржитися  
kommunizieren — kommuniziert = спілкуватися  
kompliziert = складний  
die Kostenerstattung = відшкодування витрат  
die Kostenübernahme = покриття витрат  
kühlen — gekühlt = охолоджувати  
leihen — geliehen = позичати  
manche = деякі  
die Massage = масаж  
massieren — massiert = масажувати  
die Meditation = медитація  
der Muskel — Muskeln = м’яз  
die Nebenwirkung — Nebenwirkungen = побічна дія  
das Pilates = пілатес  
der Rat = порада  
reizen — gereizt = дратувати  
die Rückenmuskulatur = м’язи спини  
schlafengehen — ist schlafen gegangen — ging schlafen = лягати спати  
schlagen — geschlagen — schlug = бити  
die Schmerztablette = знеболювальна таблетка  
die Schwellung = набряк  
selber = сам  
speziell = особливий  
die Sportart = вид спорту  
der Sportverein = спортивний клуб  
ständig = постійний  
stärken — gestärkt = зміцнювати  
der Tanzkurs = курс танців  
die Teilnahme = участь  
die Teilnahmebescheinigung = довідка про участь  
telefonisch = телефонний  
die Therapie = терапія  
der/die Trainer/in = тренер  
treiben — getrieben — trieb = займатися  
die Tüte = пакет  
die Übelkeit = нудота  
übersenden — übersandt = надсилати  
überweisen — überwiesen = переказувати  
übrigens = до речі  
die Verabschiedung = прощання  
vermitteln — vermittelt = передавати  
verschreiben — verschrieben = виписувати  
der/die Versicherungsnehmer/in = страхувальник  
der Versicherungstarif = страховий тариф  
die Verspannung — Verspannungen = напруга  
während (Genitiv) = під час  
die Wärmflasche = грілка  
weggehen — ist weggegangen — ging weg = йти геть  
zwischendurch = між іншим  
Auf der Bank = На банці  
abheben — abgehoben = знімати  
die Aktivität — Aktivitäten = діяльність  
anfordern — angefordert = запитувати  
die Armut = бідність  
aufheben — aufgehoben = піднімати  
ausdrucken — ausgedruckt = друкувати  
die Bankkarte = банківська картка  
der/die Bankkaufmann/Bankkauffrau = банківський службовець  
die Bankleitzahl = код банку  
der Bankschalter = банківська каса  
bar = готівкою  
das Bargeld = готівка  
bargeldlos = безготівковий  
die Basis = основа  
begleichen — beglichen = сплачувати  
berechnen — berechnet = розраховувати  
die Bestellnummer = номер замовлення  
die Bestellung = замовлення  
der BIC = BIC  
der Blick = погляд  
die Broschüre = брошура  
drücken — gedrückt = натискати  
eigen = власний  
die Eingabe — Eingaben = введення  
eingeben — eingegeben — gab ein = вводити  
einzahlen — eingezahlt = вносити  
erledigen — erledigt = виконувати  
eröffnen — eröffnet = відкривати  
die Filiale = філія  
folgend = наступний  
formulieren — formuliert = формулювати  
die Gebühr — Gebühren = плата  
der Geldautomat = банкомат  
die Geldbörse = гаманець  
das Geldstück — Geldstücke = монета  
genießen — genossen = насолоджуватися  
gewinnen — gewonnen — gewann = вигравати  
die Girocard = картка Giro  
das Girokonto = поточний рахунок  
das Hufeisen = підкова  
die IBAN = IBAN  
indirekt = непрямий  
die Innenstadt = центр міста  
jederzeit = будь-коли  
das Kleeblatt = конюшина  
das Kleingeld = дріб’язок  
der Kontoauszug — Kontoauszüge = виписка з рахунку  
der/die Kontoinhaber/in = власник рахунку  
die Kontonummer — Kontonummern = номер рахунку  
der Kontostand = баланс рахунку  
kontrollieren — kontrolliert = контролювати  
das Kreditinstitut — Kreditinstitute = кредитна установа  
die Kreditkarte — Kreditkarten = кредитна картка  
die Kundennummer — Kundennummern = номер клієнта  
die Kundenreferenz = клієнтська довідка  
der Laden — Läden = магазин  
die Leistung — Leistungen = послуга  
die Menge = кількість  
mobil = мобільний  
monatlich = щомісячний  
die Münze — Münzen = монета  
niemand = ніхто  
der Nulltarif = нульовий тариф  
nutzen — genutzt = використовувати  
das Online-Banking = онлайн-банкінг  
der Pfennig — Pfennige = пфеніг  
der PIN = PIN  
der Quatsch = нісенітниця  
die Rechnung = рахунок  
der Rechnungsbetrag = сума рахунку  
die Rechnungsnummer = номер рахунку  
reich = багатий  
der Reichtum = багатство  
der Respekt = повага  
der Schein — Scheine = купюра  
schieben — geschoben — schob = штовхати  
schlachten — geschlachtet = забивати  
der/die Schornsteinfeger/in = сажотрус  
das Sparkonto — Sparkonten = ощадний рахунок  
das Sparschwein — Sparschweine = скарбничка  
spätestens = найпізніше  
stecken — gesteckt = вставляти  
stoßen — gestoßen — stieß = штовхати  
die TAN = TAN  
die Taste — Tasten = кнопка  
der/die Täter/in = злочинець  
der Überfall — Überfälle = напад  
überfallen — überfallen — überfiel = нападати  
die Überwachungskamera — Überwachungskameras = камера спостереження  
die Überweisung — Überweisungen = переказ  
das Überweisungsformular = бланк переказу  
der Versuch — Versuche = спроба  
der Verwendungszweck — Verwendungszwecke = призначення платежу  
der Vorteil — Vorteile = перевага  
weglaufen — ist weggelaufen — lief weg = тікати  
der/die Zahlungsempfänger/in = отримувач платежу  
der Zeitungsartikel — Zeitungsartikel = газетна стаття  
der/die Zeuge/Zeugin = свідок  
zurückgeben — zurückgegeben — gab zurück = повертати  
Freizeitvergnügen = дозвілля  
abschalten — abgeschaltet = вимикати  
der Appetit = апетит  
ärgern sich — geärgert = дратуватися  
asiatisch = азіатський  
der Ausflug — Ausflüge = екскурсія  
ausgezeichnet = чудовий  
der Ausgleich = компенсація  
außer (Dativ) = крім  
die Aussicht = вид  
der/die Babysitter/in = няня  
die Band = гурт  
das Basketball = баскетбол  
basteln — gebastelt = майструвати  
das Besteck = столові прибори  
der Chor = хор  
daheim = вдома  
der Daumen = великий палець  
der Einlass = вхід  
entlang (Dativ) = вздовж  
das Event = подія  
das Feuerzeug = запальничка  
die Freizeit = вільний час  
die Freizeitaktivität — Freizeitaktivitäten = заняття у вільний час  
das Freizeitangebot — Freizeitangebote = пропозиція дозвілля  
das Freizeitvergnügen = розваги у вільний час  
die Gabel — Gabeln = виделка  
die Gastronomie = гастрономія  
das Gedicht — Gedichte = вірш  
der Gegensatz = протилежність  
der/die Geiger/in = скрипаль  
gemischt = змішаний  
das Geschirr = посуд  
der Grill = гриль  
die Grillkohle = вугілля для гриля  
der Grillplatz = місце для гриля  
die Grillsoße = соус для гриля  
die Grillzange = щипці для гриля  
herrlich = чудовий  
herum = навколо  
interessieren sich für (Akkusativ) — interessiert = цікавитися  
der/die Interviewpartner/in = співрозмовник  
irgendwo = десь  
jährlich = щорічний  
jeweils = кожного разу  
knackig = хрусткий  
konzentrieren sich — konzentriert = концентруватися  
der Kumpel = товариш  
die Leidenschaft = пристрасть  
der Löffel — Löffel = ложка  
malen — gemalt = малювати  
meist = здебільшого  
das Messer — Messer = ніж  
mitfahren — ist mitgefahren — fuhr mit = їхати разом  
nähen — genäht = шити  
normalerweise = зазвичай  
das Open-Air-Konzert = концерт просто неба  
der Poetry-Slam = поетичний слем  
die Regie = режисура  
der Saal — Säle = зал  
das Schach = шахи  
der Schnupperkurs = ознайомчий курс  
die Schüssel = миска  
segeln — gesegelt = плавати під вітрилами  
der Sieg = перемога  
das Spielfeld = ігрове поле  
das Sportergebnis — Sportergebnisse = спортивний результат  
der Sportplatz = спортивний майданчик  
surfen — gesurft = серфінгувати  
der Tango = танго  
der/die Tänzer/in = танцівник  
die Tischdecke = скатертина  
die Tischdekoration = декор столу  
trotzdem = попри це  
umfangreich = обширний  
die Umfrage = опитування  
die Umkleide = роздягальня  
unterhalten sich — unterhalten = розмовляти  
veranstalten — veranstaltet = влаштовувати  
der Veranstaltungshinweis — Veranstaltungshinweise = анонс заходу  
verbringen — verbracht = проводити  
die Verpackung — Verpackungen = упаковка  
verteilen — verteilt = розподіляти  
das Volleyballspiel = гра у волейбол  
die Vorlesung — Vorlesungen = лекція  
wundervoll = чудовий  
Gute Reise! = Щасливої подорожі!  
der Abfall — Abfälle = сміття  
der Abflug = виліт  
die Absage = скасування  
aktiv = активний  
der Alkohol = алкоголь  
angenehm = приємний  
annulliert = анульований  
die Anzeigetafel — Anzeigetafeln = інформаційне табло  
der Aufruf = оголошення  
der Ausgang — Ausgänge = вихід  
die Ausstattung = обладнання  
der Behälter — Behälter = контейнер  
betreten — betreten = входити  
der/die Bewohner/in — Bewohner/innen = житель  
die Bordkarte = посадковий талон  
der/die Camper/in — Camper/innen = кемпер  
der Campingplatz — Campingplätze = кемпінг  
der Check-in-Schalter = стійка реєстрації  
der Container — Container = контейнер  
die Dienstreise = відрядження  
das Doppelbett — Doppelbetten = двоспальне ліжко  
das Doppelzimmer (DZ) — Doppelzimmer = двомісний номер  
einchecken — eingecheckt = реєструватися  
die Einsteigezeit = час посадки  
das Einzelzimmer (EZ) = одномісний номер  
erleben — erlebt = переживати  
der Flug — Flüge = рейс  
der/die Flugbegleiter/in — Flugbegleiter/innen = бортпровідник  
der Fluggast — Fluggäste = пасажир літака  
die Fluggesellschaft — Fluggesellschaften = авіакомпанія  
führen — geführt = вести  
füttern — gefüttert = годувати  
das Gate = вихід на посадку  
das Gepäck = багаж  
die Gepäckausgabe = видача багажу  
das Gepäckband = багажна стрічка  
sein gestattet = дозволено  
die Halbpension (HP) = напівпансіон  
das Handgepäck = ручна поклажа  
historisch = історичний  
das Hostel = хостел  
hygienisch = гігієнічний  
das Inlineskaten = катання на роликах  
die Jugendherberge — Jugendherbergen = молодіжний хостел  
der Katalog — Kataloge = каталог  
klettern — geklettert = лазити  
komfortabel = комфортний  
die Lage = місце розташування  
das Lagerfeuer = багаття  
landen — gelandet = приземлятися  
der Lärm = шум  
die Lautsprecherdurchsage — Lautsprecherdurchsagen = оголошення через гучномовець  
lebhaft = жвавий  
die Leine = повідець  
der Leuchtturm — Leuchttürme = маяк  
der Meerblick = вид на море  
mitten = посередині  
der Nebel = туман  
neblig = туманний  
das Paradies = рай  
der/die Passagier/in — Passagiere = пасажир  
die Passkontrolle = паспортний контроль  
der Pilotenstreik = страйк пілотів  
der Pool = басейн  
rechtzeitig = вчасно  
das Reisebüro = туристичне агентство  
der Reiseplan — Reisepläne = план подорожі  
die Reiseplanung = планування подорожі  
reiten — geritten — ritt = їздити верхи  
die Ruhezeit — Ruhezeiten = час відпочинку  
sauber = чистий  
die Sauberkeit = чистота  
der Schalter — Schalter = віконце  
die Schlange = черга  
der Sonnenschirm — Sonnenschirme = парасолька від сонця  
die Sonnenterrasse — Sonnenterrassen = сонячна тераса  
der Sonnenuntergang — Sonnenuntergänge = захід сонця  
der Stern — Sterne = зірка  
stören — gestört = турбувати  
das Streichholz — Streichhölzer = сірник  
streiken — gestreikt = страйкувати  
die Taschenlampe = ліхтарик  
das Taschenmesser = кишеньковий ніж  
traumhaft = казковий  
übernachten — übernachtet = ночувати  
die Übernachtung = ночівля  
die Übernachtung mit Frühstück (ÜF) = ночівля зі сніданком  
die Umgebung = околиці  
umgehend = негайно  
verärgert = роздратований  
verreisen — ist verreist = подорожувати  
verschieben — verschoben = переносити  
der Wanderer = мандрівник  
die Wandertour — Wandertouren = піший похід  
der Waschraum — Waschräume = вбиральня  
der Wohnwagen = житловий причіп  
das Zelt = намет  
der Zoll = митниця  
der Zuschlag — Zuschläge = доплата  
die Nachbarn = сусіди  
absprechen — abgesprochen = домовлятися  
der Abstellplatz — Abstellplätze = місце для зберігання  
akzeptieren — akzeptiert = приймати  
anstreichen — angestrichen = фарбувати  
der Ärger = роздратування  
ärgerlich = дратівливий  
die Aufregung = хвилювання  
die Ausnahme = виняток  
das Balkongeländer = балконні перила  
befestigen — befestigt = закріплювати  
behalten — behalten — behielt = зберігати  
beleidigen — beleidigt = ображати  
die Beleidigung — Beleidigungen = образа  
berechtigt = виправданий  
beschimpfen — beschimpft = лаяти  
die Beschimpfung — Beschimpfungen = лайка  
beschweren sich — beschwert = скаржитися  
der Blumentopf — Blumentöpfe = квітковий горщик  
bohren — gebohrt = свердлити  
deswegen = тому  
dumm = дурний  
eilig = поспішний  
einhalten — eingehalten — hielt ein = дотримуватися  
einlegen — eingelegt = вставляти  
einstellen — eingestellt = налаштовувати  
enden — geendet = закінчувати  
die Entscheidung — Entscheidungen = рішення  
entspannend = розслабляючий  
entsprechen — entsprochen = відповідати  
erhöhen — erhöht = підвищувати  
erleichtern — erleichtert = полегшувати  
erwähnen — erwähnt = згадувати  
eskalieren — eskaliert = загострюватися  
exotisch = екзотичний  
fair = справедливий  
festkleben — festgeklebt = приклеювати  
die Freude = радість  
die Frist — Fristen = термін  
fristgerecht = своєчасний  
fristlos = безстроковий  
der Gemeinschaftsraum — Gemeinschaftsräume = спільна кімната  
gesetzlich = законний  
hämmern — gehämmert = забивати  
heizen — geheizt = опалювати  
die Instandhaltung = утримання  
klug = розумний  
der Konflikt — Konflikte = конфлікт  
die Kündigung = розірвання  
lüften — gelüftet = провітрювати  
massiv = масивний  
meckern — gemeckert = бурчати  
das Meerschweinchen = морська свинка  
die Mieterhöhung = підвищення орендної плати  
der Mietspiegel = огляд орендних цін  
der Mietvertrag — Mietverträge = договір оренди  
die Modernisierung = модернізація  
nachsehen — nachgesehen — sah nach = перевіряти  
neugierig = допитливий  
obwohl = хоча  
offenbar = очевидно  
protestieren — protestiert = протестувати  
der/die Richter/in — Richter/innen = суддя  
die Rücksicht = увага  
sammeln — gesammelt = збирати  
sauer = кислий; сердитий  
der Schaden — Schäden = шкода  
schmutzig = брудний  
selbstverständlich = зрозуміло  
sinnlos = безглуздий  
sinnvoll = розумний  
sortieren — sortiert = сортувати  
stinken — gestunken — stank = смердіти  
streiten sich — gestritten = сперечатися  
total = повний  
treu = вірний  
überlegen — überlegt = обмірковувати  
üblich = звичний  
unglaublich = неймовірний  
das Unrecht = несправедливість  
das Urteil = вирок  
vergleichbar = порівнянний  
verpflichten — verpflichtet = зобов’язувати  
das Verständnis = розуміння  
der Verstoß — Verstöße = порушення  
verstoßen — verstoßen — verstieß = порушувати  
völlig = повністю  
vorher = раніше  
wegräumen — weggeräumt = прибирати  
der Widerspruch — Widersprüche = суперечність  
wütend = сердитий  
der Zeitraum — Zeiträume = період  
ziemlich = досить  
die Zimmerlautstärke = гучність у кімнаті  
zugeben — zugegeben — gab zu = визнавати  
zurücklassen — zurückgelassen — ließ zurück = залишати  
das Zusammenleben = співжиття  
zustimmen — zugestimmt = погоджуватися  
der Zutritt = доступ  
Ein Schulprojekt zum Umweltschutz = Шкільний проєкт із захисту довкілля  
das Abgas — Abgase = вихлопні гази  
das Abwasser = стічні води  
das Altöl = відпрацьована олія  
das Altpapier = макулатура  
das Aluminium = алюміній  
andauernd = постійний  
ankündigen — angekündigt = оголошувати  
anstatt (Genitiv) = замість  
die Begleitperson = супроводжуюча особа  
belasten — belastet = навантажувати  
die Belastung = навантаження  
beobachten — beobachtet = спостерігати  
der Beutel — Beutel = мішок  
biologisch = біологічний  
die Chemikalie — Chemikalien = хімікат  
der Deckel = кришка  
doof = дурний  
der Eierkarton — Eierkartons = картон для яєць  
die Eierschale — Eierschalen = яєчна шкаралупа  
einfallen — ist eingefallen — fiel ein = спадати на думку  
das Elektroauto = електромобіль  
das Energiesparhaus = енергозберігаючий будинок  
die Energiesparlampe = енергозберігаюча лампа  
das Erdbeben = землетрус  
die Erde = земля  
die Erderwärmung = глобальне потепління  
die Erlaubnis = дозвіл  
der/die Förster/in — Förster/innen = лісник  
der Gegenstand — Gegenstände = предмет  
der Gegenvorschlag — Gegenvorschläge = контрпропозиція  
giftig = отруйний  
der Haushalt = господарство  
das Hochwasser = повінь  
der/die Hörer/in — Hörer/innen = слухач  
der Kaffeefilter = кавовий фільтр  
das Klima = клімат  
der Klimawandel = зміна клімату  
die Konservendose = консервна банка  
der Kunststoff — Kunststoffe = пластик  
die Luft = повітря  
die Matratze = матрац  
das Metall = метал  
der Milchkarton = молочний картон  
die Mülltonne = сміттєвий бак  
die Mülltrennung = сортування сміття  
die Naturkatastrophe = природна катастрофа  
das Naturprodukt — Naturprodukte = натуральний продукт  
die Obstschale — Obstschalen = фруктова миска  
der Papiermüll = паперове сміття  
die Pappe = картон  
das Picknick = пікнік  
der Planet — Planeten = планета  
das Plastik = пластик  
recyceln — recycelt = переробляти  
der Sack — Säcke = мішок  
die Sammelstelle = пункт збору  
schädigen — geschädigt = завдавати шкоди  
schädlich = шкідливий  
der Schadstoff — Schadstoffe = забруднювач  
schützen — geschützt = захищати  
die Solarenergie = сонячна енергія  
der Sondermüll = спеціальні відходи  
der Sonnenschein = сонячне світло  
die Sorge = турбота  
sparsam = ощадливий  
der Sperrmüll = великогабаритне сміття  
stattfinden — stattgefunden — fand statt = відбуватися  
der Tierschutz = захист тварин  
das Trinkwasser = питна вода  
trüb = каламутний  
der Tsunami = цунамі  
der Turm = вежа  
umdrehen — umgedreht = перевертати  
umgehen — umgangen — umging = обходити  
umweltfreundlich = екологічний  
der Umweltschutz = захист довкілля  
die Umweltverschmutzung = забруднення довкілля  
das Unwetter — Unwetter = негода  
verändern — verändert = змінювати  
verlaufen — ist verlaufen — verlief = проходити  
verschmutzen — verschmutzt = забруднювати  
verschwenden — verschwendet = марнувати  
die Verschwendung = марнотратство  
versprechen — versprochen — versprach = обіцяти  
verwerten — verwertet = утилізувати  
voraussichtlich = ймовірно  
vorhersagen — vorhergesagt — sagte vorher = передбачати  
wahrscheinlich = імовірно  
wegschmeißen (ugs.) — weggeschmissen — schmiss weg = викидати  
wegwerfen — weggeworfen — warf weg = викидати  
der Wertstoff — Wertstoffe = цінний матеріал  
der Wind = вітер  
die Windel — Windeln = підгузок  
der Wirbelsturm — Wirbelstürme = ураган  
die Wolke — Wolken = хмара  
zerstören — zerstört = руйнувати  
die Zerstörung = руйнування  
die Zigarettenkippe — Zigarettenkippen = сигаретний недопалок  
zurückfahren — ist zurückgefahren — fuhr zurück = повертатися  
Online einkaufen = Покупки онлайн  
AGB (Allgemeine Geschäftsbedingungen) = Загальні умови ведення бізнесу  
anfassen — angefasst = торкатися  
die Anprobe = примірка  
anprobieren — anprobiert = приміряти  
die Art — Arten = вид  
die Artikelnummer — Artikelnummern = номер артикулу  
die Atmung = дихання  
atmungsaktiv = дихаючий  
aufmerksam = уважний  
der Auftrag = замовлення  
die Auftragsnummer = номер замовлення  
ausliefern — ausgeliefert = доставляти  
die Auswahl = вибір  
der Bankeinzug = банківське списання  
bereits = уже  
beschädigt = пошкоджений  
die Bestellhotline = гаряча лінія замовлень  
der Betrag — Beträge = сума  
der Bezahlvorgang — Bezahlvorgänge = процес оплати  
das Callcenter = кол-центр  
der Datenschutz = захист даних  
dicht = щільний  
durchlässig = проникний  
ebenso = так само  
eher = швидше  
das Eigentum = власність  
die Ergänzung — Ergänzungen = доповнення  
erhältlich = доступний  
eventuell = можливо  
falls = якщо  
der Gutschein = ваучер  
herstellen — hergestellt = виготовляти  
die Herstellung = виробництво  
das Impressum = імпрессум  
innerhalb (Genitiv) = протягом  
irgendwie = якось  
der Kauf = покупка  
die Kaufbestätigung = підтвердження покупки  
der/die Käufer/in — Käufer/innen = покупець  
der Kaufvertrag = договір купівлі  
die Kosmetik = косметика  
die Kundenbefragung = опитування клієнтів  
kundenfreundlich = доброзичливий до клієнтів  
das Lager = склад  
lieferbar = доступний для доставки  
die Lieferbedingung — Lieferbedingungen = умова доставки  
die Lieferung = доставка  
luftdurchlässig = повітропроникний  
die Mehrkosten (Pl.) = додаткові витрати  
die Nachnahme = оплата при доставці  
der Nachteil = недолік  
der Onlineeinkauf = онлайн-покупка  
der Onlineshop = онлайн-магазин  
das Onlineshopping = онлайн-шопінг  
das Paket = посилка  
der Paketbote = кур’єр  
der Paketdienst = служба доставки  
das Porto = поштова плата  
portofrei = безкоштовна доставка  
die Portokosten (Pl.) = поштові витрати  
produzieren — produziert = виробляти  
die Qualität = якість  
die Reklamation — Reklamationen = рекламація  
die Retoure — Retouren = повернення  
der Retourenschein = талон на повернення  
die Rücksendung = зворотна відправка  
das Shopping = шопінг  
unverbindlich = необов’язковий  
der/die Verbraucher/in — Verbraucher/innen = споживач  
verpacken — verpackt = пакувати  
der Versand = відправка  
die Versandkosten (Pl.) = витрати на доставку  
versandkostenfrei = безкоштовна доставка  
die Versandkostenpauschale = фіксована плата за доставку  
versenden — versandt = відправляти  
die Ware — Waren = товар  
der Warenkorb = кошик  
wasserdicht = водонепроникний  
der Werktag — Werktage = робочий день  
wetterfest = стійкий до погоди  
widerrufen — widerrufen = скасовувати  
das Widerrufsrecht = право на скасування  
die Zahlung = оплата  
zurückschicken — zurückgeschickt = повертати  
zurücksenden — zurückgesandt = відправляти назад  
zurücktreten — ist zurückgetreten — trat zurück = відступати  
zustellen — zugestellt = доставляти  
Fernsehen und Unterhaltung = Телебачення та розваги  
das Alter = вік  
anschauen — angeschaut = дивитися  
der Anstoß = поштовх  
anstrengend = виснажливий  
das Autorennen = автоперегони  
befragen — befragt = опитувати  
begeistern sich — begeistert = захоплюватися  
beliebt = популярний  
der Biergarten = пивний сад  
das Boxen = бокс  
die Chips (Pl.) = чипси  
demnächst = незабаром  
die Detektivgeschichte = детективна історія  
das Diagramm = діаграма  
die Diskussion = дискусія  
die Dokumentation (Doku) — Dokumentationen (Dokus) = документальний фільм  
doppelt = подвійний  
dramatisch = драматичний  
der Durchschnitt = середнє значення  
die DVD = DVD  
ehrlich = чесний  
einschlafen — ist eingeschlafen — schlief ein = засинати  
einsetzen — eingesetzt = використовувати  
das Eishockey = хокей на льоду  
der Eiskunstlauf = фігурне катання  
entstehen — ist entstanden — entstand = виникати  
das Ereignis — Ereignisse = подія  
erfolgreich = успішний  
das Ergebnis — Ergebnisse = результат  
der/die Experte/Expertin — Experten/Expertinnen = експерт  
der Fan — Fans = фанат  
der Fußballclub = футбольний клуб  
die Gewohnheit — Gewohnheiten = звичка  
das Golf = гольф  
der Handball = гандбол  
das Herz = серце  
der Horrorfilm = фільм жахів  
der/die Kandidat/in — Kandidaten/Kandidatinnen = кандидат  
der/die Kommissar/in — Kommissare/Kommissarinnen = комісар  
der/die Kommentator/in — Kommentatoren/Kommissarinnen = коментатор  
die Komödie — Komödien = комедія  
der Krimi — Krimis = детектив  
kuscheln — gekuschelt = обійматися  
die Langeweile = нудьга  
die Leichtathletik = легка атлетика  
die Lieblingsbeschäftigung = улюблене заняття  
das Magazin = журнал  
die Mannschaft = команда  
die Mehrheit = більшість  
die Minderheit = меншість  
mitreden — mitgeredet = брати участь у розмові  
das Mittelfeld = півзахист  
die Moderation = модерація  
der Mord = вбивство  
motiviert = мотивований  
naschen — genascht = перекушувати  
die Niederlage = поразка  
objektiv = об’єктивний  
die Quizshow = вікторина  
das Radrennen = велоперегони  
die Rangliste = рейтинг  
das Rätsel — Rätsel = загадка  
die Reportage = репортаж  
der/die Reporter/in — Reporter/innen = репортер  
retten — gerettet = рятувати  
romantisch = романтичний  
die Runde = раунд  
schalten — geschaltet = перемикати  
der Schiedsrichter = суддя  
schießen — geschossen — schoss = стріляти  
die Seifenoper — Seifenopern = мильна опера  
die Sendung — Sendungen = передача  
die Serie — Serien = серіал  
siegen — gesiegt = перемагати  
der/die Sieger/in — Sieger/innen = переможець  
der Skisport = лижний спорт  
die Soap = серіал  
spannend = захоплюючий  
der/die Spieler/in — Spieler/innen = гравець  
der Spielfilm = художній фільм  
das Stadion = стадіон  
die Statistik = статистика  
der Tagesablauf = розпорядок дня  
die Talkshow = ток-шоу  
das Tor — Tore = гол  
der/die Torwart/in = воротар  
der/die Tote — Toten = загиблий  
die Übertragung = трансляція  
unentschieden = нічия  
ungesund = нездоровий  
die Unterhaltung = розвага  
der/die Verlierer/in — Verlierer/innen = переможений  
die Weltmeisterschaft (WM) = чемпіонат світу  
weshalb = чому  
zappen — gezappt = перемикати канали  
der Zeichentrickfilm = мультфільм  
die Zeitverschwendung = марнування часу  
der/die Zuschauer/in — Zuschauer/innen = глядач  
So war das damals … = Так було тоді …  
der/die Alliierte — Alliierten = союзник  
die Amtssprache — Amtssprachen = офіційна мова  
anfangs = спочатку  
anheben — angehoben = піднімати  
die Arbeitskraft — Arbeitskräfte = робоча сила  
die Arbeitslosigkeit = безробіття  
der/die Astronaut/in — Astronauten/Astronautinnen = астронавт  
das Asyl = притулок  
aufschreiben — aufgeschrieben — schrieb auf = записувати  
aufteilen — aufgeteilt = ділити  
der Auswanderer — Auswanderer = емігрант  
die Auswanderung = еміграція  
die Besatzungszone — Besatzungszonen = зона окупації  
besiegen — besiegt = перемагати  
der/die Bundeskanzler/in = федеральний канцлер  
die Bundesrepublik (BRD) = Федеративна Республіка Німеччина (ФРН)  
der/die Bürger/in — Bürger/innen = громадянин  
der Bürgerkrieg = громадянська війна  
die Demokratie = демократія  
demokratisch = демократичний  
die Demonstration — Demonstrationen = демонстрація  
die Deutsche Demokratische Republik (DDR) = Німецька Демократична Республіка (НДР)  
ehemalig = колишній  
einführen — eingeführt = вводити  
einsperren — eingesperrt = ув’язнювати  
die Einwanderung = імміграція  
emotional = емоційний  
entwickeln — entwickelt = розвивати  
erinnern sich an (Akkusativ) — erinnert = згадувати  
die Erinnerung — Erinnerungen = спогад  
ernähren — ernährt = годувати  
die Europäische Union (EU) = Європейський Союз (ЄС)  
die Euroeinführung = введення євро  
der Flüchtling — Flüchtlinge = біженець  
fördern — gefördert = сприяти  
die Fremdsprache — Fremdsprachen = іноземна мова  
friedlich = мирний  
der/die Gastarbeiter/in — Gastarbeiter/innen = гість-робітник  
das Gefühl — Gefühle = почуття  
der/die Gegner/in — Gegner/innen = противник  
das Gehalt — Gehälter = зарплата  
das Gewürz — Gewürze = спеція  
die Grenze — Grenzen = кордон  
gründen — gegründet = засновувати  
hart = жорсткий  
die Hauptstadt — Hauptstädte = столиця  
die Heimat = батьківщина  
die Industrie = промисловість  
irgendwann = коли-небудь  
jahrelang = роками  
das Jahrhundert — Jahrhunderte = століття  
das Jahrzehnt — Jahrzehnte = десятиліття  
der/die Jude/Jüdin — Juden/Jüdinnen = єврей  
kaum = ледве  
die Kindheit = дитинство  
der Krieg — Kriege = війна  
das Kriegsende = закінчення війни  
die Krippe — Krippen = ясла  
der/die Kritiker/in — Kritiker/innen = критик  
die Mauer — Mauern = стіна  
der Mauerbau = будівництво стіни  
der Mauerfall = падіння стіни  
die Medizin = медицина  
merken — gemerkt = помічати  
die Migration = міграція  
miteinander = разом  
miterleben — mitgelebt = переживати разом  
musikalisch = музичний  
die Muttersprache — Muttersprachen = рідна мова  
die Nachkriegszeit = повоєнний час  
der Nationalsozialismus = націонал-соціалізм  
die NATO = НАТО  
die Notunterkunft — Notunterkünfte = тимчасове житло  
die Öffnung = відкриття  
die Phase — Phasen = фаза  
politisch = політичний  
der Protest — Proteste = протест  
die Regierung — Regierungen = уряд  
die Republik — Republiken = республіка  
der/die Russlanddeutsche — Russlanddeutschen = німець із Росії  
der Staat — Staaten = держава  
die Staatsgründung = заснування держави  
das Stipendium — Stipendien = стипендія  
tatsächlich = фактично  
die Teilung — Teilungen = поділ  
verdrängen — verdrängt = витісняти  
vereinigen — vereinigt = об’єднувати  
verfolgen — verfolgt = переслідувати  
verhaften — verhaftet = арештовувати  
verlängern — verlängert = продовжувати  
verlassen — verlassen — verließ = покидати  
vermischen — vermischt = змішувати  
das Visum — Visa = віза  
das Weltall = космос  
wiedervereinigen — wiedervereinigt = возз’єднувати  
die Wiedervereinigung = возз’єднання  
zerschlagen — zerschlagen — zerschlug = розбивати  
zurückkehren — ist zurückgekehrt — kehrte zurück = повертатися  
Deutschland – zweite Heimat? = Німеччина – друга батьківщина?  
abschicken — abgeschickt = відправляти  
die Abwicklung = обробка  
amtlich = офіційний  
anerkennen — anerkannt = визнавати  
die Anerkennung = визнання  
der Anfang — Anfänge = початок  
ansteckend = заразний  
ausstellen — ausgestellt = видавати  
die Bearbeitung = обробка  
beglaubigen — beglaubigt = засвідчувати  
die Beglaubigung = засвідчення  
der/die Bekannte — Bekannten = знайомий  
benötigen — benötigt = потребувати  
berufen sich — berufen = посилатися  
bescheinigen — bescheinigt = підтверджувати  
sein dran — ist dran gewesen — war dran = бути на черзі  
einreichen — eingereicht = подавати  
enttäuschen — enttäuscht = розчаровувати  
die Enttäuschung — Enttäuschungen = розчарування  
der Erhalt = отримання  
die Erklärung — Erklärungen = пояснення  
erkundigen sich — erkundigt = дізнаватися  
die Fähigkeit — Fähigkeiten = здатність  
die Fantasie = фантазія  
die Formalität — Formalitäten = формальність  
förmlich = формальний  
die Fotokopie — Fotokopien = фотокопія  
der Frieden = мир  
das Führungszeugnis = довідка про несудимість  
garantieren — garantiert = гарантувати  
der Gedanke — Gedanken = думка  
die Geduld = терпіння  
geduldig = терплячий  
die Gemeinsamkeit — Gemeinsamkeiten = спільність  
der Geruch — Gerüche = запах  
das Gesundheitszeugnis = медична довідка  
gewährleisten — gewährleistet = забезпечувати  
häufig = часто  
das Heimweh = туга за домом  
herkommen — ist hergekommen — kam her = приїжджати  
das Herkunftsland — Herkunftsländer = країна походження  
hierher = сюди  
hilfsbereit = готовий допомогти  
inzwischen = тим часом  
die Kopie — Kopien = копія  
die Mentalität — Mentalitäten = менталітет  
nachdenklich = задумливий  
der/die Pflegehelfer/in — Pflegehelfer/innen = помічник із догляду  
die Pflegekraft — Pflegekräfte = доглядальник  
die Reihe = черга  
der/die Sachbearbeiter/in — Sachbearbeiter/innen = спеціаліст із обробки  
der Sprachnachweis = підтвердження знання мови  
übereinstimmen — übereingestimmt = збігатися  
überglücklich = надзвичайно щасливий  
übersetzen — übersetzt = перекладати  
die Übersetzung — Übersetzungen = переклад  
das Übersetzungsbüro = бюро перекладів  
ungeduldig = нетерплячий  
vermissen — vermisst = сумувати  
verurteilen — verurteilt = засуджувати  
wahr = правдивий  
weitergehen — ist weitergegangen — ging weiter = продовжувати  
wohlfühlen sich — wohlgefühlt = почуватися добре  
das Ziel — Ziele = мета  
zügig = швидкий  
zusammenstellen — zusammengestellt = складати  
Ein neuer Arbeitsplatz = Нова робота  
abhängig = залежний  
absolvieren — absolviert = завершувати  
der/die Abteilungsleiter/in — Abteilungsleiter/innen = керівник відділу  
abwechslungsreich = різноманітний  
der/die Altenpfleger/in — Altenpfleger/innen = доглядальник за літніми людьми  
die Anlage = додаток  
die Annahme = припущення  
anrechnen — angerechnet = зараховувати  
die Anstellung = працевлаштування  
die Arbeitsstelle = робоче місце  
die Arbeitsweise = спосіб роботи  
die Arbeitszeit — Arbeitszeiten = робочий час  
die Assistenz = допомога  
die Aufteilung = розподіл  
der Auszug — Auszüge = витяг  
der Bachelor = бакалавр  
beherrschen — beherrscht = володіти  
beilegen — beigelegt = додавати  
die Berufsbezeichnung = назва професії  
die Berufserfahrung = професійний досвід  
das Berufsleben = професійне життя  
die Betriebswirtschaft = економіка підприємства  
beurteilen — beurteilt = оцінювати  
das Bewerbungsschreiben = лист-заявка  
der/die Bilanzbuchhalter/in — Bilanzbuchhalter/innen = бухгалтер балансу  
bisher = досі  
das Briefpapier = листовий папір  
das Büromaterial = офісні матеріали  
die Bürozeit — Bürozeiten = офісний час  
das Catering = кейтеринг  
daneben = поруч  
eigenverantwortlich = самостійно відповідальний  
eingehen — ist eingegangen — ging ein = надходити  
einschreiben — eingeschrieben — schrieb ein = записувати  
das Eintrittsdatum = дата вступу  
der Empfang = прийом  
empfangen — empfangen — empfing = отримувати  
englischsprachig = англомовний  
entnehmen — entnommen — entnahm = брати  
die Erstellung = створення  
färben — gefärbt = фарбувати  
das Fax = факс  
die Festanstellung = постійна робота  
festlegen — festgelegt = визначати  
finanziell = фінансовий  
das Finanzwesen = фінанси  
der Firmensitz = місце розташування компанії  
fließend = вільно  
der Föhn = фен  
fordern — gefordert = вимагати  
die Formulierung = формулювання  
die Fortbildung = підвищення кваліфікації  
die Frisur = зачіска  
die Gehaltsvorstellung = очікування зарплати  
der/die Geschäftsführer/in — Geschäftsführer/innen = директор  
die Geschäftsführung = керівництво  
gleichzeitig = одночасно  
die Handlung = дія  
die Herausforderung = виклик  
individuell = індивідуальний  
insofern = у цьому сенсі  
intern = внутрішній  
die Jobbezeichnung = назва посади  
der Kamm = гребінець  
die Kommunikationsstärke = комунікативна сила  
kommunikativ = комунікабельний  
der Konferenzraum = конференц-зал  
die Kontaktdaten (Pl.) = контактні дані  
kümmern sich — gekümmert = піклуватися  
leistungsgerecht = справедливий за вислугою  
leiten — geleitet = керувати  
der/die Manager/in — Manager/innen = менеджер  
der Maschinenbau = машинобудування  
meistern — gemeistert = опановувати  
der/die Millionär/in = мільйонер  
mittelständisch = середній бізнес  
nachdem = після того як  
das Niveau = рівень  
das Original = оригінал  
der PC — PCs = комп’ютер  
der Posteingang = вхідна пошта  
die Probezeit = випробувальний термін  
die Qualifikation — Qualifikationen = кваліфікація  
regeln — geregelt = регулювати  
der/die Sales Manager/in — Sales Manager/innen = менеджер із продажів  
schneiden — geschnitten — schnitt = різати  
das Schreiben = лист  
seitdem = відтоді  
der/die Selbstständige — Selbstständigen = самозайнятий  
senden — gesandt = надсилати  
das Seniorenheim = будинок для літніх людей  
soweit = наскільки  
die Speise — Speisen = страва  
spezialisieren sich — spezialisiert = спеціалізуватися  
die Stellenanzeige — Stellenanzeigen = оголошення про вакансію  
der Steuerberater = податковий консультант  
das Steuerberatungsbüro = бюро податкових консультацій  
die Teamfähigkeit = командна робота  
die Telekommunikation = телекомунікація  
der Terminkalender = календар зустрічей  
traditionsreich = багатий традиціями  
die Überstunde — Überstunden = понаднормова робота  
der Umgang = поводження  
die Umschulung = перекваліфікація  
unbefristet = необмежений  
das Unternehmen — Unternehmen = підприємство  
der Urlaubstag — Urlaubstage = день відпустки  
verabreden — verabredet = домовлятися  
die Vergütung = винагорода  
die Verstärkung = підсилення  
weiterhelfen — weitergeholfen — half weiter = допомагати далі  
die Weiterleitung = перенаправлення  
das Werkzeug = інструмент  
zaubern — gezaubert = чаклувати  
zeitlich = часовий  
der Zeitpunkt = момент  
zusätzlich = додатковий  
die Zusatzqualifikation = додаткова кваліфікація  
die Zuverlässigkeit = надійність  
Büroalltag = Офісні будні  
abdrehen — abgedreht = викручувати  
abheften — abgeheftet = підшивати  
allerdings = однак  
anmachen — angemacht = увімкнути  
ansehen — angesehen — sah an = дивитися  
aufdrehen — aufgedreht = відкручувати  
aufmachen — aufgemacht = відкривати  
ausschalten — ausgeschaltet = вимикати  
ausschlafen — ausgeschlafen = виспатися  
das Besprechungszimmer = кімната для нарад  
der Büroalltag = офісні будні  
der/die Büroassistent/in — Büroassistenten/Büroassistentinnen = офісний асистент  
der Büroraum — Büroräume = офісне приміщення  
die Dienstleistung — Dienstleistungen = послуга  
drinnen = всередині  
einschalten — eingeschaltet = вмикати  
die Energiekosten (Pl.) = витрати на енергію  
die Energieverschwendung = марнування енергії  
der/die Handwerker/in — Handwerker/innen = майстер  
die Heizkosten (Pl.) = витрати на опалення  
indem = тим, що  
kippen — gekippt = нахиляти  
der/die König/in — Könige/Königinnen = король  
der Kopierer — Kopierer = копіювальний апарат  
langfristig = довгостроковий  
mehrmals = кілька разів  
die Million — Millionen = мільйон  
mitdenken — mitgedacht — dachte mit = думати разом  
offen = відкритий  
die Privatnummer = приватний номер  
rasieren sich — rasiert = голитися  
die Reinigungsfirma = клінінгова компанія  
der Reinigungsvertrag = договір на прибирання  
senken — gesenkt = знижувати  
stinksauer (ugs.) = страшенно сердитий  
der Strom = електрика  
der Stromanbieter = постачальник електроенергії  
die Stromkosten (Pl.) = витрати на електрику  
tropfen — getropft = капати  
übergeben — übergeben — übergab = передавати  
unnötig = непотрібний  
der Verbrauch = споживання  
verschwenden — verschwendet = марнувати  
das Vertragsende = закінчення договору  
die Vertragsnummer = номер договору  
die Wärme = тепло  
der Wasserhahn = кран  
die Weise = спосіб  
zudrehen — zugedreht = закручувати  
zumachen — zugemacht = закривати  
die Zusammenarbeit = співпраця  
zusammenarbeiten — zusammengearbeitet = працювати разом  
Gesunde Ernährung = Здорове харчування  
abnehmen — abgenommen — nahm ab = худнути  
achten — geachtet = звертати увагу  
die Allergie = алергія  
allergisch = алергічний  
der Anbau = вирощування  
angewöhnen sich — angewöhnt = звикати  
auseinandersetzen sich — auseinandergesetzt = розбиратися  
ausgewogen = збалансований  
ausprobieren — ausprobiert = випробовувати  
bedenklich = сумнівний  
die Bedingung — Bedingungen = умова  
behaupten — behauptet = стверджувати  
die Berufstätigkeit = професійна діяльність  
die Bevölkerung = населення  
bewusst = свідомий  
bio (biologisch) = біо (біологічний)  
das Bioprodukt — Bioprodukte = біопродукт  
bloß = лише  
der/die Diabetiker/in — Diabetiker/innen = діабетик  
der Döner = дьонер  
durchschnittlich = середній  
das Einkommen — Einkommen = дохід  
einseitig = однобічний  
das Eiweiß = білок  
erkennen — erkannt = розпізнавати  
die Ernährung = харчування  
der/die Esser/in — Esser/innen = той, хто їсть  
das Fertiggericht = готова страва  
fett = жирний  
fix = швидкий  
fleischfrei = без м’яса  
fleischlos = безм’ясний  
der Freundeskreis = коло друзів  
der Frust = розчарування  
furchtbar = жахливий  
der Gang — Gänge = прохід  
der/die Gemüsehändler/in — Gemüsehändler/innen = продавець овочів  
der Geschmack = смак  
das Getreide = зерно  
glutenfrei = безглютеновий  
grundsätzlich = принципово  
der Hartweizen = тверда пшениця  
die Haselnuss — Haselnüsse = лісовий горіх  
der Hauptgrund — Hauptgründe = головна причина  
die Hülsenfrucht — Hülsenfrüchte = бобові  
industriell = промисловий  
die Institution — Institutionen = установа  
irgendwelche = якісь  
irgendwer = хтось  
das Kochbuch — Kochbücher = кулінарна книга  
kulinarisch = кулінарний  
laktosefrei = безлактозний  
die Laune = настрій  
leiden — gelitten = страждати  
die Massentierhaltung = масове утримання тварин  
der Milchzucker = молочний цукор  
moralisch = моральний  
der Nährstoff — Nährstoffe = поживна речовина  
das Nahrungsmittel — Nahrungsmittel = продукт харчування  
nebenbei = між іншим  
die Nuss — Nüsse = горіх  
präsentieren — präsentiert = презентувати  
problemlos = безпроблемний  
der Quark = сир  
reduzieren — reduziert = зменшувати  
die Studie = дослідження  
die Tiefkühlpizza — Tiefkühlpizzen = заморожена піца  
tierisch = тваринний  
der Trend = тенденція  
überzeugen — überzeugt = переконувати  
vegan = веганський  
der/die Veganer/in — Veganer/innen = веган  
vereinbar = сумісний  
versorgen — versorgt = забезпечувати  
vertragen — vertragen = переносити  
der Verzehr = споживання  
verzichten — verzichtet = відмовлятися  
vorbeigehen — ist vorbeigegangen — ging vorbei = проходити повз  
der Wert — Werte = цінність  
die Wurst — Würste = ковбаса  
der Zeitmangel = брак часу  
der Zeitungsbericht = газетний звіт  
zufällig = випадковий  
zunehmen — zugenommen — nahm zu = набирати вагу  
der Zusatzstoff — Zusatzstoffe = добавка  
Gut versichert! = Добре застрахований!  
abdecken — abgedeckt = покривати  
absichtlich = навмисно  
anfahren — ist angefahren — fuhr an = рушати  
ärztlich = медичний  
aufkommen — ist aufgekommen — kam auf = виникати  
ausparken — ausgeparkt = виїжджати з парковки  
der Außenspiegel — Außenspiegel = зовнішнє дзеркало  
der/die Autofahrer/in — Autofahrer/innen = водій  
die Automarke = марка автомобіля  
das Autoteil — Autoteile = автозапчастина  
die Autoversicherung = автострахування  
das Benzin = бензин  
beschädigen — beschädigt = пошкоджувати  
betrunken = п’яний  
der Blinker — Blinker = поворотник  
bremsen — gebremst = гальмувати  
das Dach = дах  
der Diebstahl = крадіжка  
das Dorf = село  
einbrechen — ist eingebrochen — brach ein = вламуватися  
der/die Einbrecher/in — Einbrecher/innen = злодій  
der Einbruch = крадіжка зі зламом  
einparken — eingeparkt = паркуватися  
die Fahrerseite = сторона водія  
der/die Freiwillige — Freiwilligen = доброволець  
frustriert = розчарований  
der Gebrauchtwagen — Gebrauchtwagen = вживаний автомобіль  
die Haftpflicht = цивільна відповідальність  
die Haftpflichtversicherung = страхування цивільної відповідальності  
der Hagel = град  
der Hügel = пагорб  
die Kaskoversicherung = страхування каско  
der Kilometer = кілометр  
der Kofferraum = багажник  
korrekt = правильний  
krachen — gekracht = грюкати  
der Kratzer — Kratzer = подряпина  
lenken — gelenkt = керувати  
lohnen sich — gelohnt = бути вартим  
der Motor — Motoren = двигун  
die Motorhaube = капот  
der/die Motorradfahrer/in — Motorradfahrer/innen = мотоцикліст  
nachdenken — nachgedacht — dachte nach = думати  
der Neuwagen — Neuwagen = новий автомобіль  
das Nummernschild — Nummernschilder = номерний знак  
der Oldtimer = ретроавтомобіль  
optimistisch = оптимістичний  
parken — geparkt = паркувати  
die Parklücke = місце для паркування  
der Personenschaden — Personenschäden = тілесне ушкодження  
PS (Pferdestärke) = к.с. (кінські сили)  
quietschen — gequietscht = пищати  
regulieren — reguliert = регулювати  
die Regulierung = регулювання  
der Reifen — Reifen = шина  
das Rücklicht — Rücklichter = заднє світло  
die Rückscheibe = заднє скло  
rückwärts = назад  
rutschen — ist gerutscht = ковзати  
der Sachschaden — Sachschäden = матеріальна шкода  
der Schadensfall = страховий випадок  
die Scheibe — Scheiben = скло  
der Scheinwerfer — Scheinwerfer = фара  
der Schläger = нападник  
schwingen — geschwungen — schwang = гойдатися  
der Sinn = сенс  
der Sportwagen = спортивний автомобіль  
die Stoßstange = бампер  
der Straßenrand = узбіччя  
der Straßenverkehr = дорожній рух  
der Sturm = шторм  
das/der Sport Utiliy Vehicle (SUV) = позашляховик  
die Teilkaskoversicherung (Teilkasko) = часткове страхування каско  
überraschen — überrascht = дивувати  
die Überschwemmung = повінь  
umfallen — ist umgefallen — fiel um = падати  
umso = тим більше  
der Unfall — Unfälle = аварія  
die Unfallgefahr = ризик аварії  
verletzen — verletzt = травмувати  
versehentlich = випадково  
versichern — versichert = страхувати  
der/die Versicherungsberater/in — Versicherungsberater/innen = страховий консультант  
der Versicherungsschutz = страховий захист  
verursachen — verursacht = спричиняти  
die Vollkaskoversicherung (Vollkasko) = повне страхування каско  
vorschreiben — vorgeschrieben — schrieb vor = приписувати  
vorsichtig = обережний  
wegfahren — ist weggefahren — fuhr weg = від’їжджати  
die Windschutzscheibe = лобове скло  
zulassen — zugelassen — ließ zu = допускати  
zusammenstoßen — ist zusammengestoßen — stieß zusammen = зіткнутися  
die Zusatzversicherung = додаткова страховка