go in = войти
get on = садиться (на транспорт), ладить
give back = возвращать
find out = узнавать, выяснять
call back = перезвонить
get off = выходить (из транспорта)
get back = возвращаться
grow up = взрослеть
wash up = мыться, умываться
drop by = заскочить, зайти в гости
come across = случайно встретить
bring up = поднимать (тему), воспитывать
come in = входить
come back = возвращаться
get along = ладить
get by = справляться
get over = пережить, справиться
get up = вставать
give up = сдаваться, бросать
go out = выходить (в свет), встречаться
hang out = проводить время, тусоваться
look after = заботиться, присматривать
look for = искать
look up = искать (информацию)
make up = выдумывать, мириться
pick up = подбирать, забирать
put off = откладывать, отталкивать
put on = надевать
run out = заканчиваться
take off = снимать (одежду), взлетать, уезжать
turn on = включать
turn up = появляться, увеличивать (звук и т.д.)
work out = заниматься спортом, разбираться с чем-то
call off = отменять
check out = проверить, осмотреть, выписаться
come up = возникать, появляться
cut down = сокращать, уменьшать
drop off = подбросить, завезти
fall apart = разваливаться
get away = уезжать, сбегать
give away = отдавать, раздавать
go ahead = начинать, продолжать
hang on = подождать
kick out = выгонять
pay back = возвращать долг
put up with = мириться с чем-то
turn down = отказываться, уменьшать (громкость, интенсивность)
wait up = не ложиться спать (ждать кого-то)
watch out = быть осторожным
break down = ломаться, расстраиваться
back up = поддерживать
calm down = успокаиваться
call around = обзванивать
give in = уступать
hold on = подождать, держаться
set up = организовывать, устанавливать
figure out = понять, разобраться
show up = появляться, приходить
run into = случайно встретить, столкнуться
look forward to = с нетерпением ждать
go over = просматривать, повторять
catch up = догонять, наверстывать
ASAP — как можно скорее
Cool — круто, классно
No worries — ничего страшного, не переживай
Dude — чувак
BRB (Be Right Back) — сейчас вернусь
YOLO (You Only Live Once) — живём один раз
Spill the tea — сплетничать, рассказывать новости
I can’t even! — просто нет слов!
No biggie — ничего особенного, не проблема
Off the hook — быть свободным от ответственности или наказания
In the zone — быть в отличной форме, на пике возможностей
Get under one’s skin — раздражать кого-то
Break the ice — растопить лёд, начать разговор
Under the weather — плохо себя чувствовать
Hit the sack — идти спать
Once in a blue moon — очень редко
Cut corners — делать что-то проще, экономить
Speak of the devil — лёгок на помине
Go the extra mile — сделать больше, чем требуется
Take with a pinch of salt — относиться с недоверием
Hold your horses — подожди, не спеши
Cold feet — струсить, испугаться в последний момент
Ruffle feathers — раздражать, злить
Hit me up — напиши/позвони мне
Keep me posted — держи меня в курсе
What’s up? / Wassup? / ’Sup? — как дела?
How’s it going? — как идут дела?
I hear you / I hear ya — понимаю тебя
Tell me about it — да уж, мне это знакомо
No way! — не может быть!
You bet! — ещё бы, конечно
My bad — моя ошибка, виноват
Trash (Rubbish) = Мусор
Restroom (Loo) = Туалет
Fall (Autumn) = Осень
Truck (Lorry) = Грузовик
Vacation (Holiday) = Отпуск, каникулы
Sidewalk (Pavement) = Тротуар
Flashlight (Torch) = Фонарик
Apartment (Flat) = Квартира
Cookie (Biscuit) = Печенье
Soccer (Football) = Футбол
kiddo = детка
buddy = дружище
Would you mind…? = Вы не возражаете…?
Could you…? = Не могли бы вы…?
gonna (going to) = собираюсь (сделать)
wanna (want to) = хочу (сделать)
gotta (got to) = надо (сделать)
a piece of cake = проще простого
spill the beans = раскрыть секрет
when pigs fly = когда рак на горе свистнет (никогда)
costs an arm and a leg = очень дорого
hit the jackpot = сорвать куш, добиться успеха
bite the bullet = стиснуть зубы, сделать неприятное
actions speak louder than words = дела важнее слов
all ears = внимательно слушать
back to the drawing board = начать сначала
barking up the wrong tree = ошибаться, обвинять не того
by the skin of one's teeth = едва-едва
cry over spilled milk = сожалеть о непоправимом
cut to the chase = перейти к сути
every cloud has a silver lining = нет худа без добра
face the music = отвечать за поступки
get cold feet = струсить
hit the nail on the head = попасть в точку
in the same boat = быть в одной ситуации
kill two birds with one stone = убить двух зайцев
let the cat out of the bag = выдать секрет
make a long story short = короче говоря
miss the boat = упустить шанс
no pain, no gain = без труда не вытащишь и рыбку из пруда
on the ball = быть на высоте
pull someone's leg = подшучивать
rain or shine = при любых обстоятельствах
read between the lines = читать между строк
rule of thumb = практическое правило
saved by the bell = быть спасённым в последний момент
see eye to eye = быть одного мнения
sit on the fence = занимать нейтральную позицию
take it with a grain of salt = относиться скептически
up in the air = неопределённо
you can't judge a book by its cover = не суди по внешности
zip it = замолчи