ist gewesen — wäre = был — был бы = 
ihr habt — hätte = прошедшее — имел бы = 
wird — ist geworden — wurde = будущее — стал — бы = 
konnte — könnte = мог — мог бы = 
von (Dativ) = от = 
der Mann — Männer = мужчина; человек = 
aus (Dativ) = из = 
richtig = правильно = 
nach (Dativ) = после; в = 
machen — gemacht = делать =
er gibt — gegeben — gab = давать = 
um (Akkusativ) = вокруг; ради; в (о времени) = 
gut — besser — am besten = хороший = 
wenn = если = 
bei (Dativ) = у; при = 
ist gegangen — ging = ходил = 
gehen um (Akkusativ) = (речь) идёт про
ist gekommen — kam = пришел; приехал = 
als = как; чем; когда = 
über = о; над; через = 
der Text — Texte = текст = 
noch = ещё = 
dann = тогда; затем = 
der Mensch — Menschen = человек = 
das Wort — Wörter = слово = 
falsch = неправильно = 
der Herr — Herren = господин = 
viel — mehr — am meisten = много = 
der Moderator — Moderatoren = модератор = 
immer = всегда = 
vor (Dativ) = перед; до = 
die Präposition — Präpositionen = предлог = 
schon = уже = 
sehr = очень = 
das Kind — Kinder = ребёнок = 
der Schuh — Schuhe = туфля; обувь = 
neu = новый = 
der Teil — Teile = часть = 
stehen — steht — gestanden — stand = стоять
sehen — sieht — gesehen — sah = видеть
heute = сегодня = 
ergänzen — ergänzt = дополнять
wollen — will — wollte = хотеть = 
groß — größer — am größten = большой = 
da = там; здесь; так как = 
das Jahr — Jahre = год = 
die Leute = люди = 
sollen — soll — sollte = должен; следует
die Frau — Frauen = женщина = 
doch = всё же; однако = 
mir = мне = 
ander = другой = 
welche = какой; который = 
ihnen = им; Вам = 
sprechen — spricht — gesprochen — sprach = говорить
sprechen mit (Dativ) über (Akkusativ) = говорить с (кем?) про (кого? что?)
sprechen von (Dativ) = упоминать о
sprechen für (Akkusativ) = говорить в пользу
sagen — gesagt = сказать; говорить
finden — findet — gefunden — fand = находить
das Leben — Leben = жизнь = 
etwas = что-то = 
das Haus — Häuser = дом = 
benutzen — benutzt = использовать = 
bis (Akkusativ) = до
ganz = весь; совсем = 
wissen — weiß — gewusst — wusste = знать
hören — gehört = слышать; слушать = 
jetzt = сейчас = 
möchten — möchte — möchte = хотел бы = 
passend = подходящий
schreiben — schreibt — geschrieben — schrieb = писать
schreibt an (Akkusativ) über (Akkusativ) = писать на (кого?) про (кого? что?)
das Kreuz — Kreuze = крест
denn = ведь; потому что = 
die Lösung — Lösungen = решение = 
der Tag — Tage = день = 
unser = наш = 
viel; viele = много; многие = 
wieder = снова = 
die Frage nach (Dativ) — Fragen = вопрос о
der Satz — Sätze = предложение = 
folgend = следующий
der Artikel — Artikel = статья; артикль
Deutschland = Германия = 
die Person — Personen = человек; личность
also = итак; следовательно
helfen — hilft — geholfen — half = помогать
helfen bei (Dativ) = помогать в
hier = здесь = 
leben — gelebt = жить = 
lernen — gelernt = учиться = 
wichtig = важный = 
die Aufgabe — Aufgaben = задание = 
das Auto — Autos = автомобиль = 
der Freund — Freunde = друг = 
die Grammatik — Grammatiken = грамматика = 
alle = все = 
denken — denkt — gedacht — dachte = думать
denken an (Akkusativ) = думать про
durch (Akkusativ) = через; сквозь
gern = охотно = 
ob = ли; если = 
das Beispiel — Beispiele = пример = 
fahren — fährt — ist gefahren — fuhr = ехать; водить
jeder = каждый = 
lesen — liest — gelesen — las = читать
mich = меня = 
der Film — Filme = фильм = 
der Hauptsatz — Hauptsätze = главное предложение
die Mail — Mails = письмо (электронное) = 
die Schule — Schulen = школа = 
die Zeit für (Akkusativ) — Zeiten = время для = 
bekommen — bekommt — bekommen — bekam = получать
dazu = к этому = 
einmal = один раз; однажды = 
früh = рано = 
verstehen — versteht — verstanden — verstand = понимать
warum = почему = 
wo = где = 
die Antwort auf (Akkusativ) — Antworten = ответ на
der Computer — Computer = компьютер = 
das Verb — Verben = глагол = 
weil = потому что = 
die Aussage — Aussagen = утверждение
das Partizip — Partizipien = причастие (делающий)
ohne (Akkusativ) = без
wenig = мело = 
wer = кто = 
der Ausdruck — Ausdrücke = выражение
die Information — Informationen = информация = 
die Stadt — Städte = город = 
arbeiten — gearbeitet = работать = 
heißen — heißt — geheißen — hieß = называться; звать
kaufen — gekauft = покупать = 
der Kasten — Kästen = ящик; коробка
ordnen — geordnet = упорядочивать
alt — älter — am ältesten = старый
bleiben — bleibt — ist geblieben — blieb = оставаться
erste = первый = 
müssen — muss — musste = нужно (сделать)
suchen — gesucht = искать = 
sucht nach (Dativ) = искать (что?)
treffen sich — trifft — getroffen — traf = встречаться
uns = нас, нам = 
die Arbeit an (Dativ) — Arbeiten = работа над = 
der Grund für (Akkusativ) — Gründe = причина для
das Land — Länder = страна
der Plural = множественное число = 
das Thema — Themen = тема = 
die Uhr — Uhren = часы
der Wortschatz — Wortschätze = словарный запас
brauchen — gebraucht — brauchte = нуждаться
dafür = для этого = 
dort = там = 
die Überschrift — Überschriften = заголовок
bringen — bringt — gebracht — brachte = приносить
bringen zu (Dativ) = приносить (кому?)
die Familie — Familien = семья = 
das Geld = деньги = 
das Kino — Kinos = кино = 
der Nebensatz — Nebensätze = придаточное предложение = 
der Relativsatz — Relativsätze = относительное придаточное предложение = 
beginnen — beginnt — begonnen — begann = начинать с
beginnen mit (Dativ) = начинать с 
einfach = просто; простой = 
lange = долго = 
markieren — markiert = отмечать
zusammen = вместе = 
die Form — Formen = форма = 
die Kirche — Kirchen = церковь = 
der Konjunktiv = сослагательное наклонение
der Passiv = пассивный залог = 
die Prüfung — Prüfungen = экзамен; проверка = 
ab (Dativ) = с; от
dein = твой = 
dürfen — darf — durfte = мочь; разрешать
freuen sich — freut — gefreut — freute = радоваться
freuen sich über (Akkusativ) auf (Akkusativ) = радоваться о (прошлом, настоящем) в (будущем)
kennen — kennt — gekannt — kannte = знать; быть знакомым
oft — öfter — am öftesten = часто
häufig — häufiger — am häufigsten = часто
zufrieden mit (Dativ) = довольный (чем?)
die Eltern = родители = 
der Euro — Euros = евро = 
die Sprache — Sprachen = язык = 
das Tier — Tiere = животное
deutsch = немецкий = 
dir = тебе = 
fragen — fragt — gefragt — fragte = спрашивать
fragen nach (Dativ) = спрашивать о (ком? чём?)
nehmen — nimmt — genommen — nahm = брать
nächste = следующий
passen — passt — gepasst — passte = подходит
passen zu (Dativ) = подходит к
schnell — schneller — am schnellsten = быстрый = 
zwischen (Dativ) = между
das Ende — Enden = конец
die Freundin — Freundinnen = подруга = 
die Hilfe für (Akkusativ) — Hilfen = помощь для
der Partner — Partner = партнёр
die Partnerin — Partnerinnen = партнёрша = 
der Singular = единственное число = 
der Urlaub — Urlaube = отпуск
die Zahl — Zahlen = число
beide = оба = 
bilden — bildet — gebildet = образовывать
gegen; wider (Akkusativ) = против
gestern = вчера = 
gleich = сразу; одинаковый
klein — kleiner — am kleinsten = маленький
liegen — liegt — gelegen — lag = лежать
mal = раз
nichts = ничего
schön — schöner — am schönsten = красивый
weit — weiter — am weitesten = далеко; широкий
die Beziehung — Beziehungen = отношение
das Buch — Bücher = книга
der Kaffee — Kaffees = кофе
München = Мюнхен
der Name — Namen = имя
die Woche — Wochen = неделя
bekannt = известный
darauf = на это
erhalten — erhält — erhalten — erhielt = получать
essen — isst — gegessen — aß = есть; кушать
geradeaus = прямо
gerade = только что
möglich = возможный = 
schlecht — schlechter — am schlechtesten = плохой =
spät = поздно = 
statt (Dativ) = вместо
die Angst vor (Dativ) — Ängste = страх перед = 
das Internet = интернет = 
das Kapitel — Kapitel = глава
das Subjekt — Subjekte = подлежащее
die Vorstellung von (Dativ) — Vorstellungen = представление, воображение о
die Zeitung — Zeitungen = газета = 
allerdings = однако
bitte = пожалуйста = 
damit = этим; чтобы = 
halten — hält — gehalten — hielt = держать
ihm = ему = 
mögen — mag — mochte = любить; нравиться
setzen — setzt — gesetzt = ставить; садиться
wählen — wählt — gewählt = выбирать
das Hörverstehen = аудирование
der Ort — Orte = место = 
das Wetter — Wetter = погода = 
die Zukunft = будущее = 
bauen — baut — gebaut = строить
bieten — bietet — geboten — bot = предлагать
deshalb = поэтому = 
eigen = собственный
erzählen — erzählt — erzählt = рассказывать
erzählen von (Dativ) = рассказывать о
jemand = кто-то
nennen — nennt — genannt — nannte = называть
passieren — passiert — ist passiert = происходить = 
schwer — schwerer — am schwersten = тяжёлый; сложный = 
selbst = сам = 
stellen — stellt — gestellt = ставить
vielleicht = возможно; может быть = 
wegen (Genitiv) = из-за
während (Genitiv) = во время
zuerst = сначала = 
das Adjektiv — Adjektive = прилагательное = 
das Bild — Bilder = картина; образ
die Endung — Endungen = окончание
die Firma — Firmen = фирма
das Hotel — Hotels = отель
mündlich — mündlicher — mündlichsten = устный
die Nachricht von (Dativ) — Nachrichten = сообщение, новость о
Präteritum = прошедшее время = 
die Reihenfolge — Reihenfolgen = последовательность
bedeuten — bedeutet — bedeutet = означать = 
eben = только что; ровно
entscheiden — entscheidet — entschieden — entschied = решать
genau = точно = 
handeln — handelt — gehandelt = действовать (поступать), торговать
es handelt sich um (Akkusativ) = говорится про (кого? что?)
handeln von (Dativ) = говорит про
ihn = его = 
manchmal = иногда = 
sondern = а (в противопоставлении)
spielen — spielt — gespielt = играть = 
steigen — steigt — ist gestiegen — stieg = подниматься
der Berg — Berge = гора = 
die Deklination — Deklinationen = склонение
die Lese = чтение
die Meinung — Meinungen = мнение = 
das Recht — Rechte = право
der Satzbau — Satzbaus = построение предложения
die Situation — Situationen = ситуация = 
die Tür — Türen = дверь = 
der Vater — Väter = отец = 
die Welt — Welten = мир = 
bald = скоро = 
bestehen — besteht — bestanden — bestand = выдерживать
bestehen auf (Dativ) = настаивать на
es besteht aus (Dativ) = это состоит из
fliegen — fliegt — ist geflogen — flog = летать
gesund = здоровый
lachen — lacht — gelacht — lachte = смеяться
meinen — meint — gemeint = иметь в виду
sitzen — sitzt — gesessen — saß = сидеть
studieren — studiert — studiert = учиться (в вузе)
trinken — trinkt — getrunken — trank = пить
tun — tut — getan — tat = делать
verdienen — verdient — verdient = зарабатывать
vergessen — vergisst — vergessen — vergaß = забывать
warten — wartet — gewartet — wartete = ждать
warten auf (Akkusativ) = ждать (кого? что?)
wohl = вероятно; хорошо
überhaupt = вообще
überzeugen — überzeugt — überzeugt = убеждать
überzeugen von (Dativ) = убеждать в
der Anfang — Anfänge = начало
die Beschwerde über (Akkusativ) — Beschwerden = жалоба про 
die Ernährung — Ernährungen = питание
die Geschichte — Geschichten = история
das Interesse an (Dativ) — Interessen = интерес к
die Lücke — Lücken = пробел
die Million — Millionen = миллион = 
der Nachbar — Nachbarn = сосед = 
die Party — Partys = вечеринка = 
der Roman — Romane = роман
der Track — Tracks = трек
der Vortrag — Vorträge = доклад
die Wahl — Wahlen = выбор
bestimmt = определённый
besuchen — besucht — besucht = посещать
daran = об этом = 
darüber = об этом; над этим = 
dich = тебя = 
endlich = наконец
fest = твёрдый; постоянный
gehören — gehört — gehört = принадлежать
gemeinsam = вместе
glauben — glaubt — geglaubt — glaubte = верить в
glauben an (Akkusativ) = верить в
lang — länger — am längsten = длинный; долгий
lassen — lässt — gelassen — ließ = оставлять; позволять
letzte = последний = 
mehrere = несколько
seit (Dativ) = с (о времени)
tragen — trägt — getragen — trug = носить
vorstellen — stellt vor — vorgestellt — stellte vor = представлять
wahrscheinlich = вероятно = 
zurück = обратно = 
die Angabe — Angaben = указание
das Angebot — Angebote = предложение = 
der August = август = 
das Bio = био (органический) = 
der Chef — Chefs = начальник = 
die Entscheidung — Entscheidungen = решение
der Erfolg — Erfolge = успех = 
die Ergänzung — Ergänzungen = дополнение
der Fall — Fälle = случай
das Gefühl — Gefühle = чувство
der Hund — Hunde = собака
die Idee — Ideen = идея = 
der Kunde — Kunden = клиент = 
Plusquamperfekt = предпрошедшее время = 
die Position — Positionen = позиция = 
das Produkt — Produkte = продукт = 
die Pronominaladverbien (da-, wo-) = местоименные наречия 
das Relativpronomen — Relativpronomen (der, die, das) = относительное местоимение (который, которая, которые)
der Sport — Sportarten = спорт = 
am (Dativ) = в; на
besonders = особенно
bloß = только; лишь
daher = поэтому
davon = об этом; от этого = 
erleben — erlebt — erlebt = переживать; испытывать
frei von (Dativ) = свободный от
gelten — gilt — gegolten — galt = действовать; считаться
hoch — höher — am höchsten = высокий
laut — lauter — lautesten = громкий = 
schließen — schließt — geschlossen — schloss = закрывать
unter = под
wirklich = действительно
ändern — ändert — geändert = менять
der Abend — Abende = вечер = 
die Anzeige — Anzeigen = объявление
die Erfahrung — Erfahrungen = опыт = 
die Erwartung — Erwartungen = ожидание
das Essen — Essen = еда
der Gedanke an (Akkusativ) — Gedanken = мысль о
der Infinitiv — Infinitive = инфинитив = 
der Kurs — Kurse = курс = 
die Liebe zu (Dativ) — Lieben = любовь к
die Maßschuhe = обувь на заказ
das Modalverb — Modalverben = модальный глагол = 
das Paar — Paare = пара
das Problem — Probleme = проблема = 
das Pronomen — Pronomen = местоимение
das Präsens = настоящее время
der Prüfungsteil — Prüfungsteile = часть экзамена
die Rede — Reden = речь
die Regel — Regeln = правило
die Schlüsselwörter = ключевые слова
die Seite — Seiten = страница; сторона
der Slum — Slums = трущобы
der Spaß = веселье
das Theater — Theater = театр
die Vergangenheit — Vergangenheiten = прошлое
außer (Dativ) = кроме
eigentlich = вообще-то; на самом деле
einige = некоторый
entwickeln — entwickelt — entwickelt = развивать
erkennen — erkennt — erkannt — erkannte = узнавать; распознавать
erst = только; сначала
funktionieren — funktioniert — funktioniert = работать (о механизмах)
glücklich = счастливый = 
infolge (Genitiv) = вследствие
jung — jünger — am jüngsten = молодой
manche = некоторый = 
der Meister — Meister = мастер = 
natürlich = естественно = 
nie = никогда = 
obwohl = хотя = 
ordnen — ordnet — geordnet = упорядочивать
sicher = уверенный; безопасный = 
trotz (Genitiv) = несмотря на
verbringen — verbringt — verbracht — verbrachte = проводить (время)
wohnen — wohnt — gewohnt = жить (проживать)
zahlen — zahlt — gezahlt = платить = 
zeigen — zeigt — gezeigt = показывать = 
der Absatz — Absätze = абзац; каблук
die Ausbildung — Ausbildungen = образование; обучение = 
Europa = Европа = 
der Gast — Gäste = гость = 
die Homepage — Homepages = домашняя страница = 
die Katze — Katzen = кошка = 
der Kauf — Käufe = покупка
die Kleidung — Kleidungen = одежда = 
der Konnektor — Konnektoren = соединитель
Latein = латынь
der Lehrer — Lehrer = учитель = 
das Leseverstehen = понимание прочитанного
die Minute — Minuten = минута = 
der Monat — Monate = месяц = 
das Musical — Musicals = мюзикл = 
die Musik = музыка = 
die Nummer — Nummern = номер = 
die Sache — Sachen = вещь; дело = 
die Schweiz = Швейцария = 
der Schüler — Schüler = ученик = 
der Sprecher — Sprecher = оратор; диктор = 
die Stelle — Stellen = место; должность
die Straße — Straßen = улица = 
die Stunde — Stunden = час = 
Stuttgart = Штутгарт = 
der Termin — Termine = срок; встреча = 
der Tipp — Tipps = совет = 
die Transkription — Transkriptionen = транскрипция = 
der Unfall — Unfälle = авария
das Ziel — Ziele = цель = 
anbieten — bietet an — angeboten — bot an = предлагать
ausdrücken — drückt aus — ausgedrückt — drückte aus = выражать
bitten um (Akkusativ) — bittet — gebeten — bat = просить о
dabei = при этом = 
dankbar für (Akkusativ) = благодарный за
dauern — dauert — gedauert = длиться; продолжаться = 
eingehen — geht ein — ist eingegangen — ging ein = входить, поступать (о сообщении, предложении)
eingehen auf (Akkusativ) — er geht auf (Akkusativ) ein = вдаваться в, принять во внимание, согласится на
einverstanden mit (Dativ) = согласный с
erinnern (sich) — erinnert — erinnert = напоминать (вспомнить)
erinnern (sich) an (Akkusativ) = напоминать (вспомнить) про (кого? что?)
fallen — fällt — ist gefallen — fiel = падать
fühlen sich — fühlt — gefühlt — fühlte = чувствовать
gegenüber (Dativ) = напротив; по отношению к
gewinnen — gewinnt — gewonnen — gewann = выигрывать
hin = туда
interessiert an (Dativ) = заинтересованный в
jeweils = каждый раз; соответственно
kaum = едва; почти не
kurz — kürzer — am kürzesten = короткий
lieben — liebt — geliebt = любить
lösen — löst — gelöst = решать; развязывать
müde von (Dativ) = уставший от
neutral = нейтральный
niemand = никто
reparieren — repariert — repariert = ремонтировать
schicken — schickt — geschickt = отправлять
sowie = а также
stimmen — stimmt — gestimmt = соответствовать; голосовать
teils = частично
verlassen — verlässt — verlassen — verließ = покидать; оставлять
verlieren — verliert — verloren — verlor = терять; проигрывать
verschieden = различный
voll — voller — am vollsten = полный
ziehen — zieht — gezogen — zog = тянуть; переезжать
die Übung — Übungen = упражнение
die Adjektivendung — Adjektivendungen = окончание прилагательного
das Alter — Alter = возраст
das Argument — Argumente = аргумент
die Bedeutung — Bedeutungen = значение
Berlin = Берлин = 
der Beruf — Berufe = профессия = 
die Bildung — Bildungen = образование; формирование
das Cafe — Cafes = кафе = 
das Einkaufszentrum — Einkaufszentren = торговый центр
das Fahrrad — Fahrräder = велосипед = 
der Fehler — Fehler = ошибка = 
das Fenster — Fenster = окно = 
das Fernsehen = телевидение
der Fernseher — Fernseher = телевизор
das Fest — Feste = праздник
das Geschenk — Geschenke = подарок
die Gesellschaft — Gesellschaften = общество; компания
der Haarausfall = выпадение волос
der Haushalt — Haushalte = хозяйство; бюджет
der Hinweis — Hinweise = указание; подсказка
die Karte — Karten = карта; билет
das Komma — Kommata = запятая
die Kosten = расходы
das Krankenhaus — Krankenhäuser = больница
das Modell — Modelle = модель
die Möglichkeit — Möglichkeiten = возможность = 
der Müll = мусор = 
die Polizei — Polizeien = полиция
die Post — Posten = почта = 
der Preis — Preise = цена; приз
der Rat — Räte = совет
der Satzteil — Satzteile = часть предложения
der Schuhmacher — Schuhmacher = сапожник
der Service — Services = сервис; обслуживание
der Single — Singles = одиночка; сингл
das Stück — Stücke = кусок; штука
das Telefon — Telefone = телефон
die Veranstaltung — Veranstaltungen = мероприятие
der Verkehr = движение; транспорт
der Vorteil — Vorteile = преимущество = 
die Werkstatt — Werkstätten = мастерская
die Wohnung — Wohnungen = квартира
das Wörterbuch — Wörterbücher = словарь
der Zweifel — Zweifel = сомнение
abholen — holt ab — abgeholt — holte ab = забирать
dagegen = против этого
darin = в этом; внутри = 
entspannen — entspannt — entspannt = расслабляться
entstehen — entsteht — ist entstanden — entstand = возникать
etwa = примерно
folgen — folgt — ist gefolgt = следовать
formell = формальный
froh über; auf (Akkusativ) = радостный по поводу
fällen — fällt — gefällt = валить (дерево)
führen — führt — geführt = вести; руководить
gar = вовсе; даже
gering — geringer — am geringsten = небольшой; низкий
grau = серый = 
hängen — hängt — gehangen — hing = висеть
kochen — kocht — gekocht = готовить (еду)
konzentrieren sich — konzentriert — konzentriert = сосредотачиваться
konzentrieren sich auf (Akkusativ) = сосредотачиваться на
laufen — läuft — ist gelaufen — lief = бегать; идти (о ТВ)
leider = к сожалению = 
lieb = милый; дорогой
maskulin = мужской
nachdem = после того как
nachdenken — denkt nach — nachgedacht — dachte nach = размышлять
nachdenken über (Akkusativ) = размышлять о
nämlich = а именно
plötzlich = внезапно = 
schließlich = в конце концов
der Sprachbaustein — Sprachbausteine = языковой элемент
ständig = постоянно
tatsächlich = действительно
toll = классный; большой = 
verwenden — verwendet — verwendet = использовать
wann = когда = 
weder … noch … = ни то …, ни это …
wohin = куда = 
zwar = хотя; правда
ärgern sich — ärgert — geärgert — ärgerte = сердиться
ärgern sich über (Akkusativ) = сердиться из-за
übrigens = кстати
das Adverb — Adverbien = наречие (прилагательное у глагола)
der Arbeitnehmer — Arbeitnehmer = работник
der Arm — Arme = рука
der Arzt — Ärzte = врач = 
der Aspekt — Aspekte = аспект
die Autobahn — Autobahnen = автобан = 
der Bauer — Bauern = крестьянин; фермер = 
der Begriff — Begriffe = понятие, термин
die Behinderung — Behinderungen = инвалидность; препятствие
der Bekannte — Bekannten = знакомый
der Besuch — Besuche = визит
das Büro — Büros = офис = 
die Dame — Damen = дама; женщина = 
der Dank für (Akkusativ) — Danke = благодарность за
der Deutschkurs — Deutschkurse = курс немецкого языка = 
der Dialekt — Dialekte = диалект = 
das Ding — Dinge = вещь = 
das Eis — Eise = лёд; мороженое = 
die Freude an (Dativ) — Freuden = радость от
die Freude über (Akkusativ) auf (Akkusativ) — Freuden = радость в (прошлом, сейчас) в (будущем)
der Geburtstag — Geburtstage = день рождения = 
die Gegenwart = настоящее (время)
das Gerät — Geräte = устройство = 
das Gespräch — Gespräche = разговор
die Grafik — Grafiken = графика
die Hausaufgabe — Hausaufgaben = домашнее задание = 
indirekt = косвенный
die Kartoffel — Kartoffeln = картофель = 
der Kollege — Kollegen = коллега = 
der Kontext — Kontexte = контекст = 
der Kopfschmerz — Kopfschmerzen = головная боль = 
die Kritik — Kritiken = критика
der Liebesfilm — Liebesfilme = мелодрама
die Meldung — Meldungen = сообщение
der Montag — Montage = понедельник = 
der Morgen — Morgen = утро = 
das Paket — Pakete = посылка = 
der Patient — Patienten = пациент = 
das Programm — Programme = программа = 
die Reise — Reisen = путешествие = 
der Rhein = Рейн (река) = 
die Schlange — Schlangen = змея; очередь = 
die Schokolade — Schokoladen = шоколад = 
der Stau — Staus = пробка (дорожная) = 
die Tabelle — Tabellen = таблица
der Test — Tests = тест = 
die Textstelle — Textstellen = место в тексте
der Tisch — Tische = стол = 
die Tochter — Töchter = дочь = 
die Umfrage — Umfragen = опрос
der Umlaut — Umlaute = умляут = 
das Unternehmen — Unternehmen = предприятие
die Verbindung — Verbindungen = связь
der Verlust — Verluste = потеря
das Warenhaus — Warenhäuser = универмаг
die Warnung vor (Dativ) — Warnungen = предупреждение о
der Wunsch — Wünsche = желание
der Zug — Züge = поезд = 
allein = один; одиноко = 
außerdem = кроме того = 
begeistern — begeistert — begeistert = восхищать
beherrschen — beherrscht — beherrscht = владеть
berichten — berichtet — berichtet = сообщать, упоминать
berichten über (Akkusativ) = сообщать о
berichten von (Dativ) = упоминать о
berücksichtigen — berücksichtigt — berücksichtigt = учитывать
bevor = перед тем как
bezahlen — bezahlt — bezahlt = платить
christlich = христианский
danken — dankt — gedankt = благодарить
davor = до этого
deutlich = ясно; отчётливо
dritte = третий = 
drücken — drückt — gedrückt = нажимать; прижимать
durchführen — führt durch — durchgeführt = проводить
eher = скорее; раньше
erfahren — erfährt — erfahren — erfuhr = узнавать; испытывать
ergeben — ergibt — ergeben — ergab = давать (результат)
erklären — erklärt — erklärt = объяснять = 
erwarten — erwartet — erwartet = ожидать = 
fertig mit (Dativ) = закончить (готово) что-то
freundlich = дружелюбный = 
geehrt = уважаемый
halb = половина = 
interessieren sich — interessiert — interessiert = интересоваться
interessieren sich für (Akkusativ) = интересоваться про (кого? что?)
kaputt = сломанный
kosten — kostet — gekostet = стоить = 
kulturell = культурный
leiden — leidet — gelitten — litt = страдать от
leiden an (Dativ) = страдать от
leiden unter (Dativ) = страдать под (влиянием)
meistens = чаще всего
morgens = по утрам = 
paar = пара = 
planen — plant — geplant = планировать = 
reden — redet — geredet = говорить = 
reich an (Dativ) — reicher — am reichsten = богатый (чем?)
reisen — reist — gereist = путешествовать = 
rot = красный = 
scheinen — scheint — geschienen — schien = казаться; светить
schenken — schenkt — geschenkt = дарить
schlafen — schläft — geschlafen — schlief = спать = 
singen — singt — gesungen — sang = петь
spazieren — spaziert — spaziert = гулять = 
stark — stärker — am stärksten = сильный
stolz auf (Akkusativ) = гордый чем-то
teuer — teurer — am teuersten = дорогой = 
typisch = типичный = 
unbedingt = обязательно
unterrichten — unterrichtet — unterrichtet = преподавать, сообщать
unterrichten in (Dativ) = преподавать (что?)
unterrichten von (Dativ) = сообщать о
unterstrichen = подчёркнутый
versprechen — verspricht — versprochen — versprach = обещать
vorbei = мимо; законченный
warm — wärmer — am wärmsten = тёплый
weiß = белый = 
wen = кого = 
wünschen — wünscht — gewünscht = желать
übrig = оставшийся
das Aktiv — Aktive = активный залог = 
das Amt — Ämter = ведомство; должность
die App — Apps = приложение = 
der Arbeitgeber — Arbeitgeber = работодатель = 
der Architekt — Architekten = архитектор = 
die Armut = бедность
die Art — Arten = вид; тип
die Auffassung — Auffassungen = мнение; понимание
die Auskunft — Auskünfte = справка; информация
das Ausland — Ausländer = заграница
das Baby — Babys = младенец = 
der Ball — Bälle = мяч = 
die Bank — Bänke = банк; скамейка = 
der Beginn — Beginne = начало
die Beispielprüfung — Beispielprüfungen = примерный экзамен
der Besucher — Besucher = посетитель
die Bevölkerung — Bevölkerungen = население
der Brief — Briefe = письмо = 
die Chemie — Chemien = химия
der Club — Clubs = клуб = 
die Diät — Diäten = диета
der Einsteiger — Einsteiger = новичок
der Elefant — Elefanten = слон = 
das Ergebnis — Ergebnisse = результат = 
das Erlebnis — Erlebnisse = переживание = 
die Erziehung — Erziehungen = воспитание
das Fahrzeug — Fahrzeuge = транспортное средство
das Fleisch — Fleischer = мясо = 
die Folge — Folgen = следствие; эпизод
die Freizeit — Freizeiten = свободное время = 
die Fußprobleme = проблемы с ногами
das Gemüse — Gemüse = овощи
der Geschmack nach (Dativ) — Geschmäcker = вкус (чего?)
die Gitarre — Gitarren = гитара = 
das Glück = счастье = 
griechisch = греческий язык
das Gymnasium — Gymnasien = гимназия = 
die Hand — Hände = рука = 
die Handlung — Handlungen = действие; сюжет
das Handy — Handys = мобильный телефон = 
das Heimatland — Heimatländer = родина
die Heirat — Heiraten = свадьба; женитьба
das Herz — Herzen = сердце = 
die Hose — Hosen = брюки = 
die Impfung — Impfungen = прививка
Indien = Индия = 
die Insel — Inseln = остров = 
die Intuition — Intuitionen = интуиция = 
Italien = Италия = 
die Jahreszeit — Jahreszeiten = время года = 
das Jahrhundert — Jahrhunderte = век
das Kasussymbol — Kasussymbole = символ падежа
die Konjunktur — Konjunkturen = конъюнктура (условия, влияющие на ситуацию) = 
das Konzert — Konzerte = концерт = 
der Kopf — Köpfe = голова = 
das Korrelat — Korrelate = соответствие (что-то, что относится к чему-то другому)
die Krankheit — Krankheiten = болезнь = 
Köln = Кёльн = 
das Können = умение
der Liebeskummer = любовная тоска
die Luft — Lüfte = воздух = 
die Lust auf (Akkusativ) — Lüste = желание (чего?)
der Mai = май = 
die Maschine — Maschinen = машина = 
der Meter — Meter = метр = 
der Mitarbeiter — Mitarbeiter = сотрудник = 
die Mutter — Mütter = мать = 
die Nacht — Nächte = ночь = 
das Nomen — Nomen = существительное = 
die Not — Nöte = нужда
die Note — Noten = оценка; нота
die Notiz — Notizen = заметка
der Nullartikel — Nullartikel = нулевой артикль
die Ortsangabe — Ortsangaben = указание места
das Parlament — Parlamente = парламент = 
die Pause — Pausen = пауза = 
der Plan — Pläne = план = 
der Platz — Plätze = место = 
der Punkt — Punkte = точка = 
die Redemittel = средства выражения
die Regenbogenpresse = жёлтая пресса
die Richtung — Richtungen = направление = 
der Schweizer — Schweizer = швейцарец = 
die Schwester — Schwestern = сестра = 
der See — Seen = озеро = 
die Sehenswürdigkeit — Sehenswürdigkeiten = достопримечательность = 
das Sein = бытие
der Sommer — Sommer = лето = 
der Sonntag — Sonntage = воскресенье = 
das Spiel — Spiele = игра = 
der Stadtpark — Stadtparks = городской парк = 
die Stimme — Stimmen = голос
die Suche nach (Dativ) — Suchen = поиск (чего?) = 
die Tastatur — Tastaturen = клавиатура = 
die Tollwut = бешенство
der Unsinn = чепуха
der Unterricht — Unterrichte = урок; преподавание
die Vermutung — Vermutungen = предположение
das Verständnis für (Akkusativ) — Verständnisse = понимание (чего?)
das Wasser = вода = 
der Winter — Winter = зима = 
die Wirtschaft — Wirtschaften = экономика = 
der Zustand — Zustände = состояние = 
abhalten — hält ab — abgehalten — hielt ab = проводить; удерживать
ach; achso = ах; ах так = 
anfangen — fängt an — angefangen — fing an = начинать
anfangen mit (Dativ) = начинать с
angenehm für (Akkusativ) = приятный для
ankommen — kommt an — ist angekommen — kam an = прибывать
ankommen auf (Akkusativ) = зависеть от (кого? что?)
anlässlich (Genitiv) = по случаю
anrufen — ruft an — angerufen — rief an = звонить
anrufen bei (Dativ) = звонить (кому?)
ansehen — sieht an — angesehen — sah an = рассматривать
antworten — antwortet — geantwortet = отвечать = 
antworten auf (Akkusativ) mit (Dativ) = отвечать на (что?) с помощью (чего?)
aufgrund (Genitiv) = на основании
ausbilden — bildet aus — ausgebildet — bildete aus = обучать
aussehen — sieht aus — ausgesehen — sah aus = выглядеть
bedanken — bedankt — bedankt — bedankte = благодарить
bedanken sich bei (Dativ) für (Akkusativ) = благодарить у (кого?) за (что?)
beenden — beendet — beendet = заканчивать
bereit zu (Dativ) = готовый к
beschweren sich — beschwert — beschwert = жаловаться
beschweren sich bei (Dativ) über (Akkusativ) = жаловаться (кому?) про (кого? что?)
bestätigen — bestätigt — bestätigt = подтверждать
beteiligen — beteiligt — beteiligt = участвовать
bewegen (sich) — bewegt — bewegt = двигать (двигаться)
bewusst = сознательный
bezüglich (Genitiv) = относительно
danach = после этого
je mehr, desto (umso) besser = чем больше, тем лучше = 
deswegen = поэтому = 
direkt = прямо; непосредственно = 
drehen — dreht — gedreht = вращать = 
enthalten — enthält — enthalten — enthielt = содержать
entlang (Genitiv) = вдоль
enttäuschen — enttäuscht — enttäuscht = разочаровывать
erledigen — erledigt — erledigt = выполнять; завершать
erreichen — erreicht — erreicht = достигать
erzielen — erzielt — erzielt = достигать; получать
europäisch = европейский
fehlend = отсутствующий
feiern — feiert — gefeiert = праздновать
fordern — fordert — gefordert = требовать
französisch = французский = 
frisch — frischer — am frischesten = свежий = 
fähig zu (Dativ) = способный к
gültig = действительный
günstig — günstiger — am günstigsten = выгодный; дешёвый = 
halt = ну; ведь
heiraten — heiratet — geheiratet = жениться; выходить замуж
insgesamt = всего, вообще = 
international = международный = 
jugendliche = юношеский (подростковый)
klingeln — klingelt — geklingelt = звонить (о звонке)
kostenlos = бесплатный = 
kümmern sich — kümmert — gekümmert = заботиться о
kümmern sich um (Akkusativ) = заботиться о
langweilen — langweilt — gelangweilt = скучать; надоедать
leicht — leichter — am leichtesten = лёгкий
lenken — lenkt — gelenkt = направлять; управлять
los = прочь; началось
mindestens = по крайней мере
mitteilen — teilt mit — mitgeteilt = сообщать
neugierig auf (Akkusativ) = любопытный к
nun = теперь = 
pünktlich = пунктуальный = 
reagieren — reagiert — reagiert = реагировать на
reagieren auf (Akkusativ) = реагировать на
renovieren — renoviert — renoviert = ремонтировать (обновлять)
sauer = кислый = 
sauer auf (Akkusativ) = обида, досада от
schaffen — schafft — geschafft = справляться; создавать
schmecken — es schmeckt — geschmeckt = иметь вкус
schmecken nach (Dativ) = иметь вкус (чего?)
schreien — schreit — geschrien — schrie = кричать
schriftlich = письменный
seitdem = с тех пор
selten — seltener — am seltensten = редкий
sowohl … als auch … = и …, и …
nicht nur …, sondern auch … = не только …, но и …
sperren — sperrt — gesperrt = запирать; блокировать
stattfinden — findet statt — stattgefunden — fand statt = происходить
treten — tritt — getreten — trat = наступать; пинать
träumen — träumt — geträumt = мечтать; видеть сон
träumen von (Dativ) = мечтать о; видеть сон о
täglich = ежедневный
unbekannt = неизвестный
verkaufen — verkauft — verkauft = продавать
verlieben sich — verliebt — verliebt = влюбляться в
verlieben sich in (Akkusativ) = влюбляться в
vermutlich = предположительно
versuchen — versucht — versucht = пытаться
verweisen — verweist — verwiesen — verwies = ссылаться; указывать
verzichten — verzichtet — verzichtet = отказываться
verändern — verändert — verändert = изменить (существенно)
vorgegeben = заданный
wofür = для чего = 
wütend auf (Akkusativ) = (сильно) злой на
zustimmen — stimmt zu — zugestimmt = соглашаться
die Überraschung — Überraschungen = сюрприз = 
das Übungsbuch — Übungsbücher = учебник с упражнениями
ähnlich = похожий
überlegen — überlegt — überlegt = обдумывать
überreichen — reicht über — überreicht — reichte über = вручать
der Actionfilm — Actionfilme = боевик
das Afrika = Африка = 
die Ampel — Ampeln = светофор = 
der Arbeitstag — Arbeitstage = рабочий день = 
die Aufforderung — Aufforderungen = требование; призыв
der Ausflug — Ausflüge = экскурсия
der Autor — Autoren = автор = 
die Bahnhofstraße — Bahnhofstraßen = вокзальная улица
der Baum — Bäume = дерево
der Bayer — Bayer = баварец
der Belang — Belange = важность, значение
der Bereich — Bereiche = область
der Berufsverkehr = час пик
die Beschreibung — Beschreibungen = описание
der Betreff — Betreffe = тема (письма)
der Bezug auf (Akkusativ) — Bezüge = отношение к, ссылка на, связь с
das Bioprodukt — Bioprodukte = биопродукт = 
die Bitte um (Akkusativ) — Bitten = просьба о
der Blumenstrauß — Blumensträuße = букет цветов
der Blödsinn = чушь
der Bus — Busse = автобус = 
der Cent — Cents = цент = 
das Computerspiel — Computerspiele = компьютерная игра = 
die Datei — Dateien = файл
das Datum — Daten = дата
der Deckel — Deckel = крышка = 
der Dialog — Dialoge = диалог = 
die Diskussion — Diskussionen = дискуссия
der Druck — Drücke = давление; печать
die Ehe — Ehen = брак
das Ei — Eier = яйцо
die Einladung zu (Dativ) — Einladungen = приглашение на
die Einzelheit — Einzelheiten = деталь
englisch = английский = 
die Entspannung — Entspannungen = расслабление
das Erbe — Erben = наследство
die Erklärung — Erklärungen = объяснение
der Ernst = серьёзность
der Experte — Experten = эксперт = 
extra = дополнительно; экстра = 
feminin = женский
das Ferienziel — Ferienziele = место отдыха
der Flohmarkt — Flohmärkte = блошиный рынок = 
die Forderung — Forderungen = требование
das Foto — Fotos = фотография = 
Frankfurt = Франкфурт = 
das Freizeitverhalten — Freizeitverhalten = поведение в свободное время
der Frieden — Frieden = мир
der Frühling — Frühlinge = весна
die Fähigkeit — Fähigkeiten = способность
das Gas — Gase = газ = 
die Gefahr — Gefahren = опасность
das Gehalt — Gehälter = зарплата; содержание = 
das Geräusch — Geräusche = шум
das Geschirr — Geschirre = посуда
das Geschäft — Geschäfte = магазин; дело = 
das Getränk — Getränke = напиток
die Grundschule — Grundschulen = начальная школа = 
die Gruppe — Gruppen = группа = 
die Hauptaussage — Hauptaussagen = основное утверждение
die Hochzeit — Hochzeiten = свадьба = 
die Hotline — Hotlines = горячая линия = 
der Inhalt — Inhalte = содержание
die Institution — Institutionen = учреждение = 
italienisch = итальянский = 
der Junge — Jungen = мальчик; юноша = 
der Juniorchef — Juniorchefs = младший руководитель
der Kindergarten — Kindergärten = детский сад = 
das Kleid — Kleider = платье
das Kleinkind — Kleinkinder = малыш
die Kleinstadt — Kleinstädte = небольшой город
die Komposita = составные слова (слова из нескольких)
die Konjunktion — Konjunktionen = союз
der Kontakt — Kontakte = контакт = 
die Krise — Krisen = кризис
der Käse — Käse = сыр = 
der Körper — Körper = тело = 
der Künstler — Künstler = художник; артист
der Laden — Läden = магазин = 
die Laune — Launen = настроение
die Leistung — Leistungen = достижение; мощность
der Lernerfolg — Lernerfolge = успех в обучении
das Licht — Lichter = свет
das Lied — Lieder = песня  
die Medizin — Medizinen = медицина = 
der Meinungsmacher — Meinungsmacher = формирующий мнение
das Milchprodukt — Milchprodukte = молочный продукт = 
das Mitglied — Mitglieder = член = 
das Mittel — Mittel = средство = 
der Mittwoch — Mittwoche = среда = 
das Modalwort — Modalwörter = модальное слово = 
der Moment — Momente = момент = 
das Motiv — Motive = мелодия; повод; сюжет; узор
der Mut = смелость
das Mädchen — Mädchen = девочка = 
das Nachtleben — Nachtleben = ночная жизнь = 
der Nobelpreis — Nobelpreise = Нобелевская премия = 
die Oma — Omas = бабушка = 
der Pfeffer — Pfeffer = перец
die Politik — Politiken = политика
der Polizist — Polizisten = полицейский
polnisch = польский = 
der Postman — Postmen = почтальон = 
das Prinzip — Prinzipien = принцип = 
das Präsens — Präsen = настоящее время
die Präsentation — Präsentationen = презентация = 
der Prüfer — Prüfer = экзаменатор
der Prüfungspartner — Prüfungspartner = партнёр по экзамену = 
die Prüfungsteile = части экзамена
das Radio — Radios = радио = 
der Ratschlag — Ratschläge = совет
der Raum — Räume = комната; пространство = 
die Reaktion auf (Akkusativ) — Reaktionen = реакция на
das Regal — Regale = полка
die Reparatur — Reparaturen = ремонт
der Ring — Ringe = кольцо
der Rollstuhl — Rollstühle = инвалидная коляска = 
das Rad — Räder = колесо; велосипед = 
der Schaden — Schäden = ущерб
der Schneider — Schneider = портной
die Schuld — Schulden = вина; долг
die Schwierigkeit — Schwierigkeiten = трудность
der Schal — Schals = шарф = 
der Silvesterabend — Silvesterabende = канун Нового года
das Sportereignis — Sportereignisse = спортивное событие
das Sprichwort — Sprichwörter = пословица
die Strecke — Strecken = участок (пути); расстояние
der Stress — Stresse = стресс = 
die Subjunktion — Subjunktionen = подчинительный союз
das Synonym — Synonyme = синоним
der Süden = юг
die Tat — Taten = поступок
die Teilinformationen = частичная информация
das Ticket — Tickets = билет
das Training — Trainings = тренировка
der Traum — Träume = мечта; сон
der Turm — Türme = башня
die Tätigkeit — Tätigkeiten = деятельность
die Türkei = Турция
die Umgebung — Umgebungen = окружение
der Umzug — Umzüge = переезд
unbestimmt = неопределённый
die Unterstützung — Unterstützungen = поддержка
die Verantwortung für (Akkusativ) — Verantwortungen = ответственность за
der Verbrauch — Verbräuche = потребление
der Verbraucher — Verbraucher = потребитель
die Verfügung — Verfügungen = распоряжение
der Vergleich — Vergleiche = сравнение
die Veränderung — Veränderungen = изменение
der Vogel — Vögel = птица
die Vorwahlnummer — Vorwahlnummern = код номера
der Wagen — Wagen = вагон; машина
die Wahrscheinlichkeit — Wahrscheinlichkeiten = вероятность
die Wand — Wände = стена
warum = почему
der Weg — Wege = путь
die Weihnachten = Рождество
der Weihnachtsmarkt — Weihnachtsmärkte = рождественский рынок
Wiesbaden = Висбаден
der Wille — Willen = воля
woran = на чём
die Wortart — Wortarten = часть речи
der Zeitungsartikel — Zeitungsartikel = газетная статья
der Zuschauer — Zuschauer = зритель
Zürich = Цюрих
abends = по вечерам
abhängig von (Dativ) = зависимый от
alleine = один; одиноко
anfertigen — fertigt an — angefertigt — fertigte an = изготавливать
angesichts (Genitiv) = в связи с
der Angestellte — Angestellten = служащий
anhören — hört an — angehört — hörte an = слушать
anscheinend = по-видимому
anstatt (Dativ) = вместо
ausreichend = достаточный
auswählen — wählt aus — ausgewählt — wählte aus = выбирать
beantworten — beantwortet — beantwortet — beantwortete = отвечать
bedienen — bedient — bedient — bediente = обслуживать
bedingt = обусловленный
befinden — befindet — befunden — befand = находиться
benachbart = соседний
berechnen — berechnet — berechnet — berechnete = вычислять
berühmt = знаменитый
betragen — beträgt — betragen — betrag = составлять (сумму)
bewerben sich bei (Dativ) um (Akkusativ) — bewirbt — beworben — bewarb = подавать заявку (кому?) на (кого? что?)
bezeichnen — bezeichnet — bezeichnet — bezeichnete = обозначать
bislang = до сих пор
buchen — bucht — gebucht — buchte = бронировать
böse auf (Akkusativ) — böser — am bösesten = (среднее) недовольство, злость на
dadurch = этим; через это
dahin = туда
damals = тогда
daraus = из этого
darum = поэтому; вокруг этого
deklinieren — dekliniert — dekliniert — deklinierte = склонять
demgegenüber = напротив этого
dick — dicker — am dicksten = толстый
diskutieren — diskutiert — diskutiert — diskutierte = обсуждать
dorthin = туда
dunkel — dunkler — am dunkelsten = тёмный
ebenfalls = также
eingreifen — greift ein — eingegriffen — griff ein = вмешиваться
einhalten — hält ein — eingehalten — hielt ein = соблюдать
einheitlich = единообразный
einladen — lädt ein — eingeladen — lud ein = приглашать
einreichen — reicht ein — eingereicht — reichte ein = подавать (документы)
einschränken — schränkt ein — eingeschränkt — schränkte ein = ограничивать
emotional = эмоциональный
empfehlen — empfiehlt — empfohlen — empfahl = рекомендовать
entgegen (Dativ) = навстречу; против; вопреки
entschließen — schließt — entschlossen — schloss = решаться
entweder … oder … = или …, или … (строго одно)
ob … oder … = или …, или … (безразличие)
erblich = наследственный
erholen — erholt — erholt — erholte = отдыхать
erstellen — erstellt — erstellt — erstellte = создавать (отчёт, план)
der Erwachsene — Erwachsenen = взрослый
eröffnen — eröffnet — eröffnet — eröffnete = открывать
euch = вас
falls = в случае если
fast = почти
fertigen — fertigt — gefertigt — fertigte = изготавливать
finanzieren — finanziert — finanziert — finanzierte = финансировать
formulieren — formuliert — formuliert — formulierte = формулировать
garantieren — garantiert — garantiert — garantierte = гарантировать
gelingen — gelingt — ist gelungen — gelang = удаваться
genannt = названный
genießen — genießt — genossen — genoss = наслаждаться
geraten — gerät — ist geraten — geriet = оказаться; советовать
gespannt auf (Akkusativ) = взволнованный (в ожидании)
grübeln — grübelt — gegrübelt — grübelte = размышлять; ломать голову
heiß — heißer — am heißesten = горячий
heraus = наружу
herstellen — stellt her — hergestellt — stellte her = производить
hinauf = вверх
hinein = внутрь
hingegen = напротив
hinnehmen — nimmt hin — hingenommen — nahm hin = принимать (как факт)
hinter = позади
hoffen auf (Akkusativ) — hofft — gehofft — hoffte = надеяться на
humanitär = гуманитарный
informieren — informiert — informiert — informierte = информировать
interessant = интересный
je = каждый; чем
jedoch = однако
jährlich = ежегодный
kalt — kälter — am kältesten = холодный
keinesfalls = ни в коем случае
kirchlich = церковный
komisch = смешной; странный
konventionell = традиционный
leuchten — leuchtet — geleuchtet — leuchtete = светить
lieber = лучше; милый
meist = больше всего
merken — merkt — gemerkt — merkte = замечать
modern = современный
morgen = завтра
morgendlich = утренний
möglicherweise = возможно
na = ну
nachlesen — liest nach — nachgelesen — las nach = перечитывать; проверять
notieren — notiert — notiert — notierte = записывать
per (Dativ) = через; с помощью
privat = частный
prägen — prägt — geprägt — prägte = формировать; чеканить
prüfen — prüft — geprüft — prüfte = проверять
reinigen — reinigt — gereinigt — reinigte = чистить
retten — rettet — gerettet — rettete = спасать
rufen — ruft — gerufen — rief = звать; кричать
ruhig — ruhiger — am ruhigsten = спокойный
schalten — schaltet — geschaltet — schaltete = переключать
scheiden — scheidet — geschieden — schied = разводиться; отделять
sicherlich = наверняка
siebziger = семидесятые
sofort = сразу
solcher = такой
sorgen für (Akkusativ) — sorgt — gesorgt — sorgte = заботиться про (кого?)
sorgen sich um (Akkusativ) — sorgt — gesorgt — sorgte = беспокоиться о
sozial = социальный
stattdessen = вместо этого
stockend = прерывистый
stoppen — stoppt — gestoppt — stoppte = останавливать
streichen — streicht — gestrichen — strich = вычёркивать; красить
streng — strenger — am strengsten = строгий
stressen — stresst — gestresst — stresste = напрягать
super = супер
surfen — surft — gesurft — surfte = серфить
tatkräftig = энергичный
teilnehmen an (Dativ) — nimmt teil — teilgenommen — nahm teil = участвовать в
tief — tiefer — am tiefsten = глубоко, низко
der Tote — die Toten = мёртвый
trennbar = отделимый
trennen — trennt — getrennt — trennte = разделять
trotzdem = несмотря на это
unterstreichen — unterstreicht — unterstrichen — unterstrich = подчёркивать
unterstützen — unterstützt — unterstützt — unterstützte = поддерживать
unzufrieden = недовольный
verantwortlich für (Akkusativ) = ответственный за
verbinden — verbindet — verbunden — verband = соединять
verheiraten — verheiratet — verheiratet — verheiratete = женить; выдавать замуж
verlangen — verlangt — verlangt — verlangte = требовать
verrückt = сумасшедший
verschieben — verschiebt — verschoben — verschob = сдвигать; откладывать
vertagen — vertagt — vertagt — vertagte = откладывать (заседание)
vertrauen — vertraut — vertraut — vertraute = доверять
verursachen — verursacht — verursacht — verursachte = вызывать, причинять
völlig = полностью
wachsen — wächst — ist gewachsen — wuchs = расти
warnen vor (Dativ) — warnt — gewarnt — warnte = предупреждать о
weiterhin = далее
weltbekannt = всемирно известный
wem = кому
wild — wilder — am wildesten = дикий
woher = откуда
womit = c чем
worüber = о чём
wunderschön = прекрасный
zunehmen — nimmt zu — zugenommen — nahm zu = увеличиваться; набирать вес
zuordnen — ordnet zu — zugeordnet — ordnete zu = сопоставить; привести в соответствие
zurzeit = в настоящее время
zuständig für (Akkusativ) = ответственный, компетентный за
zusätzlich = дополнительный
zweifeln an (Dativ) — zweifelt — gezweifelt — zweifelte = сомневаться в
zählen — zählt — gezählt — zählte = считать
das Öl — Öle = масло
das Österreich = Австрия
die Übersicht — Übersichten = обзор
öffnen — öffnet — geöffnet — öffnete = открывать
üben — übt — geübt — übte = практиковать; упражняться
überleben — überlebt — überlebt — überlebte = выжить, пережить
überreden zu (Dativ) — überredet — überredet — überredete = уговаривать на
der Abbau — Abbauten = сокращение, демонтаж, распад
der Abfall — Abfälle = отходы, мусор
der Absolvent — Absolventen = выпускник
die Abteilung — Abteilungen = отдел
die Achtung — Achtungen = внимание
die Adresse — Adressen = адрес
das Akkusativsymbol — Akkusativsymbole = символ винительного падежа
die Aktivität — Aktivitäten = активность
die Altsprache — Altsprachen = древний язык
der Anbieter — Anbieter = поставщик
der Andrang — Andränge = наплыв
der Anfänger — Anfänger = новичок
der Anhang — Anhänge = приложение (к письму); прицеп
die Ansage — Ansagen = объявление (в транспорте)
die Anschaffung — Anschaffungen = приобретение (покупка)
der Ansprechpartner — Ansprechpartner = контактное лицо
die Anweisung — Anweisungen = инструкция
das Aquajogging = бег в воде
der Arbeitsalltag — Arbeitsalltage = рабочие будни
der Arbeitsplatz — Arbeitsplätze = рабочее место
Asien = Азия
die Atmung — Atmungen = дыхание
das Audio — Audios = аудио
der Aufbau — Aufbauten = структура; строительство
der Aufenthalt — Aufenthalte = пребывание
das Aufgabenblatt — Aufgabenblätter = лист с заданиями
der Aufräumtag — Aufräumtage = день уборки
der Auftrag — Aufträge = заказ
das Auge — Augen = глаз
die Ausrüstung — Ausrüstungen = оборудование
die Ausstellung — Ausstellungen = выставка
der Bahnhof — Bahnhöfe = вокзал
die Bahnstrecke — Bahnstrecken = железнодорожная линия
der Bauch — Bäuche = живот
die Baustelle — Baustellen = стройка
die Bedingung — Bedingungen = условие
die Bedrohung — Bedrohungen = угроза
die Begegnung — Begegnungen = встреча
der Bericht — Berichte = отчёт
der Berliner — Berliner = берлинец
die Berufsausbildung — Berufsausbildungen = профессиональное обучение
die Beschreibung — Beschreibungen = описание
die Betonung — Betonungen = ударение
der Betrieb — Betriebe = предприятие; эксплуатация
der Beweis für (Akkusativ) — Beweise = доказательство для
die Bewerbung um (Akkusativ) — Bewerbungen = заявка, резюме на
die Biokost = биопродукты
die Biolade — Bioladen = биомагазин
die Blume — Blumen = цветок
Brasilien = Бразилия
der Brenner — Brenner = горелка
das Brot — Brote = хлеб
der Buddhist — Buddhisten = буддист
das Budget — Budgets = бюджет
das Bundesland — Bundesländer = федеральная земля
die Bundesrepublik — Bundesrepubliken = федеральная республика
die Bundesstraße — Bundesstraßen = федеральная дорога
die Bushaltestelle — Bushaltestellen = автобусная остановка
die Bühne — Bühnen = сцена
der Bürger — Bürger = гражданин
die Bürgerin — Bürgerinnen = гражданка
die Bürgerinitiative — Bürgerinitiativen = гражданская инициатива
die Charaktereigenschaft — Charaktereigenschaften = черта характера
der Chauffeur — Chauffeure = шофёр
die Choice — Choices = выбор
der Code — Codes = код
der Computerkurs — Computerkurse = компьютерный курс
das Computerprogramm — Computerprogramme = компьютерная программа
die Delikatesse — Delikatessen = деликатес
das Detail — Details = деталь
der Diener — Diener = слуга
die Dienstleistung — Dienstleistungen = услуга
der Dolmetscher — Dolmetscher = переводчик (устный)  
der Draht — Drähte = проволока
das Ehepaar — Ehepaare = супружеская пара
das Eichhörnchen — Eichhörnchen = белка
der Eindruck — Eindrücke = впечатление
die Eingebung — Eingebungen = озарение
die Einigung — Einigungen = объединение
die Einlage — Einlagen = вклад; стелька
die Einleitung — Einleitungen = введение
der Empfänger — Empfänger = получатель
die Endposition — Endpositionen = конечная позиция
das Engagement — Engagements = участие; приверженность
England = Англия
der Enthusiasmus — Enthusiasmen = энтузиазм
der Entschluss — Entschlüsse = решение
die Entschuldigung — Entschuldigungen = извинение
die Entspannung — Entspannungen = расслабление
die Enttäuschung — Enttäuschungen = разочарование
das Ereignis — Ereignisse = событие
der Erfahrungsbericht — Erfahrungsberichte = отчёт об опыте
das Erfahrungsgedächtnis — Erfahrungsgedächtnisse = долговременная память (память опыта)
die Ernte — Ernten = урожай
das Experiment — Experimente = эксперимент
die Explosion — Explosionen = взрыв
der Fachkräftemangel — Fachkräftemängel = нехватка специалистов
die Fachsprache — Fachsprachen = профессиональный язык
die Fahrkarte — Fahrkarten = билет на транспорт
die Fahrprüfung — Fahrprüfungen = экзамен по вождению
der Fahrradstand — Fahrradstände = велостоянка
die Fahrt — Fahrten = поездка
das Fasching — Faschinge = карнавал
die Faulheit — Faulheiten = лень
das Feld — Felder = поле
das Fett — Fette = жир
die Feuerwehr — Feuerwehren = пожарная служба
der Filter — Filter = фильтр
der Fisch — Fische = рыба
die Fitness = фитнес
das Fitnessstudio — Fitnessstudios = фитнес-студия
die Fledermaus — Fledermäuse = летучая мышь
der Flug — Flüge = полёт
das Fragewort — Fragewörter = вопросительное слово
der Frankfurter — Frankfurter = франкфуртец
das Frankreich = Франция
der Freitag — Freitage = пятница
der Freizeittrend — Freizeittrends = тренд свободного времени
die Fremdsprache — Fremdsprachen = иностранный язык
der Friede — Frieden = мир
das Futur — Future = будущее (время)
der Fußball — Fußbälle = футбол
die Fünfzehnjährige — Fünfzehnjährigen = пятнадцатилетняя
die Fürstin — Fürstinnen = княгиня
der Gatte — Gatten = супруг
das Gebiet — Gebiete = область
der Gebrauch — Gebräuche = использование; обычай
das Gebäude — Gebäude = здание
die Gebührenerhöhung — Gebührenerhöhungen = повышение сборов
die Geduld = терпение
der Gegensatz — Gegensätze = противоположность
die Gehirnströme = мозговые волны
der Geist — Geister = дух
das Gelenk — Gelenke = сустав
die Gemeinde — Gemeinden = община
der Genuss — Genüsse = наслаждение
der Geruch nach (Dativ) — Gerüche = запах (чего?)
die Geschäftsreise — Geschäftsreisen = командировка (деловая поездка)
die Gesundheit = здоровье
das Gesundheitsprogramm — Gesundheitsprogramme = программа здоровья
der Gesundheitszustand — Gesundheitszustände = состояние здоровья
das Gift — Gifte = яд
der Glaube — Glauben = вера
der Grad — Grade = градус; степень
das Grammatikkapitel — Grammatikkapitel = глава по грамматике
die Grenze — Grenzen = граница
Griechenland = Греция
die Großeltern = бабушка и дедушка
die Grundregel — Grundregeln = основное правило
die Grundstufe — Grundstufen = начальный уровень
die Größe — Größen = размер
das Halbjahr — Halbjahre = полугодие
die Halle — Hallen = зал
das Halloween = Хэллоуин
der Handel — Handels = торговля
die Hauptaussage — Hauptaussagen = основное утверждение
der Hausbewohner — Hausbewohner = житель дома
die Haushaltspflicht — Haushaltspflichten = домашняя обязанность
die Heimat — Heimaten = родина
die Heizung — Heizungen = отопление
die Helenenstraße — Helenenstraßen = улица Хеленен
her = сюда
der Herbst — Herbste = осень
das Hindernis — Hindernisse = препятствие
die Hindus = индусы
der Hit — Hits = хит
der Hoax — Hoaxes = обман; мистификация
das Hobby — Hobbys = хобби
der Hof — Höfe = двор
die Hosenträger = подтяжки
der Händler — Händler = торговец
die Höflichkeit — Höflichkeiten = вежливость
der Hörtext — Hörtexte = аудиотекст
der Impuls — Impulse = импульс
das Indefinitpronomen — Indefinitpronomen = неопределённое местоимение
der Insasse — Insassen = обитатель; пассажир
die Integration — Integrationen = интеграция
das Interphon — Interphone = домофон
das Interview — Interviews = интервью
der Jeck — Jecken = шут; карнавальный персонаж
der Jude — Juden = еврей
das Kamel — Kamele = верблюд
der Karfreitag — Karfreitage = Страстная пятница
der Kasus — Kasus = падеж
der Keller — Keller = подвал
der Kerl — Kerle = парень
die Kerze — Kerzen = свеча
der Kilometer — Kilometer = километр
der Kirchenkritiker — Kirchenkritiker = критик церкви
die Klammer — Klammern = скобка
das Klavier — Klaviere = пианино
das Kleintier — Kleintiere = мелкое животное
der Knopf — Knöpfe = кнопка
das Koma — Komas = кома
der Konditionalsatz — Konditionalsätze = условное предложение
der Konditor — Konditoren = кондитер
der Konflikt — Konflikte = конфликт
der Konkurrent — Konkurrenten = конкурент
der Konsum — Konsume = потребление
die Kontrolle — Kontrollen = контроль
das Konzept — Konzepte = концепция
der Konzern — Konzerne = концерн
die Kostenerstattung — Kostenerstattungen = возмещение затрат
das Kostüm — Kostüme = костюм
der Kreis — Kreise = круг; район
der Kreislauf — Kreisläufe = круговорот
das Krokodil — Krokodile = крокодил
die Kulanzregelung — Kulanzregelungen = правило доброй воли
der Kummer — Kummer = горе; печаль
die Kundennummer — Kundennummern = номер клиента
der König — Könige = король
die Körnerfresserei = поедание зёрен
die Kündigung — Kündigungen = увольнение; расторжение
die Lage — Lagen = положение; местоположение
die Landstraße — Landstraßen = загородная дорога
das Lebensjahr — Lebensjahre = год жизни
das Lebensmittel — Lebensmittel = продукт питания
die Lebensumstände = жизненные обстоятельства
das Leid — Leiden = страдание, горе  
die Leitung — Leitungen = руководство; провод
das Liebesnest — Liebesnester = любовное гнёздышко
die Lohnnebenkosten = дополнительные расходы на зарплату
der Londoner — Londoner = лондонец
das Lotto — Lottos = лотерея
Luxemburg = Люксембург
der Lärm — Lärme = шум
die Lösungsmöglichkeit — Lösungsmöglichkeiten = возможность решения
der Lückentext — Lückentexte = текст с пропусками
Madrid = Мадрид
der Main = Майн (река)
der Majoran = майоран
Mallorca = Майорка
der Mantel — Mäntel = пальто
der Marathon — Marathons = марафон
die Marine — Marinen = морской флот
das Material — Materialien = материал
der Maurer — Maurer = каменщик
das Meer — Meere = море
das Meeresufer — Meeresufer = морской берег
die Menge — Mengen = количество
die Miete — Mieten = аренда
der Mieter — Mieter = арендатор
das Milieu — Milieus = среда
die Milliarde — Milliarden = миллиард
das Mittagessen — Mittagessen = обед
die Modalpartikel — Modalpartikeln = модальная частица
die Mode — Moden = мода
das Museum — Museen = музей
die Musikveranstaltung — Musikveranstaltungen = музыкальное мероприятие
die Muskelkraft = мышечная сила
die Muskulatur — Muskulaturen = мускулатура
die Mühe — Mühen = усилие
die Natur — Naturen = природа
die Nebenwirkung — Nebenwirkungen = побочный эффект
die Nomen = существительные
der Notruf — Notrufe = экстренный вызов
das Obst = фрукты
das Opfer — Opfer = жертва
die Organisation — Organisationen = организация
die Orthopädie — Orthopädien = ортопедия
das Osterfest = Пасхальный праздник
die Ostereier = пасхальные яйца
das Ostern = Пасха
der Parkplatz — Parkplätze = парковочное место
das Pech = невезение
die Pension — Pensionen = пансион
das Personal = персонал
das Pferd — Pferde = лошадь
die Pflanze — Pflanzen = растение
das Pflanzenschutzmittel — Pflanzenschutzmittel = средство защиты растений
die Pflegekraft — Pflegekräfte = медработник по уходу
die Physik — Physiken = физика
das Picknick — Picknicks = пикник
die Pluralendung — Pluralendungen = окончание множественного числа
der Pole — Polen = поляк
der Polizeibesuch — Polizeibesuche = визит полиции
der Poll — Polls = опрос
der Popstar — Popstars = поп-звезда
das Postamt — Postämter = почтовое отделение
die Produktion — Produktionen = производство
der Professor — Professoren = профессор
die Prognose — Prognosen = прогноз
das Projekt — Projekte = проект
das Präfix — Präfixe = префикс
die Präzisionsuhr — Präzisionsuhren = точные часы
die Qualität — Qualitäten = качество
der Rabatt — Rabatte = скидка
das Radiointerview — Radiointerviews = радио-интервью
der Rasen — Rasen = газон
das Rathaus — Rathäuser = ратуша (здание мерии, местного самоуправления)
die Realität — Realitäten = реальность
die Rechnung — Rechnungen = счёт; расчёт
die Rechtspartei — Rechtsparteien = правая партия
die Regierung — Regierungen = правительство
der Reinfall — Reinfälle = провал (неудача)
die Reinigung — Reinigungen = уборка
der Reiseveranstalter — Reiseveranstalter = туроператор
der Reporter — Reporter = репортёр
die Rose — Rosen = роза
die Ruhe — Ruhen = покой
das Rätoromanisch = романсийский язык
das Rätsel — Rätsel = загадка
der Rückgang — Rückgänge = снижение
Saarland = Саарланд
der Sachverhalt — Sachverhalte = обстоятельство дела
der Salat — Salate = салат
der Samstag — Samstage = суббота
der Sandstrand — Sandstrände = песчаный пляж
das Satzende — Satzenden = конец предложения
das Schema — Schemata = схема
der Schiedsrichter — Schiedsrichter = судья (в спорте), арбитр
das Schlafengehen = отход ко сну
die Schlagzeile — Schlagzeilen = заголовок
der Schluss — Schlüsse = вывод; конец
der Schmerz — Schmerzen = боль
die Schnittstelle — Schnittstellen = интерфейс
der Schokoladennikolaus — Schokoladennikoläuse = шоколадный Николаус
schriftlich = письменный  
der Schritt — Schritte = шаг
das Schuhmodell — Schuhmodelle = модель обуви  
der Schulfreund — Schulfreunde = школьный друг
die Schulzeit — Schulzeiten = школьное время
das Schwimmbad — Schwimmbäder = бассейн
schön — schöner — am schönsten = красивый
die Schönheit — Schönheiten = красота
die Sehnsucht nach (Dativ) — Sehnsüchte = тоска по
das Sekretariat — Sekretariate = секретариат
die Sekretärin — Sekretärinnen = секретарь
das Seminar — Seminare = семинар
der Senior — Senioren = пожилой человек
die Servicezeit — Servicezeiten = время обслуживания
die Show — Shows = шоу
die Sicherheit — Sicherheiten = безопасность
die Sicht — Sichten = вид; обзор
das Silbenrätsel — Silbenrätsel = слоговая загадка
der Sitz — Sitze = сиденье
das Smartphone — Smartphones = смартфон
die Software — Softwares = программное обеспечение
der Sohn — Söhne = сын
der Spam — Spams = спам
Spanien = Испания
der Spaziergänger — Spaziergänger = пешеход, прогуливающийся человек
der Speicherplatz — Speicherplätze = место для хранения
der Sperrmüllservice — Sperrmüllservices = служба вывоза крупногабаритного мусора
die Spinne — Spinnen = паук
das Sportprogramm — Sportprogramme = спортивная программа
der Spracherwerb — Spracherwerbe = освоение языка
die Sprachprüfung — Sprachprüfungen = языковой экзамен
die Spülmaschine — Spülmaschinen = посудомоечная машина
das Stadion — Stadien = стадион
die Stadthalle — Stadthallen = городской зал
der Stadtrat — Stadträte = городской совет
der Standesbeamter — Standesbeamte = сотрудник ЗАГСа
der Start — Starts = старт
die Steinzeitmenschen = люди каменного века
der Stellenabbau — Stellenabbauten = сокращение штатов
der Stoff — Stoffe = материал; ткань
der Strauß — Sträuße = букет; страус
die Straßenbahn — Straßenbahnen = трамвай
der Streik — Streiks = забастовка
der Streit — Streite = спор
das Studienfach — Studienfächer = учебный предмет
der Studierende — Studierenden = студент
das Studium — Studien = учёба; исследование
der Superlativ — Superlative = превосходная степень
die Szene — Szenen = сцена
die Tante — Tanten = тётя
der Onkel — Onkel = дядя
der Enkel — Enkel = внук  
der Tarifpartner — Tarifpartner = тарифный партнёр
die Tarifpartnerschaft — Tarifpartnerschaften = тарифное партнёрство
die Taxis = такси
der Techniker — Techniker = техник
der Teig — Teige = тесто
die Teigwaren = макаронные изделия
der Theaterschuhmacher — Theaterschuhmacher = театральный сапожник
die Theorie — Theorien = теория
die Tierhaltung — Tierhaltungen = содержание животных
der Tod — Tode = смерть
der Trend — Trends = тренд
die Treppe — Treppen = лестница
der Tanz — Tänze = танец
die Unterkunft — Unterkünfte = жильё
der Unterschied — Unterschiede = различие
die Variante — Varianten = вариант
der Vegetarier — Vegetarier = вегетарианец
der Veranstalter — Veranstalter = организатор
die Veranstaltungshinweise = информация о мероприятиях
der Verbstamm — Verbsträmme = основа глагола
die Verfilmung — Verfilmungen = экранизация
der Verkauf — Verkäufe = продажа
der Verkäufer — Verkäufer = продавец
der Verlag — Verlage = издательство
die Verpflegung — Verpflegungen = питание
die Versorgung — Versorgungen = обеспечение
die Verspätung — Verspätungen = опоздание
die Verständnisbarriere — Verständnisbarrieren = барьер понимания
der Vertrag — Verträge = договор
die Volkshochschule — Volkshochschulen = народный университет
die Vollpension — Vollpensionen = полный пансион
voraus = вперёд
die Vorbereitung — Vorbereitungen = подготовка
das Vorjahr — Vorjahre = предыдущий год
die Vorsicht = осторожность
der Vorverkauf — Vorverkäufe = предварительная продажа
der Wandel — Wandel = изменение
die Ware — Waren = товар
die Wechselpräposition — Wechselpräpositionen = переменный предлог
die Weihnachtszeit — Weihnachtszeiten = рождественское время
der Wein — Weine = вино
die Wendung — Wendungen = оборот; поворот
das Werk — Werke = произведение; завод
der Wert — Werte = ценность
das Wesen — Wesen = существо; сущность
der Wetterbericht — Wetterberichte = прогноз погоды
Wien = Вена
die Wirklichkeit — Wirklichkeiten = действительность
der Wissenschaftler — Wissenschaftler = учёный
die Wolke — Wolken = облако
das Wortfeld — Wortfelder = группа связанных слов
das Yoga — Yogas = йога
die Zahlenangabe — Zahlenangaben = указание числа
das Zeugnis — Zeugnisse = свидетельство; аттестат
der Zucker — Zucker = сахар
die Zusammenfassung — Zusammenfassungen = краткое изложение
der Zusammenhang — Zusammenhänge = связь
der Zusatzstoff — Zusatzstoffe = добавка
der Zweck — Zwecke = цель
die Zweisprachigkeit — Zweisprachigkeiten = двуязычие
abbauen — baut ab — abgebaut — baute ab = разбирать; сокращать
der Abgeordnete — Abgeordneten = депутат
der Anwalt — Anwälte = адвокат
ablehnen — lehnt ab — abgelehnt — lehnte ab = отклонять
abnehmen — nimmt ab — abgenommen — nahm ab = снимать; худеть
abstürzen — stürzt ab — ist abgestürzt — stürzte ab = падать; разбиваться
abwertend = уничижительный
achten auf (Akkusativ) — achtet — geachtet — achtete = обращать внимание на (кого? что?)
die Adjektivendung — Adjektivendungen = окончание прилагательного
alleinerziehend = одинокий родитель
altmodisch = старомодный
anbraten — brät an — angebratan — briet an = обжаривать
andererseits = с другой стороны
angeben — gibt an — angegeben — gab an = указывать; хвастаться
angefertigen — fertigt an — angefertigt — fertigte an = изготавливать
angepasst = приспособленный
anhalten — hält an — angehalten — hielt an = останавливать
anhand (Genitiv) = на основе
anregen — regt an — angeregt — regte an = побуждать; стимулировать
anwenden — wendet an — angewendet — wendete an = применять
arm — ärmer — am ärmsten = бедный
aufbauen — baut auf — aufgebaut — baute auf = строить; основывать
auffallen — fällt auf — ist aufgefallen — fiel auf = бросаться в глаза
aufgeregt = взволнованный
aufhören mit (Dativ) — hört auf — aufgehört — hörte auf = прекращать (что?)
aufnehmen — nimmt auf — aufgenommen — nahm auf = записывать; принимать
aufpassen — passt auf — aufgepasst — passte auf = присматривать
aufregend = захватывающий, волнующий
aufräumen — räumt auf — aufgeräumt — räumte auf = убирать
aufwachen — wacht auf — ist aufgewacht — wachte auf = просыпаться
ausführlich = подробный
ausgeben — gibt aus — ausgegeben — gab aus = тратить
aushandeln — handelt aus — ausgehandelt — handelte aus = договариваться
austauschen — tauscht aus — ausgetauscht — tauschte aus = обменивать
auswendig = наизусть
auszeichnen — zeichnet aus — ausgezeichnet — zeichnete aus = отличать; награждать
außerhalb (Genitiv) = вне
bedauern — bedauert — bedauert — bedauerte = сожалеть
bedürfen — bedarf — bedurft — bedurfte = нуждаться
beeinflussen — beeinflusst — beeinflusst — beeinflusste = влиять
beeinträchtigen — beeinträchtigt — beeinträchtigt — beeinträchtigte = ухудшать, вредить
begeistert = восторженный
begreifen — begreift — begriffen — begriff = понимать
begründen — begründet — begründet — begründete = обосновывать
behalten — behält — behalten — behielt = сохранять
beilegen — legt bei — beigelegt — legte bei = прилагать
bekennen — bekennt — bekannt — bekannte = признавать
belaufen — beläuft — belaufen — belief = составлять (сумму)
beliebt = популярный
bellen — bellt — gebellt — bellte = лаять
bemalt = расписной
beobachten — beobachtet — beobachtet — beobachtete = наблюдать
beraten — berät — beraten — beriet = советовать
bereiten — bereitet — bereitet — bereitete = готовить
bereuen — bereut — bereut — bereute = сожалеть
beruflich = профессиональный
beruhigen — beruhigt — beruhigt — beruhigte = успокаивать
beschließen — beschließt — beschlossen — beschloss = решать
beschreiben — beschreibt — beschrieben — beschrieb = описывать
beschädigen — beschädigt — beschädigt — beschädigte = повреждать
beschäftigen sich mit (Dativ) — beschäftigt — beschäftigt — beschäftigte = заниматься (чем?)
besichtigen — besichtigt — besichtigt — besichtigte = осматривать
besonder = особый
bestellen — bestellt — bestellt — bestellte = заказывать
bestimmen — bestimmt — bestimmt — bestimmte = определять
betonen — betont — betont — betonte = подчёркивать
bevorzugen — bevorzugt — bevorzugt — bevorzugte = предпочитать
beweisen — beweist — bewiesen — bewies = доказывать
beziehen — bezieht — bezogen — bezog = относиться; переезжать
bilingual = двуязычный
billig — billiger — am billigsten = дешёвый
bisher = до сих пор
bisschen = немного
bissen — beißt — gebissen — biss = кусать
blau = синий
brechen — bricht — gebrochen — brach = ломать
bunt — bunter — am buntesten = яркий; разноцветный
die CD — CDs = компакт-диск
dennoch = тем не менее
dienen — dient — gedient — diente = служить
die Doppelkonnektoren = двойные соединители
dramatisch = драматичный
dreimal = трижды
durchgegangen = пройденный
dänisch = датский
eingeschlafen = заснувший
einigen — einigt — geeinigt — einigte = договариваться
einkaufen — kauft ein — eingekauft — kaufte ein = покупать
einliefern — liefert ein — eingeliefert — lieferte ein = доставлять
einnehmen — nimmt ein — eingenommen — nahm ein = принимать; занимать
einsetzen — setzt ein — eingesetzt — setzte ein = использовать; вставлять
einzeln = отдельный
elektrisch = электрический
empfangen — empfängt — empfangen — empfing = принимать; встречать
entdecken — entdeckt — entdeckt — entdeckte = обнаруживать
entsprechen — entspricht — entsprochen — entsprach = соответствовать
entsprechend = соответственно
entwerfen — entwirft — entworfen — entwarf = разрабатывать
erfinden — erfindet — erfunden — erfand = изобретать
erlernen — erlernt — erlernt — erlernte = изучать
erläutern — erläutert — erläutert — erläuterte = пояснять
erneut = вновь
ernst — ernster — am ernstesten = серьёзный
erreichbar = доступный
erschrocken = испуганный
ersetzen — ersetzt — ersetzt — ersetzte = заменять
erteilen — erteilt — erteilt — erteilte = давать (разрешение)
erwachen — erwacht — ist erwacht — erwachte = пробуждаться
erziehen — erzieht — erzogen — erzog = воспитывать
familiär = семейный
faul — fauler — am faulsten = ленивый
fehlen — fehlt — gefehlt — fehlte = отсутствовать
ferner = далее
fernsehen — fernsieht — ferngesehen — fernsah = смотреть телевизор
fliehen vor (Dativ) — flieht — ist geflohen — floh = бежать от
französische = французский
friedlich = мирный
fundiert = обоснованный
fügen — fügt — gefügt — fügte = добавлять
fünfzehnjährig = пятнадцатилетний
füttern — füttert — gefüttert — fütterte = кормить
gefährlich = опасный
gehörend = принадлежащий
geistig = духовный; умственный
genug = достаточно
geschehen — geschieht — ist geschehen — geschah = происходить
gewählt = выбранный
gratulieren zu (Dativ) — gratuliert — gratuliert — gratulierte = поздравлять с
die Gratulation — Gratulationen = поздравление
grün = зелёный
gründen — gründet — gegründet — gründete = основывать
gründlich = тщательный
hektisch = лихорадочный
herein = внутрь
herum = вокруг
hierbei = при этом
hinunter = вниз
hinweg = через
hinzugeben — gibt hinzu — hinzugegeben — gab hinzu = добавлять
höflich = вежливый
ideal = идеальный
indem = тем, что
inklusive = включительно, включённый
innen = внутри
irgendwas = что-нибудь
irgendwo = где-нибудь
jedenfalls = в любом случае
jeglicher = любой
jetzig = нынешний
kabarettistisch = кабаретный
kennenlernen — lernt kennen — kennengelernt — lernte kennen = знакомиться
klappen — klappt — geklappt — klappte = получается
klettern — klettert — geklettert — kletterte = лазать
klopfen — klopft — geklopft — klopfte = стучать
kommend = приходящий
komplett = полный
korrekt = правильный
krank — kränker — am kränksten = больной
kriegen — kriegt — gekriegt — kriegte = получить, взять, достать
ich krieg — ich möchte = хотел бы
hinkriegen — er kriegt hin — hingekriegt — kriegte hin = справляться
kritisch = критический
künstlich = искусственный
laden — lädt — geladen — lud = загружать; приглашать
landen — landet — gelandet — landete = приземляться
laufend = текущий
lauten — lautet — gelautet — lautete = звучать
lecker = вкусный
lehren — lehrt — gelehrt — lehrte = обучать
leisten — leistet — geleistet — leistete = выполнять; оказывать
leiten — leitet — geleitet — leitete = руководить
liefern — liefert — geliefert — lieferte = поставлять
links = слева
logisch = логичный
meistern — meistert — gemeistert — meisterte = овладевать
melden — meldet — gemeldet — meldete = сообщать
messen — misst — gemessen — maß = измерять
mitbringen — bringt mit — mitgebracht — brachte mit = приносить с собой
miteinander = друг с другом
mitkommen — kommt mit — ist mitgekommen — kam mit = идти вместе
mitnehmen — nimmt mit — mitgenommen — nahm mit = брать с собой
neben (Dativ) = рядом
negativ = негативный
nett = милый
normal = нормальный
notwendig = необходимый
nutzen — nutzt — genutzt — nutzte = использовать
nötig = нужный
offen — offener — am offensten = открытый
offiziell = официальный
optimal = оптимальный
pausenlos = без перерыва
perfekt = идеальный
pflanzen — pflanzt — gepflanzt — pflanzte = сажать
politisch = политический
positiv = позитивный
probieren — probiert — probiert — probierte = пробовать
raten zu (Dativ) — rät — geraten — riet = советовать (по поводу)
rauben — raubt — geraubt — raubte = грабить
rauchen — raucht — geraucht — rauchte = курить
regelmäßig = регулярный
regnen — regnet — geregnet — regnete = идти (о дожде)
reif — reifer — am reifsten = зрелый
riechen nach (Dativ) — riecht — gerochen — roch = пахнуть (чем?)
rosarot = розовый
rund — runder — am rundesten = круглый
räumen — räumt — geräumt — räumte = убирать
rühren — rührt — gerührt — rührte = мешать
scharf — schärfer — am schärfsten = острый
schauen — schaut — geschaut — schaute = смотреть
scheitern — scheitert — ist gescheitert — scheiterte = терпеть неудачу
schief = кривой
schlagen — schlägt — geschlagen — schlug = бить
schlimm — schlimmer — am schlimmsten = плохой
schlittschuhlaufen — läuft Schlittschuh — Schlittschuh gelaufen — lief Schlittschuh = кататься на коньках
schuld = виноват
schwimmen — schwimmt — geschwommen — schwamm = плавать
schwitzen — schwitzt — geschwitzt — schwitzte = потеть
schätzen — schätzt — geschätzt — schätzte = оценивать
schützen — schützt — geschützt — schützte = защищать
sehnen sich nach (Dativ) — sehnt — gesehnt — sehnte = тосковать по
sinken — sinkt — ist gesunken — sank = тонуть; опускаться
sogar = даже
somit = таким образом
sommerlich = летний
sonst = иначе; другой
spannend = захватывающий
speichern — speichert — gespeichert — speicherte = сохранять
spießig = мещанский
sprachlich = языковой
sterben — stirbt — ist gestorben — starb = умирать
stoßen — stößt — gestoßen — stieß = толкать
streiten — streitet — gestritten — stritt = спорить
städtisch = городской
subjektiv = субъективный
tanzen — tanzt — getanzt — tanzte = танцевать
teilweise = частично
telefonieren — telefoniert — telefoniert — telefonierte = звонить по телефону
total = полный
traurig = грустный
treiben — treibt — getrieben — trieb = гнать; заниматься
töten — tötet — getötet — tötete = убивать
türkisch = турецкий
umfangreich = обширный
umleiten — leitet um — umgeleitet — leitete um = перенаправлять
umsatteln — sattelt um — umgesattelt — sattelte um = переучиваться
ungarisch = венгерский
unglaublich = невероятный
unpersönlich = безличный
unpopulär = непопулярный
unschätzbar = неоценимый
unten = внизу
unterhalten — unterhält — unterhalten — unterhielt = развлекать; беседовать
unterschiedlich = различный
unvergesslich = незабываемый
unüblich = необычный
verbessern — verbessert — verbessert — verbesserte = улучшать
verbrauchen — verbraucht — verbraucht — verbrauchte = потреблять
verbreiten — verbreitet — verbreitet — verbreitete = распространять
vereinen — vereint — vereint — vereinte = объединять
verfügen — verfügt — verfügt — verfügte = располагать
vergangen = прошедший
verhalten — verhält — verhalten — verhielt = вести себя
verletzen — verletzt — verletzt — verletzte = ранить
vermeiden — vermeidet — vermieden — vermied = избегать
vermuten — vermutet — vermutet — vermutete = предполагать
verneinen — verneint — verneint — verneinte = отрицать
vernichten — vernichtet — vernichtet — vernichtete = уничтожать
versetzen — versetzt — versetzt — versetzte = переводить; переносить
vertreiben — vertreibt — vertrieben — vertrieb = изгонять; продавать
verärgert = раздражённый
vollwertig = полноценный
vorbehalten — behält vor — vorbehalten — behielt vor = сохранять за собой
vorbereiten sich auf (Akkusativ) — bereitet vor — vorbereitet — bereitete vor = готовиться к
vorher = раньше
vorlesen — liest vor — vorgelesen — las vor = читать вслух
wachsend = растущий
wahr — wahrer — am wahrsten = истинный
wechseln — wechselt — gewechselt — wechselte = менять
wehren — wehrt — gewehrt — wehrte = сопротивляться
weisen — weist — gewiesen — wies = указывать
weiterführen — führt weiter — weitergeführt — führte weiter = продолжать
wert — werter — am wertesten = ценный
wiedergeben — gibt wieder — wiedergegeben — gab wieder = воспроизводить, передавать
wiederholen — wiederholt — wiederholt — wiederholte = повторять
wozu = зачем
würzen — würzt — gewürzt — würzte = приправлять
ziemlich = довольно
zuhören — hört zu — zugehört — hörte zu = слушать
zustellen — stellt zu — zugestellt — stellte zu = доставлять
zweimal = дважды
zwingen — zwingt — gezwungen — zwang = заставлять
die Älteren = пожилые
die Ölrechnung — Ölrechnungen = счёт за масло
äußerst = чрезвычайно, крайне
ökologisch = экологический
östlich = восточный
überlebt = выживший
überraschen — überrascht — überrascht — überraschte = удивлять
überraschend = удивительный
übertreffen — übertrifft — übertroffen — übertraf = превосходить
ebenso wie = также, как
schüchtern = застенчивый
gucken — guckt — geguckt — guckte = смотреть, глядеть
abhängen von (Dativ) — es hängt ab — abgehängt — hing ab = зависеть от
erkundigen sich bei (Dativ) — erkundigt — erkundigt — erkundigte = поинтересоваться у (где?)
unterscheiden sich in (Dativ) von (Dativ) — unterscheidet — unterschieden — unterschied = отличаться в ... от ...
liegen an (Dativ) — es liegt — gelegen — lag = быть причиной (чего?); зависеть от (чего?)
verlassen sich auf (Akkusativ) — verlässt — verlassen — verließ = полагаться на
nachfragen bei (Dativ) — fragt nach — nachgefragt — fragte nach = уточнять у
wundern sich über (Akkusativ) — wundert — gewundert — wunderte = удивляться по поводу
das Heimweh nach (Dativ) — Heimweh = тоска по
die Bereitschaft zu (Dativ) — Bereitschaften = готовность к
die Hoffnung auf (Akkusativ) — Hoffnungen = надежда на
die Erinnerung an (Akkusativ) — Erinnerungen = воспоминание о
das Zeichen für (Akkusativ) — Zeichen = знак для
bekannt für (Akkusativ) = известный (чем?)
beteiligt an (Dativ) = вовлечённый в
enttäuscht von (Dativ) = разочарованный в
geschieden von (Dativ) = разведённый с
getrennt von (Dativ) = отделённый от
scharf auf (Akkusativ) = быть без ума от; очень хотеть (что-то)
überzeugt von (Dativ) = уверенный в
verheiratet mit (Dativ) = женатый (замужем) c
zornig auf (Akkusativ) = (очень сильно) злой на