sein — ist gewesen — war — wäre = бути
und = і
in = в
ein = один, якийсь
haben — er hat — gehabt — hatte — hätte = мати
zu = до
es = це
auch = також
werden — er wird — ist geworden = ставати
ich = я
nicht = не
mit = з
sie = вона; вони
sich = себе
für = для
von = від
auf = на
so = так
wir = ми
können — ich/er kann — konnte — könnte = могти
dass = що
hier = тут
an = на, до
wie = як
man = людина, хтось
dieser = цей
aber = але
er = він
dann = потім
als = ніж, коли
ihr = ви (множина); її
aus = з
das Jahr = рік
noch = ще
bei = біля, у
machen — gemacht = робити
wenn = якщо, коли
mehr = більше
geben — er gibt — gegeben = давати
nur = лише
da = там, тут
also = отже
ganz = повністю
ja = так
oder = або
immer = завжди
jetzt = зараз
gut = добре
kommen — ist gekommen = приходити
schon = вже
alle = всі
nach = після, до
gehen — ist gegangen = йти
um = навколо, о (про час)
wollen — ich/er will — wollte = хотіти
vor = перед
was = що
sehr = дуже
jeder = кожен
groß = великий
einfach = просто
mal = раз
der Mensch = людина
der andere = інший
kein = ніякий, жодний
Deutschland = Німеччина
mein = мій
sagen — gesagt = говорити
doch = проте, однак
viel = багато
sehen — er sieht — gesehen = бачити
wieder = знову
über = над, про
wer = хто
weil = тому що
sollen — ich/er soll — sollte — sollte = повинен
bis = до
müssen — ich/er muss — musste — müsste = мусити
neu = новий
heute = сьогодні
natürlich = звісно
uns = нам
finden — gefunden = знаходити
unser = наш
denn = адже
aller = усі
mir = мені
wirklich = справді
eigentlich = власне
durch = через
der erste = перший
die Stadt = місто
seit = з (часу), з тих пір
deutsch = німецький
wo = де
die Welt = світ
die Leute = люди
der Tag = день
stehen — gestanden = стояти
die Zeit = час
damit = для того, щоб
mich = мене
wissen — gewusst = знати
arbeiten — gearbeitet = працювати
klein = маленький
leben — gelebt = жити
alt = старий
wichtig = важливий
das Kind = дитина
eben = саме
erst = лише, спочатку
etwas = щось
rund = круглий, приблизно
sondern = а, навпаки
halt = просто
das Haus = будинок
dafür = для цього
das Beispiel = приклад
selbst = сам
schön = гарний
nehmen — er nimmt — genommen = брати
denken an {Akk.} — gedacht = думати про
bekommen — bekommen = отримувати
ohne = без
das Leben = життя
bleiben — ist geblieben = залишатися
heißen — geheißen = називатися
du = ти
eigen = власний
dabei = при цьому
unter = під
liegen — gelegen = лежати
vielleicht = можливо
zeigen — gezeigt = показувати
gerade = саме зараз, прямий
das Land = країна, земля
der Euro = євро
weniger = менше
hoch = високий
glauben an {Akk.} — geglaubt = вірити в
drei = три
brauchen — gebraucht = потребувати
richtig = правильно
die Frau = жінка
lang = довгий
gar = зовсім
tun — getan = робити
schaffen — geschafft = справлятися
fast = майже
dürfen — ich/er darf — durfte — dürfte = мати дозвіл
ob = чи
weit = далеко
dazu = до цього
ihn = його
möchten — ich/er möchte = хотіти б
der Teil = частина
schnell = швидкий
genau = точно
bauen — gebaut = будувати
die Million = мільйон
gehören zu {Dat.} — gehört = належати до
lassen — er lässt — gelassen = дозволяти, залишати
sogar = навіть
das Prozent = відсоток
fahren — er fährt — ist gefahren = їхати
jung = молодий
die Familie = сім’я
das Problem = проблема
bringen — gebracht = приносити
der letzte = останній
der Ort = місце
weiter = далі
die Idee = ідея
das Wasser = вода
der Berliner = берлінець
nie = ніколи
der nächste = наступний
ab = з (часу)
haben — er hat — gehabt = мати
das Auto = автомобіль
nichts = нічого
das Geld = гроші
dort = там
einmal = одного разу
weltweit = всесвітній
das Ende = кінець
ihnen = їм
oft = часто
vier = чотири
der Mann = чоловік
besonders = особливо
ein bisschen = трохи
die Woche = тиждень
irgendwie = якось
lernen — gelernt = вчити
versuchen — versucht = намагатися
spielen — gespielt = грати
die Geschichte = історія
zurück = назад
die Arbeit = робота
Europa = Європа
davon = з цього
kennen — gekannt = знати
der Meter = метр
einiger = деякий
gegen = проти
die Stunde = година
schwer = важкий
zusammen = разом
der Fall = випадок
die Straße = вулиця
der Weg = шлях
entstehen — ist entstanden = виникати
der Monat = місяць
halten — er hält — gehalten = тримати
das Mal = раз
setzen {sich} — gesetzt = сідати
spät = пізно
anders = інакший
beide = обидва
ihm = йому
stellen — gestellt = ставити
die Musik = музика
deshalb = тому
echt = справжній
fünf = п’ять
gleich = однаковий, відразу
pro = на (про кількість)
das Bild = зображення
das Tier = тварина
führen — geführt = вести
stark = сильний
tatsächlich = дійсно
treffen {sich} — er trifft — getroffen = зустрічатися
die Sache = річ, справа
die Schule = школа
warum = чому
solcher = такий
sprechen — er spricht — gesprochen = говорити
zehn = десять
helfen — er hilft — geholfen = допомагати
verkaufen — verkauft = продавати
früh = рано
der Meister = майстер
das Unternehmen = підприємство
fühlen {sich} — gefühlt = відчувати
manchmal = іноді
überhaupt = взагалі
der Kunde = клієнт
entwickeln {sich} — entwickelt = розвиватися
etwa = приблизно
mancher = деякий
ein paar = кілька
zwischen = між
die Art = вид, спосіб
das Jahrhundert = століття
bereits = вже
kaum = ледве
klar = ясно
lang = довго
ne = не (розмовне)
nutzen — genutzt = використовувати
die Region = регіон
bissch = трохи (розмовне)
deswegen = через це
erleben — erlebt = переживати
toll = чудовий
der Freund = друг
die Zukunft = майбутнє
essen — er isst — gegessen = їсти
der Platz = місце
der Spaß = задоволення
schwierig = складний
nun = тепер
beginnen — begonnen = починати
deutsch = німецький
sogenannter = так званий
suchensuchen nach {Akk.} — gesucht = шукати
zwar = хоча
die Grenze = кордон
das Team = команда
damals = тоді
darauf = на цьому
selber = сам
welcher = який
ziehen — gezogen = тягнути, переїжджати
der Anfang = початок
passieren — ist passiert = траплятися
verschieden = різний
das Gefühl = почуття
der Raum = приміщення, простір
erreichen — erreicht = досягати
gerne = охоче
sonst = інакше
kaufen — gekauft = купувати
laufen — er läuft — ist gelaufen = бігати
produzieren — produziert = виробляти
trotzdem = все-таки
der Besucher = відвідувач
das Ding = річ
die Firma = компанія
die Hand = рука
der Kilometer = кілометр
euch = вам
leicht = легкий
möglich = можливий
verändern {sich} — verändert = змінюватися
der Moment = момент
während = під час
die Angst = страх
mittlerweile = тим часом
die Natur = природа
allein = один, сам
dadurch = через це
gelten — gegolten = вважатися
die Generation = покоління
der Grund = причина
eher = швидше
fallen — er fällt — ist gefallen = падати
funktionieren — funktioniert = функціонувати
das Stück = шматок
am = на, у (поєднання артикля і прийменника)
sitzen — ist gesessen = сидіти
unterwegs = в дорозі
wenig = мало
wohl = мабуть
die Herausforderung = виклик
der Kopf = голова
die Seite = сторона, сторінка
das Thema = тема
fertig = готовий
fragen — gefragt = запитувати
der Gast = гість
das Ziel = мета
darüber = про це
direkt = безпосередньо
komplett = повністю
schauen — geschaut = дивитися
die Form = форма
das Projekt = проєкт
die Wohnung = квартира
her = сюди
sechs = шість
sorgen für {Akk.} — gesorgt = піклуватися про
bewegen {sich} — bewegt = рухатися
bieten — geboten = пропонувати
kosten — gekostet = коштувати
rein = чистий, всередину
sicher = безпечний, впевнений
überall = всюди
hinter = позаду
kurz = короткий
tragen — er trägt — getragen = носити
voll = повний
der Baum = дерево
die Eltern = батьки
die Mutter = мати
die Tradition = традиція
herstellen — hergestellt = виготовляти
je = коли-небудь
lieben — geliebt = любити
oben = зверху
sozusagen = так би мовити
steigen — ist gestiegen = підніматися
wegen = через
der Krieg = війна
die Kunst = мистецтво
allerdings = однак
dauern — gedauert = тривати
hören — gehört = слухати
meinen — gemeint = мати на увазі
merken — gemerkt = помічати
das Dorf = село
das Museum = музей
aussehen — ausgesehen = виглядати
beliebt = популярний
daran = на цьому
extrem = надзвичайно
gemeinsam = спільно
insgesamt = загалом
modern = сучасний
verlieren — verloren = втрачати
das Fleisch = м’ясо
die Frage = запитання
teuer = дорогий
verstehen — verstanden = розуміти
der zweite = другий
der Berg = гора
der Job = робота
okay = гаразд
der Vater = батько
darum = через це
einzig = єдиний
erzählen — erzählt = розповідати
mögen — ich/er mag — mochte = любити
die Minute = хвилина
der Mitarbeiter = співробітник
der Winter = зима
bekannt = відомий
besonder = особливий
erkennen — erkannt = впізнавати
international = міжнародний
nennen — genannt = називати
normal = нормальний
die Erfahrung = досвід
die Heimat = батьківщина
die Technik = техніка
hin = туди
jemand = хтось
statt = замість
der Grad = градус
der Künstler = художник
der Markt = ринок
der Tourist = турист
kriegen — gekriegt = отримувати
raus = назовні
wachsen — ist gewachsen = рости
ziemlich = досить
die Energie = енергія
das Foto = фото
die Richtung = напрямок
alle = всі
bestimmt = визначений, певний
europäisch = європейський
irgendwann = колись
verbinden — verbunden = з’єднувати
der Blick = погляд
das Buch = книга
die Möglichkeit = можливість
der Name = ім’я
knapp = майже, недостатній
los = вільний, відірваний
mehrere = кілька
quasi = майже, так би мовити
schlecht = поганий
der Alltag = повсякденне життя
das Geschäft = магазин, бізнес
frei = вільний
freuen {sich} über / auf {Akk.} — gefreut = радіти чомусь (минулому/майбутньому)
gucken — geguckt = дивитися
inzwischen = тим часом
schreiben — geschrieben = писати
stecken — gesteckt = вставляти, застрягати
verdienen — verdient = заробляти
wohnen — gewohnt = жити
die Hilfe = допомога
der Preis = ціна
das Produkt = продукт
das Restaurant = ресторан
das Schloss = замок
der Schüler = учень
die USA = США
die Ukraine = Україна
das Video = відео
digital = цифровий
erhalten — erhalten = отримувати
genießen — genossen = насолоджуватися
kämpfen — gekämpft = боротися
persönlich = особистий
tanzen — getanzt = танцювати
das Licht = світло
der Sport = спорт
bedeuten — bedeutet = означати
berühmt = відомий
bevor = перш ніж
drin = усередині
egal = байдуже
entdecken — entdeckt = відкривати
gleichzeitig = одночасно
neben = поруч
sieben = сім
vorher = раніше
ändern — geändert = змінювати
die Situation = ситуація
die Uhr = годинник
bald = скоро
bezahlen — bezahlt = оплачувати
einige = кілька
irgendwo = десь
offen = відкритий
ungefähr = приблизно
das Bier = пиво
das Gebäude = будівля
das Jahrzehnt = десятиліття
die Nähe = близькість
die Person = особа
der Schweizer = швейцарець
der Wald = ліс
aktuell = актуальний
fehlen — gefehlt = бракувати
genauso = так само
gewinnen — gewonnen = вигравати
hoffen auf {Akk.} — gehofft = сподіватися
sozial = соціальний
stammen — gestammt = походити
vergangen = минулий
zumindest = щонайменше
öffentlich = публічний
die Farbe = колір
das Glück = щастя
die Menge = кількість
die Rolle = роль
draußen = назовні
erfolgreich = успішний
frisch = свіжий
holen — geholt = приносити
kümmern sich — gekümmert = піклуватися
laut = голосний, згідно з
perfekt = ідеальний
reichen — gereicht = вистачати
scheinen — geschienen = здаватися
schützen — geschützt = захищати
selten = рідко
traditionell = традиційний
vorstellen sich — vorgestellt = уявляти
warten auf {Akk.} — gewartet = чекати
die Gruppe = група
die Hauptstadt = столиця
der Kollege = колега
der Traum = мрія
anfangen — angefangen = починати
bisher = досі
daraus = з цього
deutlich = чітко
dir = тобі
gern = охоче
passen zu {Dat.} — gepasst = підходити
relativ = відносно
schmecken — geschmeckt = смакувати
täglich = щодня
wirken — gewirkt = діяти
wünschen — gewünscht = бажати
der Boden = підлога, ґрунт
die Chance = шанс
China = Китай
die Figur = фігура
das Holz = дерево (матеріал)
der Punkt = точка
die Regel = правило
acht = вісім
bestehen — bestanden = складатися, існувати, витримувати
hart = твердий, важкий
klassisch = класичний
nein = ні
weg = геть
zahlen — gezahlt = платити
das Auge = око
die Gesellschaft = суспільство
die Höhe = висота
das Medium = медіа, засіб
die Politik = політика
der Sinn = сенс
die Tonne = тонна
der Wiener = віденський житель
der Zug = поїзд
dich = тебе
gesamt = загальний
lassen — er lässt — gelassen = дозволяти, залишати
schließen — geschlossen = закривати
wahrscheinlich = ймовірно
die Ausstellung = виставка
die Marke = марка
der Schnee = сніг
die Sprache = мова
alleine = сам
bayerisch = баварський
daher = звідси
danach = після цього
drehen — gedreht = крутити
entscheiden — entschieden = вирішувати
fest = міцний
genug = достатньо
schlagen — geschlagen = бити
schließlich = зрештою
sofort = негайно
vorbei = повз, минуле
zusätzlich = додатково
die Alpen = Альпи
das Brot = хліб
das Internet = інтернет
die Miete = оренда
die Mitte = центр
die Nacht = ніч
das Schiff = корабель
die Weise = спосіб
betreiben — betrieben = займатися
eng = тісний
erfahren — erfahren = дізнаватися, досвідчений
feiern — gefeiert = святкувати
lesen — er liest — gelesen = читати
miteinander = разом
nah = близький
regelmäßig = регулярно
verlassen — er verlässt — verlassen = залишати
die Information = інформація
absolut = абсолютно
außerdem = крім того
beobachten — beobachtet = спостерігати
nachhaltig = сталий
neun = дев’ять
obwohl = хоча
riesig = величезний
tief = глибокий
total = повний, повністю
unterschiedlich = різний
völlig = повністю
der Bereich = сфера, область
der Bewohner = мешканець
der Dom = собор
das Eis = морозиво, лід
das Fahrzeug = транспортний засіб
Gott = Бог
die Kirche = церква
die Kultur = культура
das Modell = модель
das Netz = мережа
die Reise = подорож
die Schweiz = Швейцарія
der Strom = струм, потік
Venedig = Венеція
Wien = Відень
aufgrund = на підставі, через
drauf = на цьому, на ньому
ehemalig = колишній
erklären — erklärt = пояснювати
gelingen — gelungen = вдаватися
gründen — gegründet = засновувати
halb = наполовину
legen — gelegt = класти
sagen — gesagt = говорити
der Beruf = професія
der König = король
Paris = Париж
die Regierung = уряд
die Stelle = місце, посада
der Trend = тренд
erinnern {sich} an {Akk.} — erinnert = згадувати
hängen — gehangen = висіти
langsam = повільно
liefern — geliefert = доставляти
mindestens = принаймні
na = ну, так
niemand = ніхто
politisch = політичний
unterstützen — unterstützt = підтримувати
zerstören — zerstört = руйнувати
zunächst = спочатку
die Aufgabe = завдання
der Betrieb = підприємство
der Bus = автобус
das Gericht = суд, страва
das Material = матеріал
die Ruhe = спокій
der Schritt = крок
die Studie = дослідження
bereit = готовий
besonders = особливо
gewiss = певний
leiten — geleitet = керувати
meist = здебільшого
meistens = зазвичай
mitten = посеред
neu = новий
seitdem = з того часу
speziell = спеціальний
spüren — gespürt = відчувати
umgehen — umgegangen = обходитися, поводитися
verwenden — verwendet = використовувати
vorbereiten — vorbereitet = готувати
zählen — gezählt = рахувати
übernehmen — übernommen = брати на себе
der Arzt = лікар
die Bevölkerung = населення
die Bewegung = рух
die Bühne = сцена
der Einsatz = застосування
der Einwohner = житель
die Hälfte = половина
die Landschaft = пейзаж
die Meinung = думка
die Pandemie = пандемія
die Pause = перерва
der Sommer = літо
die Türkei = Туреччина
ankommen — ist angekommen = прибувати
backen — gebacken = пекти
bitte = будь ласка
dagegen = проти цього
darunter = під цим
einst = колись
gefährlich = небезпечний
grün = зелений
heutzutage = у наші дні
innerhalb = у межах
klingen — geklungen = звучати
leisten — geleistet = досягати
planen — geplant = планувати
plötzlich = раптово
reden — geredet = говорити
starten — gestartet = стартувати
sterben — er stirbt — ist gestorben = помирати
stolz = гордий
technisch = технічний
treten — getreten = ступати
unglaublich = неймовірний
wahr = справжній
überlegen — überlegt = обмірковувати
die App = додаток
der Beton = бетон
das Datum = дата
der Druck = тиск, друк
die Entscheidung = рішення
die Erde = земля
der Erfolg = успіх
der Fisch = риба
die Folge = наслідок
der Geschmack = смак
das Instrument = інструмент
der Kontakt = контакт
die Lösung = рішення
das Muss = необхідність
die Produktion = виробництво
das Schnitzel = шніцель
beschäftigen — beschäftigt = займатися
einzeln = окремий
entsprechend = відповідний
historisch = історичний
häufig = частий
leider = на жаль
längst = давно
möglichst = якомога
teilweise = частково
trotz = незважаючи на
typisch = типовий
öffnen — geöffnet = відкривати
das Fenster = вікно
der Film = фільм
das Gesicht = обличчя
der Lehrer = вчитель
die Liebe = любов
das Spiel = гра
das Werk = робота, твір
anschauen — angeschaut = дивитися
besuchen — besucht = відвідувати
britisch = британський
ganz = цілий, повністю
lieb = милий
lieber = краще
nachdem = після того як
privat = приватний
sammeln — gesammelt = збирати
schwarz = чорний
testen — getestet = тестувати
ähnlich = схожий
die Ausbildung = освіта
das Bauwerk = споруда
der Chef = начальник
der Döner = донер
der Fan = фанат
Frankreich = Франція
das Hotel = готель
die Kamera = камера
die Kuh = корова
die Küche = кухня
die Leidenschaft = пристрасть
die Pflanze = рослина
der Sohn = син
die Sorge = турбота
der Spargel = спаржа
der Star = зірка
der Wert = цінність
der Westen = захід
das Wort = слово
die Zahl = число
bunt = яскравий
derzeit = на даний момент
ehrlich = чесно
endlich = нарешті
erfinden — erfunden = винаходити
fangen — gefangen = ловити
fliegen — ist geflogen = літати
fotografieren — fotografiert = фотографувати
gebären — geboren = народжувати
handeln — gehandelt = діяти
interessant = цікавий
per = через, за допомогою
rufen — gerufen = кликати
stattfinden — stattgefunden = відбуватися
teilen — geteilt = ділити
vergessen — er vergisst — vergessen = забувати
vermitteln — vermittelt = посередничати
weiß = білий
die Anlage = установка, обладнання
Bayern = Баварія
die Behörde = орган влади
die Brücke = міст
die Entwicklung = розвиток
Hallo = привіт
der Herr = пан
das Herz = серце
die Karriere = кар’єра
das Kilo = кілограм
die Milch = молоко
die Milliarde = мільярд
der Morgen = ранок
München = Мюнхен
Russland = Росія
der Vorteil = перевага
Weihnachten = Різдво
das Zentrum = центр
das Zuhause = дім
aufbauen — aufgebaut = будувати — побудовано
dritter = третій
entfernen — entfernt = видаляти — видалено
eröffnen — eröffnet = відкривати — відкрито
gering = незначний
momentan = тимчасовий
normalerweise = зазвичай
positiv = позитивний
praktisch = практичний
russisch = російський
studieren — studiert = вивчати — вивчено
ständig = постійно
verbringen — verbracht = проводити — проведено
Österreich = Австрія
überzeugen — überzeugt = переконувати — переконано
Corona = корона
Deutsch = німецький
das Essen = їжа
der Experte = експерт
das Fahrrad = велосипед
die Fahrt = поїздка
der Fuß = нога
das Gesetz = закон
die Größe = розмір
die Maschine = машина
die Mode = мода
die Polizei = поліція
der Schutz = захист
der Stoff = тканина
die Tour = тур
die Wahl = вибір
der Weihnachtsbaum = новорічна ялинка
bestimmen — bestimmt = визначати — визначено
bewusst = свідомий
folgen — gefolgt = слідувати — слідувало
französisch = французький
glücklich = щасливий
günstig = вигідний
reagieren auf {Akk.} — reagiert = реагувати на {Akk.} — відреаговано
retten — gerettet = рятувати — врятовано
spannend = захоплюючий
trinken — getrunken = пити — випито
wunderbar = чудовий
zwölf = дванадцять
der Bau = будівництво
die Branche = галузь
der Bruder = брат
der Club = клуб
das Dach = дах
das Ergebnis = результат
Italien = Італія
der Körper = тіло
der Landwirt = фермер
das Lebensmittel = продовольство
das Meer = море
das Motiv = мотив
der Nachbar = сусід
die Qualität = якість
die Strecke = відстань
super = супер
das System = система
der Tisch = стіл
der Unterschied = різниця
die Verbindung = зв’язок
das Vorbild = зразок
der Wunsch = бажання
die Zutat = інгредієнт
bilden — gebildet = формувати — сформовано
eins = один
erwarten — erwartet = очікувати — очікувано
finden — gefunden = знаходити — знайдено
fällen — gefällt = рубати — порубано
gestalten — gestaltet = оформляти — оформлено
global = глобальний
interessieren für {Akk.} — interessiert = цікавитися {Akk.} — зацікавлено
investieren — investiert = інвестувати — інвестовано
lösen — gelöst = вирішувати — вирішено
offiziell = офіційний
organisieren — organisiert = організовувати — організовано
probieren — probiert = пробувати — спробувано
streng = строгий
tausend = тисяча
türkisch = турецький
vegan = веганський
verarbeiten — verarbeitet = обробляти — оброблено
verbessern — verbessert = покращувати — покращено
wesentlich = суттєвий
wirtschaftlich = економічний
zahlreich = численний
der Bauer = селянин
der Besuch = візит
die Botschaft = посольство
die Freiheit = свобода
die Gefahr = небезпека
das Konzept = концепція
das Kostüm = костюм
die Luft = повітря
der Mieter = орендар
die Moschee = мечеть
das Mädchen = дівчина
der Norden = північ
der Park = парк
die Pizza = піца
die Schokolade = шоколад
die Show = шоу
der Staat = держава
der Stein = камінь
die Stimme = голос
Tausend = тисяча
der Tourismus = туризм
der Urlaub = відпустка
der Weihnachtsmann = Дід Мороз
der Weltkrieg = світова війна
anbieten — angeboten = пропонувати — запропоновано
begeistert = захоплений
bereiten — vorbereitet = готувати — підготовлено
betreffen — betroffen = стосуватися — стосувалося
davor = перед тим
dein = твій
dran = поруч
einsetzen — eingesetzt = застосовувати — застосовано
erzeugen — erzeugt = створювати — створено
faszinierend = захоплюючий
gut = хороший
hierher = сюди
kalt = холодний
landen — gelandet = приземлятися — приземлено
morgens = вранці
nämlich = а саме
stimmen — gestimmt = голосувати — проголосовано
unbedingt = обов’язково
verteilen — verteilt = розподіляти — розподілено
warm = теплий
weiterhin = надалі
wählen — gewählt = вибирати — вибрано
zuerst = спочатку
überleben — überlebt = вижити — вижито
das Alter = вік
das Angebot = пропозиція
der Auftrag = замовлення
Belgien = Бельгія
Großbritannien = Великобританія
das Handy = мобільний телефон
das Insekt = комаха
der Kauf = покупка
die Kosten = витрати
das Model = модель
der Musiker = музикант
die Plattform = платформа
der Protest = протест
der Quadratmeter = квадратний метр
das Recht = право
das Rezept = рецепт
der Schuh = черевик
die Spur = слід
der Tanz = танець
der Ton = тон
das Tor = ворота
das Training = тренування
die Umwelt = навколишнє середовище
der Vergleich = порівняння
das Wetter = погода
aktiv = активний
aufwachsen — ist aufgewachsen = рости — виріс
entfernt = віддалений
füllen — gefüllt = наповнювати — наповнено
greifen — gegriffen = схоплювати — схоплено
irgendwas = щось
jedoch = однак
jährlich = щорічно
kennenlernen — kennengelernt = знайомитися — познайомлено
lohnen — gelohnt = варто — варто було
profitieren — profitiert = отримувати вигоду — отримано вигоду
schlimm = поганий
sparen — gespart = економити — зекономлено
verschwinden — ist verschwunden = зникати — зникло
wandern — ist gewandert = мандрувати — помандрував
wechseln — gewechselt = міняти — змінено
üben — geübt = тренуватися — тренувалося
die Architektur = архітектура
Asien = Азія
der Auftritt = виступ
der Brite = англієць
das Büro = офіс
das Erlebnis = переживання
die Flasche = пляшка
das Gegenteil = протилежність
das Geheimnis = секрет
Indien = Індія
die Insel = острів
das Interesse = інтерес
die Lage = місце розташування
die Leistung = досягнення
die Masse = маса
der Nationalpark = національний парк
der Patient = пацієнт
Polen = Польща
der Roman = роман
der Salat = салат
die Seele = душа
der Song = пісня
die Steuer = податок
die Unterstützung = підтримка
das Zimmer = кімната
aufnehmen — aufgenommen = приймати — прийнято
sich befinden — sich befunden = знаходитися — знаходилося
entwerfen — entworfen = проектувати — спроектовано
fordern — gefordert = вимагати — вимагалося
hinten = ззаду
hinterher = позаду
integrieren — integriert = інтегрувати — інтегровано
jugendliche = підлітки
lustig = смішний
mitnehmen — mitgenommen = брати з собою — взято з собою
nahe = близький
nötig = необхідний
rauchen — geraucht = курити — курено
rot = червоний
schlafen — er schläft — geschlafen = спати — спить — спав
schätzen — geschätzt = оцінювати — оцінено
super = супер
ukrainisch = український
unabhängig = незалежний
unten = внизу
verantwortlich = відповідальний
vertrauen — vertraut = довіряти — довірено
wann = коли
zweimal = двічі
übrig = залишковий
die Alternative = альтернатива
die Altstadt = старе місто
die Antwort = відповідь
die Behinderung = інвалідність
die Brezel = крендель
der Bürger = громадянин
der Computer = комп’ютер
das Detail = деталь
das Element = елемент
der Engel = ангел
das Feld = поле
die Fläche = площа
der Gedanke = думка
das Gemüse = овочі
das Gespräch = розмова
das Handwerk = ремесло
die Industrie = промисловість
die Kraft = сила
der Käse = сир
der Laden = магазин
der Liter = літр
die Mauer = стіна
die Nachfrage = попит
die Nummer = номер
der Passagier = пасажир
das Patent = патент
der Plan = план
das Ruhrgebiet = Рурський регіон
die Schwester = сестра
der See = озеро
die Sicherheit = безпека
das Umfeld = оточення
der Unterricht = урок
das Virus = вірус
der Wanderer = мандрівник
der Wasserstoff = водень
die Werkstatt = майстерня
abends = ввечері
ausprobieren — ausprobiert = пробувати — спробовано
bedrohen — bedroht = загрожувати — загрожено
beispielsweise = наприклад
dahinter = за цим
definitiv = остаточно
dienen — gedient = служити — служено
einzigartig = унікальний
falsch = неправильний
fein = тонкий
froh = радий
heraus = назовні
inspirieren — inspiriert = надихати — натхненно
kreativ = креативний
rechnen — gerechnet = рахувати — пораховано
schicken — geschickt = відправляти — відправлено
sicherlich = напевно
stoßen — gestoßen = натикатися — наткнено
verbieten — verboten = забороняти — заборонено
verhindern — verhindert = запобігати — запобігано
vermutlich = ймовірно
verrückt = божевільний
zuvor = раніше
österreichisch = австрійський
der Abend = вечір
der Arbeitsplatz = робоче місце
der Architekt = архітектор
der Brandenburger = бранденбуржець
der Brief = лист
Celsius = Цельсій
der Designer = дизайнер
das Fest = свято
das Feuer = вогонь
der Flughafen = аеропорт
der Garten = сад
der Golf = гольф
die Haut = шкіра
der Inhalt = зміст
der Karneval = карнавала
das Klima = клімат
das Konzert = концерт
die Krise = криза
die Maske = маска
die Oberfläche = поверхня
das Paar = пара
der Partner = партнер
der Politiker = політик
der Rohstoff = сировина
die Runde = коло
das Schwein = свиня
der Stress = стрес
der Student = студент
der Teilnehmer = учасник
der Test = тест
die Tochter = донька
die Tür = двері
die Variante = варіант
die Vielfalt = різноманіття
der Walzer = вальс
die Wand = стіна
die Wolle = шерсть
die Wurzel = корінь
ausschließlich = виключно
begeistern — begeistert = захоплювати — захоплено
begleiten — begleitet = супроводжувати — супроводжено
brechen — er bricht — gebrochen = ламати — ламає — зламано
chinesisch = китайський
darin = в цьому
derselbe = той самий
desto = тим більше
durchaus = цілком
ersetzen — ersetzt = замінювати — замінено
festhalten — festgehalten = тримати — втримано
feststellen — festgestellt = констатувати — констатовано
heben — gehoben = піднімати — піднято
heimisch = місцевий
klappen — geklappt = вдаватися — вдалося
kochen — gekocht = готувати — приготовлено
kreieren — kreiert = створювати — створено
leiden — gelitten = страждати — страждало
niederländisch = нідерландський
nördlich = північний
professionell = професійний
servieren — serviert = подавати — подано
tot = мертвий
trainieren — trainiert = тренувати — тренувався
versorgen — versorgt = забезпечувати — забезпечено
warnen — gewarnt = попереджати — попереджено
weder = ані
wär = був би
übrigens = до речі
das Alphorn = альпійський ріг
das Ausland = закордон
das Bett = ліжко
die Börse = біржа
die DDR = НДР
die Erfindung = винахід
das Flugzeug = літак
das Gas = газ
die Gegend = місцевість
das Geräusch = звук
die Großstadt = велике місто
Hamburg = Гамбург
der Junge = хлопець
die Kleidung = одяг
das Kunstwerk = витвір мистецтва
der Kölner = колонець
der Lauf = біг
der Lebkuchen = пряник
der Motor = двигун
der Mut = відвага
die Möbel = меблі
nee = ні
die Niederlande = Нідерланди
das Phänomen = феномен
der Rest = решта
das Salz = сіль
die Sicht = видимість
die Szene = сцена
der Süden = південь
die Temperatur = температура
der Tunnel = тунель
der Verein = клуб
die Verfügung = наявність
die Wirtschaft = економіка
anlegen — angelegt = вкладати — вкладено
anstrengend = виснажливий
außen = зовні
beruflich = професійний
bestellen — bestellt = замовляти — замовлено
billig = дешевий
bislang = до цього часу
dennoch = тим не менш
drinnen = всередині
ernst = серйозний
früher = раніше
gegenüber = навпроти
gemütlich = затишний
heutig = сьогоднішній
irgendein = якийсь
kontrollieren — kontrolliert = контролювати — контролювано
malen — gemalt = малювати — намальовано
mischen — gemischt = змішувати — змішано
nachts = вночі
präsentieren — präsentiert = представляти — представлено
reduzieren — reduziert = зменшувати — зменшено
singen — gesungen = співати — співано
ungewöhnlich = незвичайний
verfolgen — verfolgt = переслідувати — переслідувано
verzichten — verzichtet = відмовлятися — відмовлено
virtuell = віртуальний
wunderschön = чудовий
zuständig = відповідальний
das Bein = нога
das Blatt = листок
die Bäckerei = пекарня
cool = класний
die Currywurst = ковбаса з карі
das Dirndl = дирндль (традиційний жіночий костюм)
die Ecke = кут
der Eindruck = враження
die Erinnerung = пам’ять
der Fehler = помилка
der Flüchtling = біженець
die Fotografie = фотографія
die Gemeinde = громада
die Gesundheit = здоров’я
das Glas = скло
der Glühwein = глінтвейн
das Haar = волосся
der Hintergrund = фон
das Hobby = хобі
die Hoffnung = надія
der Händler = продавець
der Impfstoff = вакцина
der Kaiser = імператор
der Kampf = бій
das Kilogramm = кілограм
die Klasse = клас
die Kohle = вугілля
das Krankenhaus = лікарня
die Krankheit = хвороба
der Kurs = курс
die Lust = бажання
das Mitglied = член
das Mittel = засіб
das Objekt = об’єкт
online = онлайн
die Partei = партія
das Prinzip = принцип
das Publikum = публіка
die Realität = реальність
die Ressource = ресурс
die Sammlung = колекція
das Schweden = Швеція
die Sekunde = секунда
das Smartphone = смартфон
die Spende = пожертвування
das Stroh = солома
das Studium = навчання
die Technologie = технологія
die Verantwortung = відповідальність
der Verkehr = рух
das Vorurteil = упередження
die Ware = товар
die Welle = хвиля
die Werbung = реклама
der Wind = вітер
der Wissenschaftler = науковець
das Wochenende = вихідні
der Wolf = вовк
der Zucker = цукор
angehen — angegangen = стосуватися — стосувалося
anschließend = після цього
ansonsten = в іншому випадку
aufgeben — aufgegeben = здаватися — здалося
aufstellen — aufgestellt = встановлювати — встановлено
außerhalb = поза
beibringen — beigebracht = навчати — навчено
beitragen — beigetragen = робити внесок — зроблено внесок
belgisch = бельгійський
benutzen — benutzt = використовувати — використано
circa = близько
dahin = туди
entscheidend = вирішальний
erforschen — erforscht = досліджувати — досліджено
errichten — errichtet = зводити — збудовано
extra = окремо
gesund = здоровий
herrschen — geherrscht = панувати — панувало
krank = хворий
langfristig = довгостроковий
letztendlich = в кінцевому підсумку
links = ліворуч
motivieren — motiviert = мотивувати — мотивовано
mussten — gemusst = мусили — мусили
nebenan = поряд
niedrig = низький
niemals = ніколи
ruhig = спокійний
sauber = чистий
scharf = гострий
scheitern — gescheitert = зазнати невдачі — зазнано невдачу
selbstverständlich = зрозуміло
sichtbar = видимий
süß = солодкий
transportieren — transportiert = транспортувати — транспортувано
treiben — getrieben = займатися — займався
trocken = сухий
veröffentlichen — veröffentlicht = публікувати — опубліковано
vorne = спереду
wussten — gewusst = знали — знали
öfter = частіше
der Abstand = відстань
das Album = альбом
der Alkohol = алкоголь
die Aussicht = вид
die Band = група
die Basis = основа
die Bedingung = умова
das Bewusstsein = свідомість
das Bord = борт
Brasilien = Бразилія
die Burg = замок
der Cent = цент
der Dank = подяка
der Dollar = долар
das Drittel = третина
das Ei = яйце
der Fahrer = водій
der Finger = палець
die Freude = радість
das Geschenk = подарунок
der Hersteller = виробник
die Herstellung = виробництво
der Hof = двір
Indonesien = Індонезія
die Institution = інституція
die KI (Künstliche Intelligenz) = ШІ (штучний інтелект)
kannst — gekonnt = можеш — зміг
der Kaugummi = жувальна гумка
der King = король
der Klang = звук
der Klimawandel = зміна клімату
Köln = Кельн
die Lehrerin = вчителька
der Look = вигляд
der Mythos = міф
das Oktoberfest = Октоберфест
das Original = оригінал
der Post = пошта
das Risiko = ризик
der Rücken = спина
der Schaden = шкода
der Schnitt = розріз
der Schwarzwald = Чорний ліс
das Ski = лижа
der Stil = стиль
das Studio = студія
das Symbol = символ
der Teig = тісто
der Tod = смерть
die Umfrage = опитування
der Umsatz = оборот
der Ursprung = походження
das Viertel = квартал
die Vorstellung = уявлення
der Wagen = автомобіль
das Wahrzeichen = пам’ятка
der Weihnachtsmarkt = різдвяний ринок
der Wein = вино
achten — geachtet = звертати увагу — звернено увагу
analog = аналогічний
anderthalb = півтора
aufmerksam = уважний
bearbeiten — bearbeitet = обробляти — оброблено
behaupten — behauptet = стверджувати — стверджено
benötigen — benötigt = потребувати — потребувалося
dank = завдяки
derjenige = той, хто
dokumentieren — dokumentiert = документувати — задокументовано
einstellen — eingestellt = налаштовувати — налаштовано
elf = одинадцять
entspannen — entspannt = розслаблятися — розслаблено
entweder = або
ermöglichen — ermöglicht = дозволяти — дозволено
faszinieren — fasziniert = захоплювати — захоплено
fertigen — gefertigt = виготовляти — виготовлено
fliehen — ist geflohen = тікати — втік
fürchten — gefürchtet = боятися — побоювано
geraten — geraten = потрапляти — потраплено
gewöhnen — gewöhnt = звикати — звикло
heiß = гарячий
hinaus = назовні
hundert = сто
immerhin = все ж
interessiert = зацікавлений
konzentrieren sich — konzentriert = зосереджуватися — зосереджено
laden — geladen = завантажувати — завантажено
leer = порожній
magisch = магічний
maximal = максимальний
mitmachen — mitgemacht = брати участь — взято участь
mobil = мобільний
passend = підходящий
real = реальний
recht = правильний
reich = багатий
reisen — gereist = подорожувати — подорожував
rennen — ist gerannt = бігти — біг
runter = вниз
schneiden — geschnitten = різати — різано
schön = красивий
sodass = так що
stören — gestört = турбувати — турбувано
trauen — getraut = довіряти — довірено
träumen von {Dat.} — geträumt = мріяти про {Dat.} — мріяли
ursprünglich = початковий
verletzen — verletzt = травмувати — травмовано
werfen — er wirft — geworfen = кидати — кидає — кинуто
wertvoll = цінний
zeichnen — gezeichnet = малювати — намальовано
zukünftig = майбутній
überraschen — überrascht = дивувати — здивовано
Afrika = Африка
die Agentur = агентство
der Arbeitgeber = роботодавець
die Bahn = залізниця
der Bahnhof = вокзал
die Baustelle = будівельний майданчик
das Bulgarien = Болгарія
der Bundestag = Бундестаг
das Dia = діа (слайд)
der Durchschnitt = середнє значення
die EU = ЄС
der Effekt = ефект
einfach = простий
das Erbe = спадщина
der Februar = лютий
der Flug = політ
die Forschung = дослідження
das Frankfurt = Франкфурт
die Gemeinschaft = громада
das Grundeinkommen = базовий дохід
die Haltung = ставлення
der Hamburger = гамбургер
der Handwerker = ремісник
die Heimatstadt = рідне місто
hundert = сто
die Identität = ідентичність
die Innenstadt = центр міста
Japan = Японія
jodeln — gejodelt = йодлювати — йодлювано
der Kanal = канал
die Kassette = касета
der Kebab = кебаб
die Kollektion = колекція
der Krebs = рак
Leipzig = Лейпциг
die Lokomotive = локомотив
die Macht = влада
das Mehl = борошно
der Müll = сміття
die Nachricht = новина
der Oldtimer = ретро-автомобіль
Pakistan = Пакистан
der Pariser = паризький
die Party = вечірка
Potsdam = Потсдам
das Programm = програма
der Rock = спідниця
die Schicht = зміна
die Spezialität = спеціальність
die Sportart = вид спорту
die Spree = Шпрее (річка в Берліні)
der Start = старт
die Suche = пошук
das Tal = долина
der Teller = тарілка
der Termin = термін
der Turm = вежа
der Tänzer = танцюрист
der User = користувач
der VW = Фольксваген
die Vergangenheit = минуле
der Verkauf = продаж
die Veränderung = зміна
der Volkswagen = Фольксваген
die Weihnachtsgurke = різдвяний огірок
das Wohnzimmer = вітальня
die Zeichnung = малюнок
der Zirkus = цирк
der Zustand = стан
der Abgeordnete = депутат
anpassen sich — angepasst = пристосовуватися — пристосовано
austauschen — ausgetauscht = обмінюватися — обміняно
bedienen — bedient = обслуговувати — обслуговувано
beeindrucken — beeindruckt = вражати — вражено
beeindruckend = вражаючий
beeinflussen — beeinflusst = впливати — впливало
behalten — behalten = зберігати — збережено
der Bekannte = знайомий
berühren — berührt = торкатися — торкнуто
beweisen — bewiesen = доводити — доведено
diskutieren — diskutiert = обговорювати — обговорено
erstmal = вперше
erwachsen = дорослий
ewig = вічний
exportieren — exportiert = експортувати — експортовано
genügend = достатньо
herkommen — gekommen = приходити — прийшов
indem = тим самим
innen = всередині
insbesondere = зокрема
insofern = в тому випадку
kaputt = зламано
offensichtlich = очевидно
recyceln — recycelt = переробляти — перероблено
schwimmen — geschwommen = плавати — плавано
sowohl = як … так і
spanisch = іспанський
treu = вірний
umsetzen — umgesetzt = реалізовувати — реалізовано
verwandeln — verwandelt = перетворювати — перетворено
vorhanden = наявний
wahrnehmen — wahrgenommen = сприймати — сприйнято
weitergehen — weitergegangen = йти далі — пішов далі
wert = цінний
wiederum = в свою чергу
willkommen = ласкаво просимо
das Abenteuer = пригода
die Anerkennung = визнання
die Armee = армія
der Artikel = стаття
die Auswirkung = вплив
die Bank = банк
der Bauch = живіт
der Beginn = початок
der Beitrag = внесок
die Belastung = навантаження
die Beziehung = стосунки
der Bezug = відношення
die Blüte = цвітіння
die Brauerei = пивоварня
das Bundesland = федеральна земля
der Bürgermeister = мер
die Community = спільнота
das Design = дизайн
die Diagnose = діагноз
der Diesel = дизель
Düsseldorf = Дюссельдорф
die Ehre = честь
die Emotion = емоція
das Ensemble = ансамбль
der Esel = осел
das Experiment = експеримент
der Follower = підписник
die Freundschaft = дружба
die Fähigkeit = здатність
das Gebiet = область
das Gerät = пристрій
das Getreide = зерно
die Gewalt = насильство
Grönland = Гренландія
der Handel = торгівля
die Initiative = ініціатива
die Inspiration = натхнення
der Investor = інвестор
der Keller = підвал
der Kredit = кредит
das Kreuzfahrtschiff = круїзний корабель
die Kugel = кулька
die Kulisse = декорації
der Käufer = покупець
der Köhler = вугляр
die Landwirtschaft = сільське господарство
der Lohn = заробітна плата
der Müller = млин
der Oktober = жовтень
der Pist = піст
der Planet = планета
die Pommes = картопля фрі
der Rattenfänger = ловец щурів
der Reichstag = Рейхстаг
die Reihe = ряд
der Rhein = Рейн (річка)
der Sand = пісок
der Schluss = кінець
die Schwierigkeit = складність
die Schönheit = краса
das Social = соціальний
die Spitze = вершина
die Staatsbürgerschaft = громадянство
die Station = станція
die Stiftung = фонд
die Stimmung = настрій
der Supermarkt = супермаркет
der Trainer = тренер
der Verbraucher = споживач
die Version = версія
das Volk = народ
die Vorbereitung = підготовка
der West = захід
die Wildkräuter = дикий кріп
das Wunder = чудо
die Wärme = тепло
das Zeichen = знак
der Zufall = випадок
der Zuschauer = глядач
ansagen — angesagt = оголошувати — оголошено
ansehen — angesehen = дивитися — подивилися
anziehen — angezogen = одягати — одягнено
arm = бідний
aufregend = захоплюючий
aussterben — ausgestorben = вимерти — вимерло
automatisch = автоматичний
außergewöhnlich = надзвичайний
behandeln — behandelt = поводитися — поводилися
beziehen — bezogen = отримувати — отримано
blau = синій
bloß = тільки
buchen — gebucht = бронювати — заброньовано
diverser = різноманітний
doppelt = подвійний
drüber = зверху
dunkel = темний
durchschnittlich = середній
dünn = тонкий
effizient = ефективний
eingehen — eingegangen = вступати — вступлено
einheimisch = місцевий
elektrisch = електричний
empfinden — empfunden = відчувати — відчувано
erfüllen — erfüllt = виконувати — виконано
ergeben — ergeben = давати — віддано
erledigen — erledigt = виконувати — виконано
erschaffen — erschaffen = створювати — створено
fantastisch = фантастичний
finanziell = фінансовий
fördern — gefördert = сприяти — сприяло
gelangen — gelangt = потрапляти — потраплено
gestern = вчора
gigantisch = гігантський
grundsätzlich = принциповий
haben — er hat — gehabt = мати — він має — мав
hauptsächlich = головним чином
herausfinden — herausgefunden = дізнаватися — дізналися
herkömmlich = звичайний
hinein = всередину
hinzu = додатково
hochwertig = високоякісний
hoffentlich = сподіваюся
ideal = ідеальний
irgendwelcher = будь-який
essen — er isst — gegessen = їсти — він їсть — їли
italienisch = італійський
jahrelang = багато років
kleben — geklebt = клеїти — приклеєно
kompliziert = складний
künftig = майбутній
künstlich = штучний
lebend = живий
lecker = смачний
lenken — gelenkt = керувати — керовано
letztlich = врешті-решт
olympisch = олімпійський
regional = регіональний
schießen — geschossen = стріляти — стріляно
sichern — gesichert = забезпечувати — забезпечено
sinken — gesenkt = опускатися — опущено
sportlich = спортивний
trennen — getrennt = розлучати — розлучено
umso = тим більше
unterscheiden — unterschieden = відрізняти — відрізнялося
verbreiten — verbreitet = поширювати — поширено
vereinen — vereint = об’єднувати — об’єднано
vertreiben — vertrieben = вигоняти — вигнано
weich = м’який
widmen — gewidmet = присвячувати — присвячено
zentral = центральний
ökologisch = екологічний
die Ahnung = уявлення
der Anteil = частка
der Arbeitnehmer = працівник
die Aufmerksamkeit = увага
die Aufnahme = запис
der Ausflug = екскурсія
die Autobahn = автобан
der Autor = автор
der Ball = м’яч
die Bedeutung = значення
der Bunker = бункер
die Butter = масло
der Charakter = характер
die Diversität = різноманітність
das Dutzend = дюжина
die Ebene = рівень
die Fashion = мода
die Fassade = фасада
der Forscher = дослідник
der Franzose = француз
das Frühstück = сніданок
das Gefängnis = тюрма
das Gehalt = зарплата
das Gehirn = мозок
das Gewicht = вага
der Gletscher = льодовик
das Gold = золото
der Großteil = більшість
der Großvater = дідусь
das Gut = маєток
die Handarbeit = ручна робота
die Herzen = серця
hey = привіт
das Highlight = головна подія
der Himmel = небо
der Holzmarkt = ринок деревини
die Innovation = інновація
die Intelligenz = інтелект
der Juli = липень
die Kartoffel = картопля
die Katastrophe = катастрофа
die Kindheit = дитинство
der Klassiker = класика
der Kontinent = континент
die Koralle = корал
der Kranich = журавель
die Kräuter = трави
der Kunze = куниця
das Kurzem = нещодавно
der Mauerfall = падіння стіни
die Maßnahme = захід
die Metropole = метрополія
das Mittelalter = середньовіччя
das Münster = монастир
der Nacktmull = голий землекоп
das Ohr = вухо
die Oma = бабуся
das Opfer = жертва
die Option = опція
der Ost = схід
das Papier = папір
die Perspektive = перспектива
das Preußen = Пруссія
der Rassismus = расизм
der Respekt = повага
die Schneekugel = снігова куля
die Schulter = плече
die Schülerin = учениця
das Spanien = Іспанія
der Spieler = гравець
der Stadtteil = район міста
der Strand = пляж
der Strohbär = солом’яний ведмідь
die Struktur = структура
der Tipp = порада
der Titel = титул
der Trick = трюк
die Tänzerin = танцівниця
die Universität = університет
die Veranstaltung = захід
das Verkehrsmittel = транспортний засіб
der Versuch = спроба
das Wachstum = ріст
das Weingut = виноробне господарство
der Weizen = пшениця
das Werkzeug = інструмент
der Wettbewerb = конкуренція
der Zoo = зоопарк
abbauen — abgebaut = знижувати — знижено
der Angestellte = службовець
ausgehen — ausgegangen = виходити — вийшли
auskommen — ausgekommen = ладнати — ладнано
ausstatten — ausgestattet = обладнати — обладнано
beschreiben — beschrieben = описувати — описано
besetzen — besetzt = займати — зайнято
beteiligen — beteiligt = брати участь — брали участь
betrachten — betrachtet = розглядати — розглянуто
breit = широкий
brennen — gebrannt = горіти — горіло
dankbar = вдячний
darstellen — dargestellt = зображати — зображено
dauerhaft = постійний
dick = товстий
diesmal = цього разу
ebenfalls = також
ebenso = так само
einerseits = з одного боку
einladen — eingeladen = запрошувати — запрошено
enden — geendet = закінчувати — закінчено
enorm = величезний
enthalten — enthalten = містити — містить
entsorgen — entsorgt = утилізувати — утилізовано
erkunden — erkundet = досліджувати — досліджено
erlauben — erlaubt = дозволяти — дозволено
erneuerbar = відновлюваний
erscheinen — erschienen = з’являтися — з’явився
exklusiv = ексклюзивний
finanzieren — finanziert = фінансувати — профінансовано
freiwillig = добровільний
gegessen — essen — gegessen = їсти — їв — з’їдено
geheim = таємний
geil = крутий
gewaltig = величезний
großartig = чудовий
grün = зелений
herum = навколо
jedenfalls = в будь-якому випадку
kehren — gekehrt = підмітати — підмітено
mehrfach = багаторазовий
melden — gemeldet = повідомляти — повідомлено
mutig = сміливий
nachdenken — nachgedacht = обдумувати — обдумано
nachher = пізніше
nix = нічого
nähen — genäht = шити — пошито
polnisch = польський
ran = підходити
reinigen — gereinigt = очищати — очищено
richten — gerichtet = направляти — направлено
schade = шкода
senken — gesenkt = знижувати — знижено
sowieso = все одно
traurig = сумний
unmöglich = неможливий
unterrichten — unterrichtet = навчати — навчено
von = від
verdanken — verdankt = завдячувати — завдячено
verhalten — verhalten = поводитися — поводжено
viert = четвертий
vorsichtig = обережний
wachsend = зростаючий
wahnsinnig = божевільний
wenigstens = хоча б
zugleich = одночасно
übersetzen — übersetzt = перекладати — перекладено
die Aktion = акція
der Antrieb = двигун
die Anzahl = кількість
der Apfelstrudel = яблучний штрудель
der April = квітень
der Arbeiter = робітник
das Atelier = ательє
der Ausblick = вигляд
das Baujahr = рік будівництва
der Bayer = баварець
der Besitzer = власник
das Brandenburg = Бранденбург
das Brotbier = хлібне пиво
der Bäcker = пекар
das Chaos = хаос
der Chinese = китаєць
das Christkind = дитина Христова
die Demokratie = демократія
das Eiweiß = білок
die Emission = викиди
die Etage = поверх
der Fahrgast = пасажир
die Faszination = захоплення
die Flucht = втеча
der Fokus = фокус
der Fortschritt = прогрес
der Fotograf = фотограф
die Freizeit = вільний час
der Fund = знахідка
der Fußball = футбол
die Galerie = галерея
der Geburtstag = день народження
der Gegner = супротивник
die Gelegenheit = можливість
das Gewürz = спеція
der Hafen = порт
die Hast = поспіх
der Haushalt = господарство
die Haustür = вхідні двері
der Hund = пес
das Immunsystem = імунна система
das Island = Ісландія
der Jakobsweg = шлях Святого Якова
der Journalist = журналіст
jung = молодий
der Kaffee = кава
die Kasse = каса
die Kinderarbeit = дитяча праця
das Kino = кіно
der Klotz = колода
die Konkurrenz = конкуренція
der Konzern = корпорація
die Kälte = холод
die Königin = королева
das Label = марка
der Ladepunkt = точка зарядки
der Lebensraum = життєвий простір
das Leder = шкіра
die Linie = лінія
der Macher = творець
die Media = медіа
der Migrant = мігрант
