be — was; were — been = sein — war; waren — gewesen  
to = zu  
and = und  
of = von  
in = in  
that = dass; der; die; das  
it = es  
have — had — had = haben
they = sie  
you = du; Sie  
this = dies; dieser; dieses; diese  
we = wir  
for = für  
not = nicht  
but = aber  
do — did — done = tun — hat getan — tat  
on = auf; an  
like = mögen; wie  
with = mit  
so = so  
as = wie; als  
from = von  
at = bei; an  
one = eins; einer; eines  
there = dort  
can = können  
go — went — gone = gehen — ist gegangen — ging  
more = mehr  
all = alle  
people = die Leute; die Menschen  
what = was  
make — made — made = machen — hat gemacht — machte  
get — got — got/gotten = bekommen — hat bekommen — bekam; kriegen — hat gekriegt — kriegte  
just = nur; erst; einfach; bloß; halt; eben  
by = von; durch  
or = oder  
their = ihr; ihre  
these = diese  
about = über  
if = wenn; falls  
an = ein; eine  
he = er  
up = oben; hinauf  
when = wann  
know — knew — known = wissen — hat gewusst — wusste  
out = aus; heraus  
would = würde  
which = welcher; welche; welches  
see — saw — seen = sehen — hat gesehen — sah  
how = wie  
year = das Jahr — Jahre  
time = die Zeit — Zeiten  
will = werden  
our = unser; unsere  
who = wer  
because = weil  
look = schauen; aussehen  
use = benutzen  
take — took — taken = nehmen — hat genommen — nahm  
way = der Weg — Wege  
into = in  
then = dann  
could = könnte  
some = einige  
over = über  
other = andere  
where = wo  
right = rechts; richtig  
really = wirklich  
thing = das Ding — Dinge  
than = als  
come — came — come = kommen — ist gekommen — kam  
here = hier  
work = die Arbeit; arbeiten  
lot = viel  
want = wollen  
now = jetzt  
think — thought — thought = denken — hat gedacht — dachte  
start = beginnen  
also = auch  
your = dein; Ihr  
say — said — said = sagen — hat gesagt — sagte  
my = mein  
country — countries = das Land — Länder; die Nation — Nationen  
even = sogar  
first = erste  
most = die meisten  
very = sehr  
his = sein  
those = jene  
no = nein; kein  
call = anrufen  
new = neu  
much = viel  
big — bigger — biggest = groß — größer — am größten  
its = sein; ihr  
world = die Welt  
well = gut  
mean — meant — meant = meinen — hat gemeint — meinte  
back = zurück  
need — needed — needed = brauchen — hat gebraucht — brauchte  
only = nur  
many = viele  
around = um; herum  
two = zwei  
change = ändern  
state = der Staat — Staaten  
actually = eigentlich  
after = nach  
kind = die Art — Arten  
become — became — become = werden — ist geworden — wurde  
find — found — found = finden — hat gefunden — fand  
show — showed — shown = zeigen — hat gezeigt — zeigte  
still = noch  
down = unten  
something = etwas  
government = die Regierung  
good — better — best = gut — besser — am besten  
every = jeder  
help = helfen  
part = der Teil — Teile  
give — gave — given = geben — hat gegeben — gab  
different = unterschiedlich  
day = der Tag — Tage  
build — built — built = bauen — hat gebaut — baute  
happen = passieren  
same = gleich  
through = durch  
long = lang  
music = die Musik  
high = hoch  
why = warum  
try — tried — tried = versuchen — hat versucht — versuchte  
water = das Wasser  
end = das Ende  
before = vor  
place = der Ort — Orte  
company — companies = die Firma — Firmen; das Unternehmen — Unternehmen  
million = die Million — Millionen  
home = das Zuhause  
keep — kept — kept = behalten — hat behalten — behielt  
put — put — put = legen — hat gelegt — legte  
too = auch  
city — cities = die Stadt — Städte  
system = das System  
video = das Video  
little = klein  
any = irgendein  
she = sie  
off = aus  
between = zwischen  
might = könnte  
live = leben  
power = die Macht  
today = heute  
create = erschaffen  
let — let — let = lassen — hat gelassen — ließ  
few = wenige  
feel — felt — felt = fühlen — hat gefühlt — fühlte  
own = eigen  
move = bewegen  
life — lives = das Leben — Leben  
far = weit  
land = das Land — Länder  
money = das Geld  
vote = die Stimme; wählen  
another = ein anderer  
point = der Punkt — Punkte  
law = das Gesetz  
should = sollte  
pay — paid — paid = bezahlen — hat bezahlt — bezahlte  
while = während  
black = schwarz  
case = der Fall — Fälle  
tell — told — told = erzählen — hat erzählt — erzählte  
leave — left — left = verlassen — hat verlassen — verließ  
turn = drehen  
human = der Mensch — Menschen  
include = einschließen  
problem = das Problem  
area = die Fläche  
close = schließen  
China = China  
large = groß  
less = weniger  
name = der Name — Namen  
line = die Linie  
three = drei  
each = jeder  
next = nächster  
number = die Zahl  
story — stories = die Geschichte — Geschichten  
group = die Gruppe  
virus = das Virus  
thousand = tausend  
woman — women = die Frau — Frauen  
hard = hart  
since = seit  
war = der Krieg — Kriege  
talk = reden
force = die Kraft; zwingen  
lead — led — led = führen — hat geführt — führte  
control = die Kontrolle; kontrollieren  
grow — grew — grown = wachsen — ist gewachsen — wuchs  
low = niedrig  
movie = der Film — Filme  
set — set — set = setzen — hat gesetzt — setzte  
question = die Frage — Fragen  
support = die Unterstützung; unterstützen  
able = fähig  
small = klein  
last = letzter  
light = das Licht — Lichter; leicht  
study = die Studie — Studien; studieren  
ask = fragen  
always = immer  
bring — brought — brought = bringen — hat gebracht — brachte  
school = die Schule — Schulen  
design = das Design; entwerfen  
often = oft  
pretty = hübsch  
never = nie  
sort = die Art — Arten; sortieren  
film = der Film — Filme  
image = das Bild — Bilder  
away = weg  
real = echt  
begin — began — begun = beginnen — hat begonnen — begann  
almost = fast  
great = großartig  
across = über; quer  
both = beide  
play = spielen  
sound = der Klang; klingen  
again = wieder  
space = der Raum — Räume  
early = früh  
election = die Wahl — Wahlen  
man — men = der Mann — Männer  
plan = der Plan — Pläne  
second = zweite  
already = schon  
run — ran — run = laufen — ist gelaufen — lief  
building = das Gebäude — Gebäude  
decade = das Jahrzehnt — Jahrzehnte  
police = die Polizei  
public = öffentlich  
child — children = das Kind — Kinder  
hand = die Hand — Hände  
once = einmal  
plant = die Pflanze — Pflanzen; pflanzen  
industry = die Industrie  
level = das Niveau — Niveaus  
under = unter  
important = wichtig  
job = der Job — Jobs  
old = alt  
against = gegen  
us = uns  
fight — fought — fought = kämpfen — hat gekämpft — kämpfte  
watch = die Uhr — Uhren; beobachten  
energy = die Energie  
reason = der Grund — Gründe  
stop = anhalten  
datum — data = das Datum — Daten  
history = die Geschichte  
win — won — won = gewinnen — hat gewonnen — gewann  
person = die Person — Personen  
enough = genug  
air = die Luft  
hundred = hundert  
population = die Bevölkerung  
white = weiß  
everything = alles  
idea = die Idee — Ideen  
president = der Präsident — Präsidenten  
test = der Test — Tests; testen  
ever = jemals  
learn — learned/learnt — learned/learnt = lernen — hat gelernt — lernte  
pass = passieren  
during = während  
without = ohne  
face = das Gesicht — Gesichter  
family — families = die Familie — Familien  
process = der Prozess — Prozesse  
bit = das Bit — Bits; ein bisschen  
allow = erlauben  
later = später  
open = offen  
probably = wahrscheinlich  
worker = der Arbeiter — Arbeiter  
hold — held — held = halten — hat gehalten — hielt  
rate = die Rate — Raten  
until = bis  
basically = grundsätzlich  
vaccine = der Impfstoff — Impfstoffe  
house = das Haus — Häuser  
side = die Seite — Seiten  
party = die Party — Partys; die Partei — Parteien  
understand — understood — understood = verstehen — hat verstanden — verstand  
community — communities = die Gemeinschaft — Gemeinschaften  
month — months = der Monat — Monate  
whole = ganz  
oil = das Öl  
send — sent — sent = senden — hat gesendet — sandte  
though = obwohl  
model = das Modell — Modelle  
sign = das Zeichen — Zeichen  
Russia = Russland  
bad — worse — worst = schlecht — schlechter — am schlechtesten  
team = das Team — Teams  
type = der Typ — Typen  
hear — heard — heard = hören — hat gehört — hörte  
photo = das Foto — Fotos  
gas = das Gas  
top = die Spitze — Spitzen  
military = das Militär  
nearly = fast  
cause = die Ursache — Ursachen; verursachen  
seem = scheinen  
body — bodies = der Körper — Körper  
continue = fortsetzen  
example = das Beispiel — Beispiele  
instead = stattdessen  
maybe = vielleicht  
four = vier  
hour = die Stunde — Stunden  
protect = schützen  
lose — lost — lost = verlieren — hat verloren — verlor  
form = die Form — Formen  
policy = die Politik  
easy = einfach  
federal = föderal  
hit — hit — hit = schlagen — hat geschlagen — schlug  
thank = danken  
death = der Tod  
game = das Spiel — Spiele  
rule = die Regel — Regeln  
together = zusammen  
behind = hinter  
increase = erhöhen  
car = das Auto — Autos  
price = der Preis — Preise  
risk = das Risiko — Risiken  
whether = ob  
cost = die Kosten  
spend — spent — spent = ausgeben — hat ausgegeben — gab aus  
write — wrote — written = schreiben — hat geschrieben — schrieb  
least = am wenigsten  
possible = möglich  
project = das Projekt — Projekte  
Ukraine = die Ukraine  
push = schieben  
train = der Zug — Züge; trainieren  
fast = schnell  
future = die Zukunft  
half = die Hälfte — Hälften  
die — died — died = sterben — ist gestorben — starb  
full = voll  
record = die Aufzeichnung — Aufzeichnungen  
break — broke — broken = brechen — hat gebrochen — brach  
business = das Geschäft — Geschäfte  
clear = klar  
figure = die Figur — Figuren  
base = die Basis — Basen  
fall — fell — fallen = fallen — ist gefallen — fiel  
rise — rose — risen = steigen — ist gestiegen — stieg  
cut — cut — cut = schneiden — hat geschnitten — schnitt  
drive — drove — driven = fahren; fährt — ist gefahren — fuhr  
fact = die Tatsache — Tatsachen  
food = das Essen  
kill = töten  
major = groß  
outside = außen  
add = hinzufügen  
ground = der Boden — Böden  
abortion = die Abtreibung — Abtreibungen  
attack = der Angriff — Angriffe; angreifen  
report = der Bericht — Berichte; berichten  
result = das Ergebnis — Ergebnisse  
sell — sold — sold = verkaufen — hat verkauft — verkaufte  
market = der Markt — Märkte  
huge = riesig  
student = der Student — Studenten  
likely = wahrscheinlich  
term = der Begriff — Begriffe  
along = entlang  
check = überprüfen  
color = die Farbe — Farben  
her = ihr  
require = benötigen  
technology = die Technologie  
everyone = jeder  
political = politisch  
care = die Pflege; sich kümmern  
century — centuries = das Jahrhundert — Jahrhunderte  
shoot — shot — shot = schießen — hat geschossen — schoss  
cover = die Abdeckung — Abdeckungen; bedecken  
develop = entwickeln  
buy — bought — bought = kaufen — hat gekauft — kaufte  
decide = entscheiden  
map = die Karte — Karten  
within = innerhalb  
center = das Zentrum — Zentren  
picture = das Bild — Bilder  
effect = die Wirkung — Wirkungen  
reach = erreichen  
believe = glauben  
produce = produzieren  
someone = jemand  
animal = das Tier — Tiere  
issue = das Problem — Probleme  
Russian = russisch  
amount = die Menge — Mengen  
health = die Gesundheit  
inside = innen  
research = die Forschung; forschen  
may = dürfen  
week = die Woche — Wochen  
climate = das Klima  
guy = der Typ — Typen  
sit — sat — sat = sitzen — hat gesessen — saß  
America = Amerika  
head = der Kopf — Köpfe  
ship = das Schiff — Schiffe  
spread — spread — spread = verbreiten — hat verbreitet — verbreitete  
access = der Zugang  
especially = besonders  
movement = die Bewegung — Bewegungen  
past = die Vergangenheit  
sure = sicher  
anything = irgendetwas  
matter = die Sache — Sachen  
planet = der Planet — Planeten  
States = die Staaten  
order = die Ordnung; bestellen  
answer = die Antwort — Antworten; antworten  
consider = betrachten  
exactly = genau  
five = fünf  
pandemic = die Pandemie — Pandemien  
researcher = der Forscher — Forscher  
fire = das Feuer  
program = das Programm — Programme  
sometimes = manchmal  
billion = die Milliarde — Milliarden  
common = gemeinsam  
dollar = der Dollar — Dollar  
economy = die Wirtschaft  
fuel = der Treibstoff  
travel = reisen  
course = der Kurs — Kurse  
deal = das Geschäft — Geschäfte  
scene = die Szene — Szenen  
free = frei  
entire = ganz  
love = die Liebe; lieben  
step = der Schritt — Schritte  
provide = bereitstellen  
stay = bleiben  
moment = der Moment — Momente  
soon = bald  
word = das Wort — Wörter  
focus = der Fokus  
middle = die Mitte  
scientist = der Wissenschaftler — Wissenschaftler  
stuff = das Zeug  
yet = noch  
artist = der Künstler — Künstler  
mostly = meistens  
natural = natürlich  
follow = folgen  
leader = der Führer — Führer  
quickly = schnell  
solar = solar  
World = die Welt  
act = handeln  
hope = die Hoffnung; hoffen  
protest = der Protest — Proteste; protestieren  
region = die Region — Regionen  
speed = die Geschwindigkeit  
voter = der Wähler — Wähler  
wave = die Welle — Wellen  
single = einzeln  
deep = tief  
experience = die Erfahrung — Erfahrungen  
local = lokal  
court = das Gericht — Gerichte  
target = das Ziel — Ziele  
else = sonst  
member = das Mitglied — Mitglieder  
ban = das Verbot — Verbote; verbieten  
eventually = schließlich  
impact = die Auswirkung — Auswirkungen  
official = offiziell  
player = der Spieler — Spieler  
release = die Freigabe — Freigaben; freigeben  
room = der Raum — Räume  
scale = die Skala — Skalen  
camera = die Kamera — Kameras  
chart = die Tabelle — Tabellen  
decision = die Entscheidung — Entscheidungen  
piece = das Stück — Stücke  
disease = die Krankheit — Krankheiten  
capture = erfassen  
farmer = der Bauer — Bauern  
fly — flew — flown = fliegen — ist geflogen — flog  
kid = das Kind — Kinder  
several = mehrere  
office = das Büro — Büros  
shape = die Form — Formen  
emission = die Emission — Emissionen  
share = teilen  
short = kurz  
source = die Quelle — Quellen  
track = die Spur — Spuren  
young = jung  
bill = die Rechnung — Rechnungen  
song = das Lied — Lieder  
tree = der Baum — Bäume  
challenge = die Herausforderung — Herausforderungen  
either = entweder  
exist = existieren  
pull = ziehen  
stand — stood — stood = stehen — hat gestanden — stand  
usually = normalerweise  
sense = der Sinn — Sinne  
tool = das Werkzeug — Werkzeuge  
wait = warten  
farm = der Bauernhof — Bauernhöfe  
production = die Produktion  
similar = ähnlich  
gun = die Waffe — Waffen  
key = der Schlüssel — Schlüssel  
late = spät  
raise = erhöhen  
service = der Dienst — Dienste  
cloud = die Wolke — Wolken  
expert = der Experte — Experten  
frame = der Rahmen — Rahmen  
front = die Vorderseite  
global = global  
machine = die Maschine — Maschinen  
door = die Tür — Türen  
drop = der Tropfen — Tropfen; fallen lassen  
red = rot  
seat = der Sitz — Sitze  
computer = der Computer  
credit = der Kredit — Kredite  
eye = das Auge — Augen  
post = der Beitrag — Beiträge  
safe = sicher  
save = retten  
store = der Laden — Läden  
benefit = der Vorteil — Vorteile  
class = die Klasse — Klassen  
cool = cool  
goal = das Ziel — Ziele  
heat = die Hitze  
meet — met — met = treffen — hat getroffen — traf  
position = die Position — Positionen  
race = das Rennen — Rennen  
certain = sicher  
compare = vergleichen  
economic = wirtschaftlich  
income = das Einkommen  
national = national  
percent = das Prozent  
star = der Stern — Sterne  
internet = das Internet  
itself = selbst  
nothing = nichts  
reduce = reduzieren  
ten = zehn  
South = der Süden  
majority = die Mehrheit  
massive = massiv  
remember = sich erinnern  
sea = das Meer — Meere  
shot = der Schuss — Schüsse  
slow = langsam  
speak — spoke — spoken = sprechen — hat gesprochen — sprach  
strong = stark  
Earth = die Erde  
feature = das Merkmal — Merkmale  
forest = der Wald — Wälder  
solution = die Lösung — Lösungen  
street = die Straße — Straßen  
supply = die Versorgung  
account = das Konto — Konten  
ago = vor  
average = durchschnittlich  
dog = der Hund — Hunde  
information = die Information — Informationen  
language = die Sprache — Sprachen  
measure = die Maßnahme — Maßnahmen  
night = die Nacht — Nächte  
simple = einfach  
social = sozial  
North = der Norden  
difference = der Unterschied — Unterschiede  
finally = endlich  
agree = zustimmen  
nation = die Nation — Nationen  
Congress = der Kongress  
demand = die Nachfrage; verlangen  
district = der Bezirk — Bezirke  
road = die Straße — Straßen  
sick = krank  
such = solch  
tax = die Steuer — Steuern  
true = wahr  
evidence = der Beweis — Beweise  
offer = das Angebot — Angebote; anbieten  
per = pro  
completely = vollständig  
event = das Ereignis — Ereignisse  
sport = der Sport  
themselves = sich selbst  
union = die Union — Unionen  
wear — wore — worn = tragen — hat getragen — trug  
yes = ja  
choice = die Wahl — Wahlen  
claim = der Anspruch — Ansprüche; behaupten  
list = die Liste — Listen  
ocean = der Ozean — Ozeane  
pick = auswählen  
product = das Produkt — Produkte  
remain = bleiben  
Europe = Europa  
book = das Buch — Bücher  
catch — caught — caught = fangen — hat gefangen — fing  
eat — ate — eaten = essen — hat gegessen — aß  
flu = die Grippe  
foot — feet = der Fuß — Füße  
housing = die Wohnung — Wohnungen  
mile = die Meile — Meilen  
powerful = mächtig  
represent = vertreten  
ton = die Tonne — Tonnen  
among = unter  
British = britisch  
crisis = die Krise — Krisen  
limit = die Grenze — Grenzen  
main = hauptsächlich  
read — read — read = lesen — hat gelesen — las  
size = die Größe — Größen  
approach = der Ansatz — Ansätze  
explain = erklären  
interest = das Interesse — Interessen  
rich = reich  
accord = das Abkommen — Abkommen  
burn — burned/burnt — burned/burnt = brennen — hat gebrannt — brannte  
green = grün  
material = das Material — Materialien  
pressure = der Druck  
quite = ziemlich  
recognize = erkennen  
town = die Stadt — Städte  
Germany = Deutschland  
anyone = irgendjemand  
art = die Kunst  
border = die Grenze — Grenzen  
civil = zivil  
imagine = sich vorstellen  
near = nahe  
six = sechs  
weapon = die Waffe — Waffen  
California = Kalifornien  
carry = tragen  
choose — chose — chosen = wählen — hat gewählt — wählte  
expect = erwarten  
flight = der Flug — Flüge  
resource = die Ressource — Ressourcen  
return = zurückkehren  
charge = die Ladung — Ladungen; aufladen  
prevent = verhindern  
ad = die Werbung  
field = das Feld — Felder  
individual = individuell  
link = der Link — Links  
specific = spezifisch  
walk = gehen  
ball = der Ball — Bälle  
couple = das Paar — Paare  
democracy = die Demokratie  
development = die Entwicklung  
generate = erzeugen  
native = einheimisch  
site = die Seite — Seiten  
third = dritte  
brain = das Gehirn — Gehirne  
carbon = der Kohlenstoff  
cell = die Zelle — Zellen  
coronavirus = das Coronavirus  
dangerous = gefährlich  
inflation = die Inflation  
influence = der Einfluss — Einflüsse  
screen = der Bildschirm — Bildschirme  
TV = der Fernseher — Fernseher
window = das Fenster — Fenster  
wrong = falsch  
bunch = der Haufen — Haufen  
environment = die Umwelt  
mail = die Post  
mask = die Maske — Masken  
notice = die Notiz — Notizen; bemerken  
officer = der Offizier — Offiziere  
perfect = perfekt  
shift = die Schicht — Schichten; verschieben  
candidate = der Kandidat — Kandidaten  
fund = der Fonds — Fonds; finanzieren  
news = die Nachrichten  
phone = das Telefon — Telefone  
receive = erhalten  
rest = die Ruhe; sich ausruhen  
surface = die Oberfläche — Oberflächen  
um = ähm  
chance = die Chance — Chancen  
difficult = schwierig  
flow = der Fluss — Flüsse; fließen  
miss = verpassen  
view = die Ansicht — Ansichten  
drug = die Droge — Drogen  
expensive = teuer  
particular = besonders  
replace = ersetzen  
block = der Block — Blöcke; blockieren  
fat = das Fett; dick  
wall = die Wand — Wände  
Mao = Mao  
degree = der Grad — Grade  
enter = betreten  
motion = die Bewegung — Bewegungen  
neighborhood = die Nachbarschaft  
period = die Periode — Perioden  
river = der Fluss — Flüsse  
troop = die Truppe — Truppen  
wind = der Wind — Winde  
age = das Alter  
bear — bore — borne = tragen — hat getragen — trug  
condition = die Bedingung — Bedingungen  
fossil = das Fossil — Fossilien  
highway = die Autobahn — Autobahnen  
layer = die Schicht — Schichten  
minute = die Minute — Minuten  
opportunity = die Gelegenheit — Gelegenheiten  
serve = dienen  
weather = das Wetter  
background = der Hintergrund — Hintergründe  
beginning = der Anfang — Anfänge  
former = ehemalig  
legal = legal  
mass = die Masse — Massen  
medium = das Medium — Medien  
spot = der Fleck — Flecken  
establish = etablieren  
fish = der Fisch — Fische  
friend = der Freund — Freunde  
online = online  
paper = das Papier — Papiere  
realize = realisieren  
wage = der Lohn — Löhne  
blue = blau  
Chinese = chinesisch  
cold = kalt  
draw — drew — drawn = zeichnen — hat gezeichnet — zeichnete  
final = final  
location = der Ort — Orte  
throughout = durch  
blood = das Blut  
driver = der Fahrer — Fahrer  
electricity = der Strom  
fill = füllen  
option = die Option — Optionen  
outbreak = der Ausbruch — Ausbrüche  
practice = die Praxis; üben  
rock = der Felsen — Felsen  
standard = der Standard — Standards  
storm = der Sturm — Stürme  
threat = die Bedrohung — Bedrohungen  
cheap = billig  
pattern = das Muster — Muster  
plane = das Flugzeug — Flugzeuge  
popular = beliebt  
private = privat  
teach — taught — taught = lehren — hat gelehrt — lehrte  
unique = einzigartig  
agency = die Agentur — Agenturen  
college = das College — Colleges  
everywhere = überall  
launch = starten  
nuclear = nuklear  
range = die Reichweite — Reichweiten  
remove = entfernen  
resident = der Bewohner — Bewohner  
response = die Antwort — Antworten  
structure = die Struktur — Strukturen  
village = das Dorf — Dörfer  
weird = seltsam  
ability = die Fähigkeit — Fähigkeiten  
culture = die Kultur — Kulturen  
foreign = ausländisch  
match = das Spiel — Spiele; passen  
museum = das Museum — Museen  
passenger = der Passagier — Passagiere  
situation = die Situation — Situationen  
soil = der Boden — Böden  
Republicans = die Republikaner  
alone = allein  
basic = grundlegend  
current = aktuell  
ice = das Eis  
island = die Insel — Inseln  
politician = der Politiker — Politiker  
taxis = die Taxis  
temperature = die Temperatur — Temperaturen  
truck = der Lastwagen — Lastwagen  
India = Indien  
bird = der Vogel — Vögel  
gain = gewinnen  
infrastructure = die Infrastruktur  
meter = der Meter — Meter  
roughly = grob  
stick — stuck — stuck = kleben — hat geklebt — klebte  
style = der Stil — Stile  
warm = warm  
Texas = Texas  
clean = sauber  
debt = die Schuld — Schulden  
factor = der Faktor — Faktoren  
literally = buchstäblich  
must = müssen  
non = nicht  
object = das Objekt — Objekte  
original = original  
oxygen = der Sauerstoff  
recent = kürzlich  
safety = die Sicherheit  
sample = die Probe — Proben  
specie = die Art — Arten  
teacher = der Lehrer — Lehrer  
waste = der Abfall  
Afghanistan = Afghanistan  
Canada = Kanada  
above = oben  
action = die Aktion — Aktionen  
ally = der Verbündete — Verbündete  
ballot = die Wahl — Wahlen  
box = die Kiste — Kisten  
chemical = chemisch  
chip = der Chip — Chips  
concern = die Sorge — Sorgen  
conflict = der Konflikt — Konflikte  
definitely = definitiv  
double = doppelt  
episode = die Episode — Episoden  
label = das Etikett — Etiketten  
promise = das Versprechen — Versprechen  
relationship = die Beziehung — Beziehungen  
role = die Rolle — Rollen  
series = die Serie — Serien  
sky = der Himmel  
stage = die Bühne — Bühnen  
super = super  
Portuguese = portugiesisch  
Taliban = die Taliban  
campaign = die Kampagne — Kampagnen  
destroy = zerstören  
direction = die Richtung — Richtungen  
extremely = extrem  
generation = die Generation — Generationen  
hospital = das Krankenhaus — Krankenhäuser  
identify = identifizieren  
indigenous = einheimisch  
mountain = der Berg — Berge  
organization = die Organisation — Organisationen  
protection = der Schutz  
pump = die Pumpe — Pumpen  
somebody = jemand  
strategy = die Strategie — Strategien  
strike — struck — struck = streiken — hat gestreikt — streikte  
suppose = annehmen  
trial = der Prozess — Prozesse  
weight = das Gewicht  
worth = der Wert  
capital = das Kapital  
dark = dunkel  
judge = der Richter — Richter  
message = die Nachricht — Nachrichten  
pool = der Pool — Pools  
straight = gerade  
violence = die Gewalt  
affect = beeinflussen  
appear = erscheinen  
chair = der Stuhl — Stühle  
count = zählen  
floor = der Boden — Böden  
hot = heiß  
plus = plus  
security = die Sicherheit  
struggle = der Kampf — Kämpfe  
ultimately = letztendlich  
voting = die Abstimmung — Abstimmungen  
wood = das Holz  
zero = null  
attention = die Aufmerksamkeit  
baby = das Baby — Babys  
board = das Brett — Bretter  
directly = direkt  
expand = erweitern  
glass = das Glas — Gläser  
kick = der Tritt — Tritte; treten  
letter = der Brief — Briefe  
paint = die Farbe — Farben; malen  
poll = die Umfrage — Umfragen  
survey = die Umfrage — Umfragen  
zone = die Zone — Zonen  
West = der Westen  
damage = der Schaden — Schäden  
digital = digital  
funding = die Finanzierung  
giant = der Riese — Riesen  
guess = raten  
involve = einbeziehen  
join = beitreten  
potential = das Potenzial  
ready = bereit  
Republican = der Republikaner — Republikaner  
Soviet = sowjetisch  
special = speziell  
studio = das Studio — Studios  
total = total  
typically = typisch  
value = der Wert — Werte  
beautiful = schön  
character = der Charakter — Charaktere  
depend = abhängen  
egg = das Ei — Eier  
essentially = im Wesentlichen  
everybody = jeder  
gap = die Lücke — Lücken  
heavy = schwer  
poor = arm  
sun = die Sonne  
version = die Version — Versionen  
Christmas = Weihnachten  
administration = die Verwaltung  
anti = anti  
apart = auseinander  
budget = das Budget — Budgets  
concrete = konkret  
dead = tot  
distance = die Distanz — Distanzen  
feed — fed — fed = füttern — hat gefüttert — fütterte  
financial = finanziell  
fit — fit — fit = passen — hat gepasst — passte  
forward = vorwärts  
introduce = einführen  
onto = auf  
painting = das Gemälde — Gemälde  
profit = der Profit — Profite  
rain = der Regen  
shut — shut — shut = schließen — hat geschlossen — schloss  
tiny = winzig  
Democrats = die Demokraten  
athlete = der Athlet — Athleten  
bomb = die Bombe — Bomben  
complex = komplex  
detail = das Detail — Details  
due = fällig  
education = die Bildung  
park = der Park — Parks  
rely = sich verlassen  
separate = trennen  
towards = in Richtung  
voice = die Stimme — Stimmen  
whatever = was auch immer  
announce = ankündigen  
civilian = der Zivilist — Zivilisten  
dozen = das Dutzend — Dutzende  
effort = die Anstrengung — Anstrengungen  
entirely = völlig  
growth = das Wachstum  
labor = die Arbeit  
left = links  
plastic = das Plastik  
present = das Geschenk — Geschenke; präsentieren  
south = der Süden  
suggest = vorschlagen  
surround = umgeben  
tank = der Tank — Tanks  
wide = breit  
Disney = Disney  
Union = die Union  
atmosphere = die Atmosphäre  
below = unten  
complete = vollständig  
consumer = der Verbraucher — Verbraucher  
describe = beschreiben  
email = die E-Mail — E-Mails  
facility = die Einrichtung — Einrichtungen  
hey = hey  
interesting = interessant  
international = international  
manage = verwalten  
mind = der Verstand  
multiple = mehrfach  
stock = der Vorrat — Vorräte  
tip = der Tipp — Tipps  
treat = behandeln  
activist = der Aktivist — Aktivisten  
attempt = der Versuch — Versuche  
beyond = jenseits  
bottom = der Boden — Böden  
complicated = kompliziert  
construction = der Bau  
desert = die Wüste — Wüsten  
electric = elektrisch  
era = die Ära — Ären  
famous = berühmt  
general = allgemein  
listen = zuhören  
mine = die Mine — Minen  
particularly = besonders  
restaurant = das Restaurant — Restaurants  
search = die Suche; suchen  
visit = der Besuch — Besuche; besuchen  
bank = die Bank — Banken  
contact = der Kontakt — Kontakte  
cross = das Kreuz — Kreuze; überqueren  
effective = effektiv  
factory = die Fabrik — Fabriken  
fingerprint = der Fingerabdruck — Fingerabdrücke  
jump = der Sprung — Sprünge; springen  
kilometer = der Kilometer — Kilometer  
milk = die Milch  
quality = die Qualität  
section = der Abschnitt — Abschnitte  
skin = die Haut  
summer = der Sommer  
viral = viral  
website = die Website — Websites  
Court = das Gericht — Gerichte  
Korea = Korea  
bar = die Bar — Bars  
cow = die Kuh — Kühe  
crop = die Ernte — Ernten  
doctor = der Arzt — Ärzte  
fail = scheitern  
fear = die Angst  
invest = investieren  
journey = die Reise — Reisen  
loss = der Verlust — Verluste  
obviously = offensichtlich  
purpose = der Zweck — Zwecke  
science = die Wissenschaft  
score = die Punktzahl — Punktzahlen  
station = die Station — Stationen  
text = der Text — Texte  
Ukrainian = ukrainisch  
vehicle = das Fahrzeug — Fahrzeuge  
actual = tatsächlich  
angle = der Winkel — Winkel  
army = die Armee — Armeen  
contain = enthalten  
extreme = extrem  
getting = bekommen  
height = die Höhe  
host = der Gastgeber — Gastgeber  
increasingly = zunehmend  
loan = das Darlehen — Darlehen  
photography = die Fotografie  
producer = der Produzent — Produzenten  
prove = beweisen  
rather = eher  
specifically = speziell  
steel = der Stahl  
throw — threw — thrown = werfen — hat geworfen — warf  
address = die Adresse — Adressen  
amazing = erstaunlich  
applause = der Applaus  
arrest = die Verhaftung — Verhaftungen  
available = verfügbar  
brand = die Marke — Marken  
collect = sammeln  
connect = verbinden  
designer = der Designer — Designer  
estimate = die Schätzung — Schätzungen  
hotel = das Hotel — Hotels  
interview = das Interview — Interviews  
path = der Pfad — Pfade  
recently = kürzlich  
relate = beziehen  
rural = ländlich  
season = die Jahreszeit — Jahreszeiten  
theater = das Theater — Theater  
wonder = das Wunder — Wunder  
chain = die Kette — Ketten  
document = das Dokument — Dokumente  
grid = das Gitter — Gitter  
impossible = unmöglich  
maintain = aufrechterhalten  
protester = der Demonstrant — Demonstranten  
sale = der Verkauf — Verkäufe  
tend = tendieren  
training = das Training  
anymore = nicht mehr  
anywhere = irgendwo  
approve = genehmigen  
audience = das Publikum  
elect = wählen  
element = das Element — Elemente  
forever = für immer  
lie — lay — lain = liegen — hat gelegen — lag  
morning = der Morgen  
north = der Norden  
nurse = die Krankenschwester — Krankenschwestern  
owner = der Besitzer — Besitzer  
significant = bedeutend  
society = die Gesellschaft  
visual = visuell  
Supreme = der Oberste  
Taiwan = Taiwan  
currently = derzeit  
favorite = der Favorit — Favoriten  
fix = reparieren  
inspire = inspirieren  
lay — laid — laid = legen — hat gelegt — legte  
mix = mischen  
necessarily = notwendigerweise  
parent = der Elternteil — Elternteile  
potentially = potenziell  
property = das Eigentum  
ride — rode — ridden = reiten — ist geritten — ritt  
serious = ernst  
solve = lösen  
sponsor = der Sponsor — Sponsoren  
totally = völlig  
united = vereint  
winter = der Winter  
Brazil = Brasilien  
British = britisch  
circle = der Kreis — Kreise  
conservative = konservativ  
cultural = kulturell  
dig — dug — dug = graben — hat gegraben — grub  
environmental = umweltfreundlich  
fair = fair  
generally = allgemein  
lack = der Mangel  
normal = normal  
predict = vorhersagen  
respond = antworten  
soldier = der Soldat — Soldaten  
somewhere = irgendwo  
square = das Quadrat — Quadrate  
switch = der Schalter — Schalter; wechseln  
trade = der Handel  
code = der Code — Codes  
collapse = der Zusammenbruch — Zusammenbrüche  
combine = kombinieren  
crime = das Verbrechen — Verbrechen  
cycle = der Zyklus — Zyklen  
deadly = tödlich  
department = die Abteilung — Abteilungen  
direct = direkt  
fake = gefälscht  
fluoride = das Fluorid  
mark = die Marke — Marken  
medical = medizinisch  
regime = das Regime — Regime  
seven = sieben  
simply = einfach  
suddenly = plötzlich  
survive = überleben  
traditional = traditionell  
East = der Osten  
London = London  
university = die Universität — Universitäten  
actor = der Schauspieler — Schauspieler  
agreement = die Vereinbarung — Vereinbarungen  
apply = bewerben  
balance = das Gleichgewicht  
container = der Behälter — Behälter  
content = der Inhalt — Inhalte  
description = die Beschreibung — Beschreibungen  
heart = das Herz — Herzen  
immediately = sofort  
investment = die Investition — Investitionen  
meat = das Fleisch  
method = die Methode — Methoden  
network = das Netzwerk — Netzwerke  
nice = nett  
organize = organisieren  
please = bitte  
press = die Presse; drücken  
professor = der Professor — Professoren  
rail = die Schiene — Schienen  
technique = die Technik — Techniken
tie = die Krawatte — Krawatten; binden  
whose = dessen  
Israel = Israel  
March = der März  
app = die App — Apps  
brown = braun  
citizen = der Bürger — Bürger  
clearly = klar  
extra = extra  
file = die Datei — Dateien  
German = deutsch  
historic = historisch  
investigation = die Untersuchung — Untersuchungen  
Iran = der Iran  
justice = die Gerechtigkeit  
largely = weitgehend  
modern = modern  
noise = der Lärm  
overall = insgesamt  
patient = der Patient — Patienten  
phase = die Phase — Phasen  
pop = der Pop  
professional = professionell  
reality = die Realität  
signal = das Signal — Signale  
slightly = leicht  
testing = das Testen  
trail = die Spur — Spuren  
wealthy = reich  
worry = die Sorge — Sorgen; sich sorgen  
arrive = ankommen  
article = der Artikel — Artikel  
blow — blew — blown = blasen — hat geblasen — blies  
certainly = sicherlich  
date = das Datum — Daten  
debate = die Debatte — Debatten  
determine = bestimmen  
dream = der Traum — Träume; träumen  
employee = der Angestellte — Angestellte  
equipment = die Ausrüstung  
healthy = gesund  
loop = die Schleife — Schleifen  
mining = der Bergbau  
none = keiner  
panel = das Panel — Panels  
pose = die Pose — Posen; posieren  
seek — sought — sought = suchen — hat gesucht — suchte  
states = die Staaten  
wealth = der Reichtum  
western = westlich  
Pakistan = Pakistan  
absolutely = absolut  
beat — beat — beaten = schlagen — hat geschlagen — schlug  
boy = der Junge — Jungen  
category = die Kategorie — Kategorien  
commercial = kommerziell  
daily = täglich  
declare = erklären  
deeply = tief  
emerge = auftauchen  
European = europäisch  
experiment = das Experiment — Experimente  
freedom = die Freiheit  
personal = persönlich  
perspective = die Perspektive — Perspektiven  
pipeline = die Pipeline — Pipelines  
reserve = die Reserve — Reserven  
successful = erfolgreich  
trace = die Spur — Spuren  
trust = das Vertrauen  
west = der Westen  
album = das Album — Alben  
argue = argumentieren  
avoid = vermeiden  
boom = der Boom  
cement = der Zement  
democratic = demokratisch  
despite = trotz  
familiar = vertraut  
flood = die Flut — Fluten  
gear = die Ausrüstung  
hide — hid — hidden = verstecken — hat versteckt — versteckte  
himself = sich selbst  
improve = verbessern  
incredible = unglaublich  
marijuana = das Marihuana  
minimum = das Minimum  
note = die Notiz — Notizen  
operate = operieren  
platform = die Plattform — Plattformen  
politic = politisch  
portrait = das Porträt — Porträts  
publish = veröffentlichen  
reform = die Reform — Reformen  
relatively = relativ  
renewable = erneuerbar  
severe = schwer  
sleep — slept — slept = schlafen — hat geschlafen — schlief  
tear — tore — torn = reißen — hat gerissen — riss  
trend = der Trend — Trends  
trip = die Reise — Reisen  
unemployment = die Arbeitslosigkeit  
vast = riesig  
vision = die Vision — Visionen  
yourself = dich selbst  
cup = die Tasse — Tassen  
acre = der Morgen — Morgen  
adult = der Erwachsene — Erwachsene  
animation = die Animation — Animationen  
bat = die Fledermaus — Fledermäuse  
central = zentral  
divide = teilen  
eight = acht  
hire = einstellen  
hole = das Loch — Löcher  
incredibly = unglaublich  
infect = infizieren  
nearby = in der Nähe  
net = das Netz — Netze  
percentage = der Prozentsatz — Prozentsätze  
print = drucken  
propose = vorschlagen  
protein = das Protein — Proteine  
review = die Bewertung — Bewertungen  
success = der Erfolg  
truth = die Wahrheit  
band = die Band — Bands  
basis = die Basis — Basen  
cluster = der Cluster — Cluster  
conversation = das Gespräch — Gespräche  
crash = der Crash — Crashes  
fan = der Fan — Fans  
farming = die Landwirtschaft  
folk = die Leute  
fully = vollständig  
fun = der Spaß  
handle = der Griff — Griffe; handhaben  
happy = glücklich  
jet = der Jet — Jets  
leadership = die Führung  
learning = das Lernen  
lens = die Linse — Linsen  
lock = das Schloss — Schlösser; sperren  
nature = die Natur  
positive = positiv  
prepare = vorbereiten  
preserve = bewahren  
racial = rassisch  
skater = der Skater — Skater  
tech = die Technik  
territory = das Territorium — Territorien  
transition = der Übergang — Übergänge  
January = der Januar  
October = der Oktober  
Washington = Washington  
contract = der Vertrag — Verträge  
discover = entdecken  
expose = aussetzen  
favor = der Gefallen — Gefallen  
finish = beenden  
gather = sammeln  
immune = immun  
Indian = indisch  
intelligence = die Intelligenz  
leg = das Bein — Beine  
mother = die Mutter — Mütter  
parking = das Parken  
presidential = präsidial  
primarily = primär  
rubber = der Gummi  
shop = der Laden — Läden  
spike = der Spike — Spikes  
tall = groß  
threaten = bedrohen  
trouble = die Schwierigkeit — Schwierigkeiten  
May = der Mai  
Mexico = Mexiko  
airline = die Fluggesellschaft — Fluggesellschaften  
arm = der Arm — Arme  
artificial = künstlich  
battery = die Batterie — Batterien  
click = der Klick — Klicks  
column = die Spalte — Spalten  
Congress = der Kongress  
consequence = die Konsequenz — Konsequenzen  
crew = die Crew — Crews  
deny = leugnen  
director = der Direktor — Direktoren  
dry = trocken  
easily = leicht  
enemy = der Feind — Feinde  
industrial = industriell  
journalist = der Journalist — Journalisten  
myself = mich selbst  
nobody = niemand  
operation = die Operation — Operationen  
possibility = die Möglichkeit — Möglichkeiten  
representative = der Vertreter — Vertreter  
request = die Anfrage — Anfragen  
reverse = umkehren  
sink — sank — sunk = sinken — ist gesunken — sank  
suffer = leiden  
tennis = das Tennis  
trailer = der Trailer — Trailer  
transform = transformieren  
user = der Benutzer — Benutzer  
soul = die Seele — Seelen  
activity = die Aktivität — Aktivitäten  
conduct = das Verhalten; durchführen  
corner = die Ecke — Ecken  
curve = die Kurve — Kurven  
decline = der Rückgang — Rückgänge  
deliver = liefern  
drag = ziehen  
enforce = durchsetzen  
father = der Vater — Väter  
football = der Fußball  
highly = hoch  
interact = interagieren  
legacy = das Erbe  
rare = selten  
slowly = langsam  
snow = der Schnee  
telescope = das Teleskop — Teleskope  
theory = die Theorie — Theorien  
universal = universell  
unlike = anders als  
wild = wild  
February = der Februar  
Indian = indisch  
Japan = Japan  
ahead = voraus  
battle = die Schlacht — Schlachten  
broad = breit  
canal = der Kanal — Kanäle  
cattle = das Vieh  
clip = der Clip — Clips  
coast = die Küste — Küsten  
committee = das Komitee — Komitees  
electoral = Wahl-  
empty = leer  
flee — fled — fled = fliehen — ist geflohen — floh  
god = der Gott — Götter  
grade = die Note — Noten  
grant = der Zuschuss — Zuschüsse  
guard = der Wächter — Wächter  
hang — hung — hung = hängen — hat gehangen — hing  
infection = die Infektion — Infektionen  
interested = interessiert  
invasion = die Invasion — Invasionen  
living = lebend  
metal = das Metall — Metalle  
obvious = offensichtlich  
occur = auftreten  
prompt = die Aufforderung — Aufforderungen  
rainforest = der Regenwald — Regenwälder  
responsible = verantwortlich  
revolution = die Revolution — Revolutionen  
round = rund  
route = die Route — Routen  
settlement = die Siedlung — Siedlungen  
stream = der Strom — Ströme  
suit = der Anzug — Anzüge  
symptom = das Symptom — Symptome  
touch = berühren  
treatment = die Behandlung — Behandlungen  
various = verschieden  
April = der April  
affordable = erschwinglich  
beach = der Strand — Strände  
bond = die Bindung — Bindungen  
boost = der Schub — Schübe  
card = die Karte — Karten  
coal = die Kohle  
combination = die Kombination — Kombinationen  
contribute = beitragen  
corruption = die Korruption  
crazy = verrückt  
data = die Daten  
defend = verteidigen  
effectively = effektiv  
encourage = ermutigen  
engineer = der Ingenieur — Ingenieure  
except = außer  
fine = das Bußgeld — Bußgelder  
footage = das Filmmaterial  
Hawaiian = hawaiianisch  
illegal = illegal  
importantly = wichtig  
independence = die Unabhängigkeit  
landscape = die Landschaft — Landschaften  
loon = der Taucher — Taucher  
marketing = das Marketing  
moose = der Elch — Elche  
neighbor = der Nachbar — Nachbarn  
oppose = ablehnen  
peak = der Gipfel — Gipfel  
pitch = die Tonhöhe  
poverty = die Armut  
repeat = wiederholen  
self = das Selbst  
spirit = der Geist — Geister  
tension = die Spannung — Spannungen  
trick = der Trick — Tricks  
urban = städtisch  
volume = das Volumen — Volumen  
apartment = die Wohnung — Wohnungen  
barrier = die Barriere — Barrieren  
bid = das Gebot — Gebote  
celebrate = feiern  
cheese = der Käse  
communist = kommunistisch  
define = definieren  
edge = die Kante — Kanten  
explosion = die Explosion — Explosionen  
exposure = die Belichtung  
function = die Funktion — Funktionen  
gold = das Gold  
harm = der Schaden — Schäden  
invade = eindringen  
king = der König — Könige  
knowledge = das Wissen  
legislation = die Gesetzgebung  
mention = erwähnen  
mid = Mitte  
mirror = der Spiegel — Spiegel  
page = die Seite — Seiten  
photograph = das Foto — Fotos  
pro = der Profi — Profis  
recommend = empfehlen  
roll = die Rolle — Rollen  
symbol = das Symbol — Symbole  
tradition = die Tradition — Traditionen  
truly = wirklich  
twice = zweimal  
Palestinians = die Palästinenser  
wright = der Wright  
additional = zusätzlich  
African = afrikanisch  
algorithm = der Algorithmus — Algorithmen  
anybody = irgendjemand  
attract = anziehen  
church = die Kirche — Kirchen  
copy = die Kopie — Kopien  
dot = der Punkt — Punkte  
drink — drank — drunk = trinken — hat getrunken — trank  
hair = das Haar — Haare  
hog = das Schwein — Schweine  
hurdle = die Hürde — Hürden  
independent = unabhängig  
Jewish = jüdisch  
mental = mental  
necessary = notwendig  
photographer = der Fotograf — Fotografen  
pipe = die Pfeife — Pfeifen  
portion = der Teil — Teile  
promote = fördern  
quarantine = die Quarantäne  
regulation = die Regelung — Regelungen  
spark = der Funke — Funken  
spin = der Spin  
table = der Tisch — Tische  
task = die Aufgabe — Aufgaben  
traffic = der Verkehr  
versus = gegen  
wildlife = die Wildtiere  
wolf = der Wolf — Wölfe  
Palestine = Palästina  
adopt = adoptieren  
advantage = der Vorteil — Vorteile  
alliance = die Allianz — Allianzen  
annual = jährlich  
campus = der Campus  
chicken = das Huhn — Hühner  
compete = konkurrieren  
context = der Kontext — Kontexte  
counter = der Zähler — Zähler  
county = der Landkreis — Landkreise  
exact = genau  
French = französisch  
inch = der Zoll — Zoll  
investor = der Investor — Investoren  
lift = der Aufzug — Aufzüge  
lower = niedriger  
melt = schmelzen  
negative = negativ  
nowhere = nirgendwo  
particle = das Teilchen — Teilchen  
partner = der Partner — Partner  
poster = das Poster — Poster  
poultry = das Geflügel  
prison = das Gefängnis — Gefängnisse  
reference = die Referenz — Referenzen  
sperm = das Sperma  
spring = der Frühling  
steal — stole — stolen = stehlen — hat gestohlen — stahl  
subject = das Thema — Themen  
transfer = der Transfer — Transfers  
underground = unterirdisch  
willing = bereit  
zoo = der Zoo — Zoos  
republic = die Republik — Republiken  
Sudan = der Sudan  
achieve = erreichen  
advanced = fortgeschritten  
cancer = der Krebs  
cash = das Bargeld  
chase = die Verfolgung; verfolgen  
comment = der Kommentar — Kommentare  
concept = das Konzept — Konzepte  
customer = der Kunde — Kunden  
dramatically = dramatisch  
ecosystem = das Ökosystem — Ökosysteme  
employer = der Arbeitgeber — Arbeitgeber  
ensure = sicherstellen  
explore = erkunden  
feeling = das Gefühl — Gefühle  
flat = flach  
grass = das Gras  
item = der Artikel — Artikel  
muscle = der Muskel — Muskeln  
occupy = besetzen  
ourselves = uns selbst  
panther = der Panther — Panther  
peace = der Frieden  
performance = die Leistung — Leistungen  
reflect = reflektieren  
replicate = replizieren  
responsibility = die Verantwortung  
satellite = der Satellit — Satelliten  
scan = der Scan — Scans  
sex = das Geschlecht  
smooth = glatt  
transportation = der Transport  
unit = die Einheit — Einheiten  
Cairo = Kairo  
crown = die Krone — Kronen  
queen = die Königin — Königinnen  
acknowledge = anerkennen  
advance = der Fortschritt — Fortschritte  
assist = assistieren  
authority = die Autorität — Autoritäten  
baseball = das Baseball  
breed = die Rasse — Rassen  
criminal = der Kriminelle — Kriminelle  
deforestation = die Abholzung  
extend = erweitern  
identity = die Identität — Identitäten  
immunity = die Immunität  
institution = die Institution — Institutionen  
journalism = der Journalismus  
lawsuit = die Klage — Klagen  
loud = laut  
membership = die Mitgliedschaft  
memory = die Erinnerung — Erinnerungen  
mutation = die Mutation — Mutationen  
Napoleon = Napoleon  
newspaper = die Zeitung — Zeitungen  
participate = teilnehmen  
pilot = der Pilot — Piloten  
pollution = die Verschmutzung  
possibly = möglicherweise  
radio = das Radio — Radios  
railroad = die Eisenbahn — Eisenbahnen  
refuse = ablehnen  
regular = regelmäßig  
regulate = regulieren  
retirement = der Ruhestand  
reveal = enthüllen  
secure = sicher  
shooting = das Schießen  
stretch = die Strecke — Strecken  
strict = streng  
sudden = plötzlich  
tap = der Hahn — Hähne  
transit = der Transit  
universe = das Universum  
useful = nützlich  
August = der August  
Chicago = Chicago  
Everest = der Everest  
Philippines = die Philippinen  
aim = das Ziel — Ziele  
airplane = das Flugzeug — Flugzeuge  
approval = die Genehmigung — Genehmigungen  
associate = der Mitarbeiter — Mitarbeiter  
brutal = brutal  
camp = das Lager — Lager  
collection = die Sammlung — Sammlungen  
competition = der Wettbewerb — Wettbewerbe  
confirm = bestätigen  
corporation = die Gesellschaft — Gesellschaften  
correct = korrekt  
critical = kritisch  
crucial = entscheidend  
disaster = die Katastrophe — Katastrophen  
emit = ausstoßen  
engage = engagieren  
evolve = entwickeln  
filmmaker = der Filmemacher — Filmemacher
gender = das Geschlecht  
guarantee = die Garantie — Garantien  
guide = der Führer — Führer; führen  
historical = historisch  
illness = die Krankheit — Krankheiten  
knife — knives = das Messer — Messer  
liquid = die Flüssigkeit — Flüssigkeiten  
male = männlich  
management = das Management  
march = der Marsch — Märsche  
mission = die Mission — Missionen  
moon = der Mond  
murder = der Mord — Morde  
normally = normalerweise  
pedestrian = der Fußgänger — Fußgänger  
perfectly = perfekt  
quick = schnell  
reaction = die Reaktion — Reaktionen  
senate = der Senat  
software = die Software  
somehow = irgendwie  
southern = südlich  
speech = die Rede — Reden  
sue = verklagen  
Kashmir = Kaschmir  
agriculture = die Landwirtschaft  
architect = der Architekt — Architekten  
bright = hell  
capacity = die Kapazität — Kapazitäten  
cast = die Besetzung — Besetzungen; werfen  
channel = der Kanal — Kanäle  
climb = klettern  
comfortable = bequem  
contribution = der Beitrag — Beiträge  
destruction = die Zerstörung  
distribute = verteilen  
efficient = effizient  
eliminate = eliminieren  
export = der Export — Exporte; exportieren  
fold = falten  
forecast = die Vorhersage — Vorhersagen  
forget — forgot — forgotten = vergessen — hat vergessen — vergaß  
grocery = der Lebensmittelladen — Lebensmittelläden  
iron = das Eisen  
lake = der See — Seen  
miniature = die Miniatur — Miniaturen  
munition = die Munition  
officially = offiziell  
overdose = die Überdosis — Überdosen  
pack = das Paket — Pakete  
pair = das Paar — Paare  
payment = die Zahlung — Zahlungen  
perform = aufführen  
permanent = dauerhaft  
pickleball = das Pickleball  
presence = die Anwesenheit  
refer = verweisen  
remote = fern  
royal = königlich  
settle = sich niederlassen  
skill = die Fähigkeit — Fähigkeiten  
split = teilen  
successfully = erfolgreich  
surprise = die Überraschung — Überraschungen  
tough = hart  
trap = die Falle — Fallen  
typeface = die Schriftart — Schriftarten  
underneath = unter  
unprecedented = beispiellos  
wife = die Ehefrau — Ehefrauen  
September = der September  
Valley = das Tal — Täler  
Yemen = der Jemen  
ancient = alt  
bind — bound — bound = binden — hat gebunden — band  
bounce = der Sprung — Sprünge; springen  
census = die Volkszählung — Volkszählungen  
concerned = besorgt  
core = der Kern — Kerne  
corona = die Corona  
dance = der Tanz — Tänze; tanzen  
devastating = verheerend  
device = das Gerät — Geräte  
dose = die Dosis — Dosen  
fairly = ziemlich  
fighter = der Kämpfer — Kämpfer  
Filipino = der Filipino — Filipinos  
grab = greifen  
habitat = der Lebensraum — Lebensräume  
lawn = der Rasen  
Lebanon = der Libanon  
manufacturing = die Fertigung  
nationwide = landesweit  
oyster = die Auster — Austern  
physical = physisch  
pound = das Pfund — Pfunde  
profitable = profitabel  
progress = der Fortschritt — Fortschritte  
quarter = das Viertel — Viertel  
register = das Register — Register; registrieren  
reporting = die Berichterstattung  
respect = der Respekt  
seismic = seismisch  
shortage = der Mangel  
stadium = das Stadion — Stadien  
trigger = der Auslöser — Auslöser  
upon = auf  
wake — woke — woken = aufwachen — ist aufgewacht — wachte auf  
yellow = gelb  
Cape = das Kap — Kaps  
July = der Juli  
June = der Juni  
Madagascar = Madagaskar  
November = der November  
accurate = genau  
afford = sich leisten  
alive = lebendig  
although = obwohl  
amendment = die Änderung — Änderungen  
bike = das Fahrrad — Fahrräder  
birth = die Geburt — Geburten  
bungalow = der Bungalow — Bungalows  
connection = die Verbindung — Verbindungen  
constantly = ständig  
crack = der Riss — Risse  
custom = der Brauch — Bräuche  
dairy = die Molkerei — Molkereien  
defense = die Verteidigung  
detainee = der Häftling — Häftlinge  
differently = anders  
discrimination = die Diskriminierung  
equal = gleich  
famine = die Hungersnot — Hungersnöte  
girl = das Mädchen — Mädchen  
gravity = die Schwerkraft  
grouse = das Moorhuhn — Moorhühner  
hate = der Hass  
hydrogen = der Wasserstoff  
ideal = ideal  
invent = erfinden  
investigate = untersuchen  
isolate = isolieren  
lady = die Dame — Damen  
length = die Länge  
lighting = die Beleuchtung  
load = die Ladung — Ladungen  
lockdown = der Lockdown — Lockdowns  
magazine = die Zeitschrift — Zeitschriften  
mainly = hauptsächlich  
mainstream = der Mainstream  
migrant = der Migrant — Migranten  
minority = die Minderheit — Minderheiten  
nose = die Nase — Nasen  
orange = die Orange — Orangen  
outcome = das Ergebnis — Ergebnisse  
ozone = das Ozon  
perhaps = vielleicht  
pre = vor  
prime = die Primzahl — Primzahlen  
principle = das Prinzip — Prinzipien  
quote = das Zitat — Zitate  
racism = der Rassismus  
rating = die Bewertung — Bewertungen  
rent = die Miete — Mieten  
sage = der Salbei  
scary = gruselig  
secret = das Geheimnis — Geheimnisse  
senator = der Senator — Senatoren  
shipping = der Versand  
stake = der Einsatz — Einsätze  
stewardess = die Stewardess — Stewardessen  
storage = die Lagerung  
substance = die Substanz — Substanzen  
toward = in Richtung  
unless = es sei denn  
France = Frankreich  
Russians = die Russen  
Stanford = Stanford  
Uruguay = Uruguay  
accept = akzeptieren  
aid = die Hilfe  
aircraft = das Flugzeug — Flugzeuge  
Arab = der Araber — Araber  
Augustine = Augustinus  
author = der Autor — Autoren  
Azerbaijan = Aserbaidschan  
bacteria = die Bakterien  
became = wurde  
belong = gehören  
bombing = der Bombenanschlag — Bombenanschläge  
clothing = die Kleidung  
consume = konsumieren  
cough = der Husten  
creation = die Schöpfung  
decrease = die Abnahme — Abnahmen  
demonstration = die Demonstration — Demonstrationen  
earthquake = das Erdbeben — Erdbeben  
expansion = die Expansion  
fighting = der Kampf — Kämpfe  
flip = der Flip — Flips  
float = schweben  
further = weiter  
gallon = die Gallone — Gallonen  
graphic = die Grafik — Grafiken  
greenhouse = das Gewächshaus — Gewächshäuser  
Hampton = Hampton  
hero = der Held — Helden  
highlight = der Höhepunkt — Höhepunkte  
hunt = die Jagd; jagen  
inequality = die Ungleichheit  
instrument = das Instrument — Instrumente  
lab = das Labor — Labore  
lesson = die Lektion — Lektionen  
locate = lokalisieren  
methane = das Methan  
mimic = nachahmen  
naturally = natürlich  
nest = das Nest — Nester  
nine = neun  
opening = die Eröffnung — Eröffnungen  
physics = die Physik  
postcard = die Postkarte — Postkarten  
previous = vorherig  
realistic = realistisch  
restore = wiederherstellen  
ring = der Ring — Ringe  
row = die Reihe — Reihen  
scenario = das Szenario — Szenarien  
sequence = die Sequenz — Sequenzen  
setting = die Einstellung — Einstellungen  
shadow = der Schatten — Schatten  
shout = der Schrei — Schreie  
suicide = der Selbstmord  
swing = der Schwung  
tactic = die Taktik — Taktiken  
television = das Fernsehen  
thinking = das Denken  
translate = übersetzen  
typical = typisch  
variety = die Vielfalt  
victory = der Sieg — Siege  
welcome = willkommen  
Britain = Großbritannien  
Island = die Insel — Inseln  
Pennsylvania = Pennsylvania  
Poland = Polen  
Space = der Weltraum  
Ukrainians = die Ukrainer  
absorb = absorbieren  
agricultural = landwirtschaftlich  
apple = der Apfel — Äpfel  
architecture = die Architektur  
aside = beiseite  
auction = die Auktion — Auktionen  
barely = kaum  
branch = der Zweig — Zweige  
career = die Karriere — Karrieren  
ceiling = die Decke — Decken  
comparison = der Vergleich — Vergleiche  
creative = kreativ  
curious = neugierig  
delay = die Verzögerung — Verzögerungen  
disappear = verschwinden  
droplet = der Tropfen — Tropfen  
editorial = das Editorial — Editorials  
empire = das Reich — Reiche  
employment = die Beschäftigung  
excited = aufgeregt  
fade = verblassen  
flooding = die Überschwemmung — Überschwemmungen  
helpful = hilfreich  
household = der Haushalt — Haushalte  
iconic = ikonisch  
implement = implementieren  
initial = anfänglich  
intense = intensiv  
Japanese = japanisch  
laser = der Laser — Laser  
league = die Liga — Ligen  
lighthouse = der Leuchtturm — Leuchttürme  
medal = die Medaille — Medaillen  
meeting = das Treffen — Treffen  
mistake = der Fehler — Fehler  
mom = die Mutter — Mütter  
obstacle = das Hindernis — Hindernisse  
opposite = gegenüber  
physically = physisch  
polling = die Umfrage — Umfragen  
prop = die Stütze — Stützen  
rancher = der Rancher — Rancher  
reject = ablehnen  
religious = religiös  
residential = Wohn-  
restriction = die Einschränkung — Einschränkungen  
roof = das Dach — Dächer  
seriously = ernsthaft  
shine = der Glanz  
significantly = signifikant  
sled = der Schlitten — Schlitten  
son = der Sohn — Söhne  
sorry = Entschuldigung  
supporter = der Unterstützer — Unterstützer  
volunteer = der Freiwillige — Freiwillige  
vulnerable = verletzlich  
widespread = weit verbreitet  
wing = der Flügel — Flügel  
worried = besorgt  
Georgia = Georgien  
Senate = der Senat  
active = aktiv  
adjust = anpassen  
advertising = die Werbung  
analyze = analysieren  
application = die Anwendung — Anwendungen  
armed = bewaffnet  
Armenia = Armenien  
basement = der Keller — Keller  
bed = das Bett — Betten  
beef = das Rindfleisch  
belief = der Glaube — Glauben  
bite — bit — bitten = beißen — hat gebissen — biss  
breathe = atmen  
chapter = das Kapitel — Kapitel  
coalition = die Koalition — Koalitionen  
coaster = der Untersetzer — Untersetzer  
commit = verpflichten  
communicate = kommunizieren  
consistently = konsequent  
constitution = die Verfassung  
convince = überzeugen  
corporate = unternehmerisch  
dataset = der Datensatz — Datensätze  
dementia = die Demenz  
dominate = dominieren  
dramatic = dramatisch  
earn = verdienen  
enforcement = die Durchsetzung  
engine = der Motor — Motoren  
essential = wesentlich  
exchange = der Austausch  
executive = der Geschäftsführer — Geschäftsführer  
exercise = die Übung — Übungen  
female = weiblich  
font = die Schriftart — Schriftarten  
friendly = freundlich  
fruit = die Frucht — Früchte  
governor = der Gouverneur — Gouverneure  
honestly = ehrlich  
horror = der Horror  
joy = die Freude  
lane = die Spur — Spuren  
lifetime = die Lebenszeit  
meanwhile = inzwischen  
minister = der Minister — Minister  
narrow = schmal  
overlap = die Überlappung — Überlappungen  
pig = das Schwein — Schweine  
plate = der Teller — Teller  
prediction = die Vorhersage — Vorhersagen  
punch = der Schlag — Schläge  
rapidly = schnell  
rebuild = wiederaufbauen  
reef = das Riff — Riffe  
rid = befreien  
ruling = die Entscheidung — Entscheidungen  
shoulder = die Schulter — Schultern  
signature = die Unterschrift — Unterschriften  
skyrocket = in die Höhe schießen  
soft = weich  
spray = das Spray — Sprays  
status = der Status  
terrorist = der Terrorist — Terroristen  
transmission = die Übertragung — Übertragungen  
trucker = der Lkw-Fahrer — Lkw-Fahrer  
turbine = die Turbine — Turbinen  
vaccinate = impfen  
variation = die Variation — Variationen  
vary = variieren  
violent = gewalttätig  
widely = weit verbreitet  
Australia = Australien  
God = Gott  
Italy = Italien  
Manhattan = Manhattan  
abuse = der Missbrauch  
analysis = die Analyse — Analysen  
assume = annehmen  
backyard = der Hinterhof — Hinterhöfe  
behavior = das Verhalten  
being = das Wesen — Wesen  
boat = das Boot — Boote  
bone = der Knochen — Knochen  
bus = der Bus — Busse  
classic = klassisch  
coat = der Mantel — Mäntel  
colleague = der Kollege — Kollegen  
colonial = kolonial  
communication = die Kommunikation  
convert = umwandeln  
coverage = die Berichterstattung  
critic = der Kritiker — Kritiker  
dam = der Damm — Dämme  
developer = der Entwickler — Entwickler  
displacement = die Verdrängung  
division = die Division — Divisionen  
dress = das Kleid — Kleider  
dynamic = dynamisch  
ear = das Ohr — Ohren  
elite = die Elite  
emergency = der Notfall — Notfälle  
employ = beschäftigen  
explanation = die Erklärung — Erklärungen  
flag = die Flagge — Flaggen  
flower = die Blume — Blumen  
found = gründen  
foundation = die Stiftung — Stiftungen  
genetic = genetisch  
gentleman = der Herr — Herren  
gray = grau  
historically = historisch  
hurricane = der Hurrikan — Hurrikane  
immigration = die Einwanderung  
import = der Import — Importe; importieren  
initially = anfänglich  
margin = der Rand — Ränder  
measurement = die Messung — Messungen  
militia = die Miliz — Milizen  
monitor = der Monitor — Monitore; überwachen  
moral = moralisch  
northern = nördlich  
opioid = das Opioid — Opioide  
package = das Paket — Pakete  
patch = der Patch — Patches  
perceive = wahrnehmen  
pill = die Pille — Pillen  
port = der Hafen — Häfen  
pregnancy = die Schwangerschaft  
primary = primär  
remind = erinnern  
revenue = der Umsatz — Umsätze  
root = die Wurzel — Wurzeln  
sanction = die Sanktion — Sanktionen  
select = auswählen  
shake — shook — shaken = schütteln — hat geschüttelt — schüttelte  
shrink — shrank — shrunk = schrumpfen — ist geschrumpft — schrumpfte  
statement = die Aussage — Aussagen  
strange = seltsam  
surge = der Anstieg — Anstiege  
sweep — swept — swept = fegen — hat gefegt — fegte  
tag = der Tag — Tags  
tanker = der Tanker — Tanker  
technical = technisch  
tight = eng  
timber = das Holz  
tone = der Ton — Töne  
topic = das Thema — Themen  
tour = die Tour — Touren  
tricky = knifflig  
vice = der Laster  
wash = waschen  
wire = der Draht — Drähte  
England = England  
grand = großartig  
Service = der Dienst — Dienste  
advocate = der Anwalt — Anwälte  
aggressive = aggressiv  
anyway = trotzdem  
axis = die Achse — Achsen  
balloon = der Ballon — Ballons  
beaver = der Biber — Biber  
bridge = die Brücke — Brücken  
chant = der Gesang — Gesänge  
crowd = die Menge — Mengen  
dad = der Vater — Väter  
dense = dicht  
diet = die Diät — Diäten  
domestic = inländisch  
doubt = der Zweifel — Zweifel  
editor = der Redakteur — Redakteure  
electronic = elektronisch  
elsewhere = anderswo  
enable = ermöglichen  
engineering = das Ingenieurwesen  
enjoy = genießen  
estate = das Anwesen — Anwesen  
ethnic = ethnisch  
exploit = ausbeuten  
extract = der Extrakt — Extrakte  
fellow = der Kollege — Kollegen  
founder = der Gründer — Gründer  
frequency = die Frequenz — Frequenzen  
garden = der Garten — Gärten  
hurt = verletzen  
imagery = die Bildsprache  
insurance = die Versicherung — Versicherungen  
interaction = die Interaktion — Interaktionen  
invisible = unsichtbar  
limited = begrenzt  
meteorite = der Meteorit — Meteoriten  
molecule = das Molekül — Moleküle
opinion = die Meinung — Meinungen  
otherwise = sonst  
parallel = parallel  
partly = teilweise  
pathogen = der Krankheitserreger — Krankheitserreger  
pile = der Stapel — Stapel  
presidency = die Präsidentschaft  
priority = die Priorität — Prioritäten  
processing = die Verarbeitung  
propaganda = die Propaganda  
qualified = qualifiziert  
random = zufällig  
recession = die Rezession — Rezessionen  
refugee = der Flüchtling — Flüchtlinge  
regardless = ungeachtet  
removal = die Entfernung  
reporter = der Reporter — Reporter  
requirement = die Anforderung — Anforderungen  
resistance = der Widerstand  
sector = der Sektor — Sektoren  
seize = ergreifen  
shield = der Schild — Schilde  
shirt = das Hemd — Hemden  
shutdown = die Abschaltung  
slavery = die Sklaverei  
stable = stabil  
strength = die Stärke  
strengthen = stärken  
swim — swam — swum = schwimmen — ist geschwommen — schwamm  
ticket = das Ticket — Tickets  
unfortunately = leider  
unusual = ungewöhnlich  
warming = die Erwärmung  
bay = die Bucht — Buchten  
December = der Dezember  
Egypt = Ägypten  
English = Englisch  
Jakarta = Jakarta  
monopoly = das Monopol — Monopole  
spider = die Spinne — Spinnen  
addition = die Addition  
alternative = die Alternative — Alternativen  
appeal = der Appell — Appelle  
appearance = das Erscheinen  
appoint = ernennen  
archive = das Archiv — Archive  
astronaut = der Astronaut — Astronauten  
bag = die Tasche — Taschen  
bathroom = das Badezimmer — Badezimmer  
booster = der Booster — Booster  
burden = die Last — Lasten  
buyback = der Rückkauf  
clue = der Hinweis — Hinweise  
continent = der Kontinent — Kontinente  
decarbonize = dekarbonisieren  
deepfake = das Deepfake — Deepfakes  
diaper = die Windel — Windeln  
dioxide = das Dioxid  
display = die Anzeige — Anzeigen  
dive = tauchen  
domain = die Domäne — Domänen  
dust = der Staub  
eastern = östlich  
embrace = umarmen  
escape = entkommen  
explode = explodieren  
facial = Gesichts-  
failure = das Versagen  
fashion = die Mode  
filter = der Filter — Filter  
fraud = der Betrug  
Fred = Fred  
funny = lustig  
handful = die Handvoll  
harsh = hart  
heavily = schwer  
immigrant = der Einwanderer — Einwanderer  
jail = das Gefängnis — Gefängnisse  
leverage = die Hebelwirkung  
log = das Protokoll — Protokolle  
odd = seltsam  
pain = der Schmerz — Schmerzen  
participant = der Teilnehmer — Teilnehmer  
pathway = der Weg — Wege  
pledge = das Versprechen — Versprechen  
pregnant = schwanger  
prohibit = verbieten  
provider = der Anbieter — Anbieter  
purchase = der Kauf — Käufe  
recognition = die Anerkennung  
recreate = neu erstellen  
recruit = rekrutieren  
reduction = die Reduzierung  
restrict = einschränken  
ruin = die Ruine — Ruinen  
runoff = der Abfluss  
saint = der Heilige — Heilige  
salary = das Gehalt — Gehälter  
settler = der Siedler — Siedler  
shoe = der Schuh — Schuhe  
sing — sang — sung = singen — hat gesungen — sang  
skate = das Skateboard — Skateboards  
solid = solide  
string = die Schnur — Schnüre  
surf = surfen  
SUV = der SUV — SUVs  
swimming = das Schwimmen  
talent = das Talent — Talente  
temporary = vorübergehend  
thought = der Gedanke — Gedanken  
tribe = der Stamm — Stämme  
tweet = der Tweet — Tweets  
valuable = wertvoll  
via = über  
virtual = virtuell  
visible = sichtbar  
wish = der Wunsch — Wünsche  
wound = die Wunde — Wunden  
wrap = einwickeln  
Arctic = die Arktis  
Commonwealth = das Commonwealth  
Gaza = Gaza  
accident = der Unfall — Unfälle  
acid = die Säure — Säuren  
adapt = anpassen  
additive = der Zusatz — Zusätze  
Afghan = afghanisch  
altogether = insgesamt  
attach = befestigen  
blame = die Schuld  
boundary = die Grenze — Grenzen  
button = der Knopf — Knöpfe  
cancel = stornieren  
cat = die Katze — Katzen  
catastrophic = katastrophal  
chairman = der Vorsitzende — Vorsitzende  
clinic = die Klinik — Kliniken  
commitment = das Engagement  
danger = die Gefahr — Gefahren  
detect = erkennen  
dirty = schmutzig  
distancing = die Distanzierung  
diverse = vielfältig  
exciting = aufregend  
fatality = der Todesfall — Todesfälle  
finger = der Finger — Finger  
fox = der Fuchs — Füchse  
ghost = der Geist — Geister  
honor = die Ehre  
hopefully = hoffentlich  
Houthis = die Huthi  
insect = das Insekt — Insekten  
invention = die Erfindung — Erfindungen  
invite = einladen  
livestock = das Vieh  
magic = die Magie  
manufacture = die Herstellung  
medication = die Medikation  
missile = die Rakete — Raketen  
mortgage = die Hypothek — Hypotheken  
oversight = die Aufsicht  
pit = die Grube — Gruben  
plenty = reichlich  
protective = schützend  
pulp = der Brei  
quiet = leise  
recommendation = die Empfehlung — Empfehlungen  
relation = die Beziehung — Beziehungen  
reputation = der Ruf  
rush = die Eile  
seal = das Siegel — Siegel  
senior = der Senior — Senioren  
shall = sollen  
shock = der Schock — Schocks  
slave = der Sklave — Sklaven  
Spotify = Spotify  
statistic = die Statistik — Statistiken  
streaming = das Streaming  
stress = der Stress  
sugar = der Zucker  
suppress = unterdrücken  
texture = die Textur — Texturen  
therefore = daher  
thrive = gedeihen  
title = der Titel — Titel  
tournament = das Turnier — Turniere  
understanding = das Verständnis  
vitamin = das Vitamin — Vitamine  
vocal = vokal  
wet = nass  
whenever = wann immer  
winner = der Gewinner — Gewinner  
withdraw = zurückziehen  
youth = die Jugend  
Asia = Asien  
Berlin = Berlin  
Bush = Bush  
Kabul = Kabul  
Wisconsin = Wisconsin  
accessible = zugänglich  
activate = aktivieren  
antibody = der Antikörper — Antikörper  
assemble = zusammenbauen  
attend = teilnehmen  
awesome = großartig  
beam = der Strahl — Strahlen  
billionaire = der Milliardär — Milliardäre  
bold = mutig  
borrow = leihen  
canopy = das Dach — Dächer  
careful = vorsichtig  
carefully = sorgfältig  
catapult = das Katapult — Katapulte  
competitive = wettbewerbsfähig  
complaint = die Beschwerde — Beschwerden  
contagious = ansteckend  
controversial = kontrovers  
corrupt = korrupt  
craft = das Handwerk  
cruise = die Kreuzfahrt — Kreuzfahrten  
density = die Dichte  
deploy = einsetzen  
discovery = die Entdeckung — Entdeckungen  
dominant = dominant  
drought = die Dürre — Dürren  
economist = der Ökonom — Ökonomen  
enormous = enorm  
Europe = Europa  
excess = der Überschuss — Überschüsse  
execute = ausführen  
exploration = die Erkundung  
fatal = tödlich  
firm = die Firma — Firmen  
formal = formell  
formula = die Formel — Formeln  
frankly = offen gesagt  
fungus = der Pilz — Pilze  
gay = schwul  
globe = der Globus — Globen  
hail = der Hagel  
hell = die Hölle  
however = jedoch  
ideology = die Ideologie — Ideologien  
ignore = ignorieren  
incentive = der Anreiz — Anreize  
influential = einflussreich  
install = installieren  
interpret = interpretieren  
kingdom = das Königreich — Königreiche  
lawyer = der Anwalt — Anwälte  
legalization = die Legalisierung  
legislature = die Legislative  
library = die Bibliothek — Bibliotheken  
liner = der Liner — Liner  
making = die Herstellung  
math = die Mathematik  
meaning = die Bedeutung  
medicine = die Medizin  
minimize = minimieren  
monarchy = die Monarchie — Monarchien  
navy = die Marine  
penalty = die Strafe — Strafen  
proposal = der Vorschlag — Vorschläge  
rally = die Rallye — Rallyes  
reinforce = verstärken  
rocket = die Rakete — Raketen  
scientific = wissenschaftlich  
sewer = die Kanalisation  
simulation = die Simulation — Simulationen  
smart = intelligent  
soap = die Seife  
span = die Spanne — Spannen  
stack = der Stapel — Stapel  
stare = starren  
submit = einreichen  
surveyor = der Vermesser — Vermesser  
technically = technisch  
thin = dünn  
toll = die Maut  
tooth — teeth = der Zahn — Zähne  
treaty = der Vertrag — Verträge  
uncertainty = die Unsicherheit  
weigh = wiegen  
worldwide = weltweit  
writing = das Schreiben  
Alex = Alex  
Arizona = Arizona  
Brooklyn = Brooklyn  
COVID = COVID  
Jupiter = Jupiter  
Metro = die Metro  
Paris = Paris  
Turkey = die Türkei  
alter = ändern  
ambitious = ehrgeizig  
argument = das Argument — Argumente  
Asian = asiatisch  
assault = der Angriff — Angriffe  
aware = bewusst  
awareness = das Bewusstsein  
blockbuster = der Blockbuster — Blockbuster  
breakthrough = der Durchbruch — Durchbrüche  
broadcast = die Sendung — Sendungen  
brother = der Bruder — Brüder  
cannabis = das Cannabis  
celebrity = die Berühmtheit — Berühmtheiten  
chief = der Chef — Chefs  
circumstance = der Umstand — Umstände  
cocci = die Kokken  
colony = die Kolonie — Kolonien  
conspiracy = die Verschwörung — Verschwörungen  
contrast = der Kontrast — Kontraste  
coup = der Putsch — Putsche  
defeat = die Niederlage — Niederlagen  
delivery = die Lieferung — Lieferungen  
demonstrate = demonstrieren  
depict = darstellen  
dump = die Müllkippe — Müllkippen  
enact = erlassen  
epidemic = die Epidemie — Epidemien  
equally = gleich  
escalate = eskalieren  
everyday = alltäglich  
existence = die Existenz  
exoplanet = der Exoplanet — Exoplaneten  
expectation = die Erwartung — Erwartungen  
fraction = der Bruch — Brüche  
Fresnel = Fresnel  
galaxy = die Galaxie — Galaxien  
globally = global  
govern = regieren  
graduate = der Absolvent — Absolventen  
harmful = schädlich  
harvest = die Ernte — Ernten  
headline = die Schlagzeile — Schlagzeilen  
headquarters = der Hauptsitz  
heritage = das Erbe  
importance = die Wichtigkeit  
indicate = anzeigen  
inquit = inquit  
intend = beabsichtigen  
joint = das Gelenk — Gelenke  
justify = rechtfertigen  
lean = lehnen  
license = die Lizenz — Lizenzen  
lord = der Herr — Herren  
manufacturer = der Hersteller — Hersteller  
menu = das Menü — Menüs  
militant = der Militante — Militante  
monthly = monatlich  
mouth = der Mund — Münder  
orbit = die Umlaufbahn — Umlaufbahnen  
origin = der Ursprung  
phenomenon = das Phänomen — Phänomene  
plain = die Ebene — Ebenen  
pour = gießen  
previously = zuvor  
properly = richtig  
rapid = schnell  
receptor = der Rezeptor — Rezeptoren  
relative = relativ  
render = rendern  
repair = reparieren  
ski = das Ski — Skier  
soccer = der Fußball  
sovereignty = die Souveränität  
speaker = der Sprecher — Sprecher  
species = die Art — Arten  
spectrum = das Spektrum — Spektren  
spending = die Ausgaben  
squeeze = drücken  
stone = der Stein — Steine  
surrender = sich ergeben  
sustainable = nachhaltig  
tenant = der Mieter — Mieter  
tide = die Gezeiten  
toxic = giftig  
transport = der Transport  
tube = die Röhre — Röhren  
umbrella = der Regenschirm — Regenschirme  
unite = vereinen  
variant = die Variante — Varianten  
weak = schwach  
wipe = wischen  
working = arbeitend  
Antarctica = die Antarktis  
Bible = die Bibel  
Jersey = Jersey  
absolute = absolut  
alongside = neben  
animate = animieren  
artifact = das Artefakt — Artefakte  
aspect = der Aspekt — Aspekte  
assistant = der Assistent — Assistenten  
backwards = rückwärts  
Benin = Benin  
bury = begraben  
busy = beschäftigt  
catastrophe = die Katastrophe — Katastrophen  
cent = der Cent — Cents  
challenging = herausfordernd  
coffee = der Kaffee  
competitor = der Konkurrent — Konkurrenten  
complexity = die Komplexität  
conference = die Konferenz — Konferenzen  
consistent = konsequent  
constant = konstant  
cry = weinen  
dedicate = widmen  
deposit = die Einzahlung — Einzahlungen  
depth = die Tiefe  
dialogue = der Dialog — Dialoge  
disrupt = unterbrechen  
distribution = die Verteilung  
Dominican = dominikanisch  
drain = der Abfluss — Abflüsse  
duty = die Pflicht — Pflichten  
dying = sterbend  
dyslexia = die Legasthenie  
evangelical = evangelisch  
fault = der Fehler — Fehler  
footprint = der Fußabdruck — Fußabdrücke  
fresh = frisch  
gate = das Tor — Tore  
geothermal = geothermisch  
grain = das Korn — Körner  
gross = brutto  
groundwater = das Grundwasser  
guilty = schuldig  
hello = hallo  
hip = die Hüfte — Hüften  
humanity = die Menschheit  
identical = identisch  
immediate = unmittelbar  
impose = auferlegen  
initiative = die Initiative — Initiativen  
injure = verletzen  
internal = intern  
kitchen = die Küche — Küchen  
lagoon = die Lagune — Lagunen  
legalize = legalisieren  
lifeboat = das Rettungsboot — Rettungsboote  
luckily = glücklicherweise  
lucky = glücklich  
lung = die Lunge — Lungen  
mill = die Mühle — Mühlen  
misinformation = die Fehlinformation — Fehlinformationen  
motor = der Motor — Motoren  
Muslim = der Muslim — Muslime  
negotiate = verhandeln  
neutral = neutral  
obtain = erhalten  
occupation = die Besetzung  
opposition = die Opposition  
painter = der Maler — Maler  
Palestinian = palästinensisch  
permit = die Genehmigung — Genehmigungen  
physicist = der Physiker — Physiker  
pixel = das Pixel — Pixel  
plantation = die Plantage — Plantagen  
porn = der Porno — Pornos  
practical = praktisch  
profile = das Profil — Profile  
proper = richtig  
proud = stolz  
province = die Provinz — Provinzen  
qualify = qualifizieren  
ramp = die Rampe — Rampen  
rank = der Rang — Ränge  
recover = sich erholen  
representation = die Darstellung  
respiratory = respiratorisch  
retire = in den Ruhestand gehen  
revolutionary = revolutionär  
rival = der Rivale — Rivalen  
schedule = der Zeitplan — Zeitpläne  
script = das Skript — Skripte  
sculpture = die Skulptur — Skulpturen  
seaweed = der Seetang  
seed = der Samen — Samen  
sentence = der Satz — Sätze  
staff = das Personal  
strain = die Belastung — Belastungen  
strait = die Meerenge — Meerengen  
strategic = strategisch  
suffering = das Leiden  
survival = das Überleben  
swap = tauschen  
tilt = die Neigung  
trillion = die Billion — Billionen  
verify = überprüfen  
vibration = die Vibration — Vibrationen  
victim = das Opfer — Opfer  
visitor = der Besucher — Besucher  
warn = warnen  
whereas = während  
whom = wen  
yard = der Hof — Höfe  
Boston = Boston  
Dutch = niederländisch
Iceland = Island  
Indonesia = Indonesien  
institute = das Institut — Institute  
mount = der Berg — Berge  
Northern = nördlich  
politburo = das Politbüro  
rights = die Rechte  
secretary = der Sekretär — Sekretäre  
Vancouver = Vancouver  
accuse = beschuldigen  
adoption = die Adoption — Adoptionen  
afraid = ängstlich  
alcohol = der Alkohol  
apology = die Entschuldigung — Entschuldigungen  
association = die Vereinigung — Vereinigungen  
basketball = der Basketball  
beauty = die Schönheit  
bend — bent — bent = biegen — hat gebogen — bog  
beneath = unter  
biodiversity = die Biodiversität  
brightness = die Helligkeit  
bucket = der Eimer — Eimer  
bump = die Beule — Beulen  
CEO = der CEO — CEOs  
ceremony = die Zeremonie — Zeremonien  
chaos = das Chaos  
cite = zitieren  
citizenship = die Staatsbürgerschaft  
clothe = kleiden  
commission = die Kommission — Kommissionen  
composition = die Komposition — Kompositionen  
concentrate = konzentrieren  
conclude = abschließen  
consent = die Zustimmung  
consumption = der Verbrauch  
countryside = das Land  
creator = der Schöpfer — Schöpfer  
darkness = die Dunkelheit  
database = die Datenbank — Datenbanken  
definition = die Definition — Definitionen  
dessert = das Dessert — Desserts  
dimensional = dimensional  
disagree = nicht zustimmen  
distinct = deutlich  
donor = der Spender — Spender  
drainage = die Entwässerung  
drill = der Bohrer — Bohrer  
duck = die Ente — Enten  
elderly = ältere  
electron = das Elektron — Elektronen  
encounter = die Begegnung — Begegnungen  
equivalent = gleichwertig  
exclude = ausschließen  
expense = die Ausgabe — Ausgaben  
express = ausdrücken  
expression = der Ausdruck — Ausdrücke  
fever = das Fieber  
follower = der Anhänger — Anhänger  
forth = vorwärts  
gathering = die Versammlung — Versammlungen  
graph = das Diagramm — Diagramme  
having = habend  
hearing = das Hören  
hike = die Wanderung — Wanderungen  
historian = der Historiker — Historiker  
honest = ehrlich  
infected = infiziert  
ingredient = die Zutat — Zutaten  
injury = die Verletzung — Verletzungen  
Instagram = Instagram  
instruction = die Anweisung — Anweisungen  
intention = die Absicht — Absichten  
Iranian = iranisch  
iwi = der Stamm — Stämme  
jaw = der Kiefer — Kiefer  
jury = die Jury — Jurys  
lobby = die Lobby  
metric = metrisch  
micro = mikro  
mode = der Modus — Modi  
myopia = die Kurzsichtigkeit  
neither = weder  
novel = der Roman — Romane  
patent = das Patent — Patente  
petition = die Petition — Petitionen  
pink = rosa  
plot = die Handlung — Handlungen  
pocket = die Tasche — Taschen  
popularity = die Popularität  
prior = vorherig  
prioritize = priorisieren  
privilege = das Privileg — Privilegien  
puzzle = das Puzzle — Puzzles  
quiz = das Quiz — Quizze  
recording = die Aufnahme — Aufnahmen  
refine = verfeinern  
rough = rau  
saving = die Ersparnis — Ersparnisse  
scare = erschrecken  
shade = der Schatten — Schatten  
shelf = das Regal — Regale  
sight = der Anblick  
skateboard = das Skateboard — Skateboards  
slide = die Rutsche — Rutschen  
smell = der Geruch — Gerüche  
smile = das Lächeln  
subscriber = der Abonnent — Abonnenten  
sustain = aufrechterhalten  
terrible = schrecklich  
thick = dick  
unlikely = unwahrscheinlich  
urge = der Drang  
violation = die Verletzung — Verletzungen  
virtually = virtuell  
airlines = die Fluggesellschaften  
Alabama = Alabama  
Filipino = der Filipino — Filipinos  
Houston = Houston  
Hyde = Hyde  
Indus = der Indus  
Ohio = Ohio  
Pacific = der Pazifik  
Phoenix = Phoenix  
accumulate = ansammeln  
airport = der Flughafen — Flughäfen  
animator = der Animator — Animatoren  
anon = anonym  
anthropos = der Mensch  
award = der Preis — Preise  
bedroom = das Schlafzimmer — Schlafzimmer  
blanket = die Decke — Decken  
boycott = der Boykott — Boykotte  
brick = der Ziegel — Ziegel  
brilliant = brillant  
brutality = die Brutalität  
cab = das Taxi — Taxis  
calculate = berechnen  
Canadian = kanadisch  
cap = die Kappe — Kappen  
cargo = die Fracht  
carrier = der Träger — Träger  
chef = der Koch — Köche  
Christian = christlich  
circular = kreisförmig  
classroom = das Klassenzimmer — Klassenzimmer  
clinical = klinisch  
closely = eng  
coach = der Trainer — Trainer  
compartment = das Fach — Fächer  
compromise = der Kompromiss — Kompromisse  
concert = das Konzert — Konzerte  
confine = begrenzen  
congestion = die Stauung  
construct = konstruieren  
cook = der Koch — Köche  
corn = der Mais  
council = der Rat — Räte  
crater = der Krater — Krater  
criticize = kritisieren  
crowded = überfüllt  
daughter = die Tochter — Töchter  
dependent = abhängig  
detailed = detailliert  
diagram = das Diagramm — Diagramme  
diamond = der Diamant — Diamanten  
dirt = der Schmutz  
discuss = diskutieren  
displace = verdrängen  
enslave = versklaven  
error = der Fehler — Fehler  
evolution = die Evolution  
examine = untersuchen  
explosive = der Sprengstoff  
false = falsch  
fancy = schick  
flame = die Flamme — Flammen  
Florida = Florida  
foster = fördern  
gift = das Geschenk — Geschenke  
glacier = der Gletscher — Gletscher  
hill = der Hügel — Hügel  
humanitarian = humanitär  
indoor = innen  
infectious = ansteckend  
instance = die Instanz — Instanzen  
joke = der Witz — Witze  
kinda = irgendwie  
laugh = das Lachen  
legally = legal  
lens = die Linse — Linsen  
literacy = die Alphabetisierung  
logo = das Logo — Logos  
makeup = das Make-up  
marriage = die Ehe — Ehen  
migration = die Migration  
mild = mild  
mineral = das Mineral — Mineralien  
minor = geringfügig  
mitigate = mildern  
mujahideen = die Mudschaheddin  
narrator = der Erzähler — Erzähler  
nursing = die Pflege  
overthrow = der Sturz — Stürze  
pace = das Tempo  
peer = der Gleichaltrige — Gleichaltrige  
podcast = der Podcast — Podcasts  
pollster = der Meinungsforscher — Meinungsforscher  
pope = der Papst — Päpste  
prominent = prominent  
proof = der Beweis — Beweise  
publicly = öffentlich  
punish = bestrafen  
racist = rassistisch  
regularly = regelmäßig  
relief = die Erleichterung  
reminder = die Erinnerung — Erinnerungen  
remnant = der Rest — Reste  
reparation = die Reparatur — Reparaturen  
Republicans = die Republikaner  
resist = widerstehen  
rice = der Reis  
ridge = der Grat — Grate  
ridiculous = lächerlich  
rifle = das Gewehr — Gewehre  
rip = der Riss — Risse  
risky = riskant  
robot = der Roboter — Roboter  
scream = der Schrei — Schreie  
sheet = das Blatt — Blätter  
slash = der Schrägstrich — Schrägstriche  
Spanish = spanisch  
sphere = die Sphäre — Sphären  
statehood = die Staatlichkeit  
strip = der Streifen — Streifen  
subtle = subtil  
swell = die Schwellung — Schwellungen  
tape = das Band — Bänder  
taste = der Geschmack  
Terri = Terri  
theme = das Thema — Themen  
tomorrow = morgen  
tonight = heute Abend  
transmit = übertragen  
triple = dreifach  
tweak = der Twist — Twists  
ultimate = ultimativ  
undermine = untergraben  
update = das Update — Updates  
urgent = dringend  
vegetation = die Vegetation  
vertical = vertikal  
violate = verletzen  
weaken = schwächen  
whoa = whoa  
wobble = wackeln  
yield = der Ertrag — Erträge  
Germans = die Deutschen  
Greenland = Grönland  
metals = die Metalle  
Nigeria = Nigeria  
Syria = Syrien  
Tennessee = Tennessee  
Wade = Wade  
absentee = der Abwesende — Abwesende  
academic = akademisch  
align = ausrichten  
apologize = sich entschuldigen  
apparently = anscheinend  
appreciate = schätzen  
arcade = die Arkade — Arkaden  
array = das Array — Arrays  
atom = das Atom — Atome  
banana = die Banane — Bananen  
bet = die Wette — Wetten  
bloody = blutig  
brush = die Bürste — Bürsten  
bug = der Käfer — Käfer  
builder = der Bauarbeiter — Bauarbeiter  
bullet = die Kugel — Kugeln  
buyer = der Käufer — Käufer  
calculator = der Rechner — Rechner  
canyon = die Schlucht — Schluchten  
capsule = die Kapsel — Kapseln  
charity = die Wohltätigkeit  
chin = das Kinn — Kinne  
cholera = die Cholera  
chunk = das Stück — Stücke  
Clearview = Clearview  
compound = die Verbindung — Verbindungen  
compress = komprimieren  
concentration = die Konzentration  
confidence = das Vertrauen  
contamination = die Kontamination  
cotton = die Baumwolle  
cute = niedlich  
deserve = verdienen  
desire = der Wunsch — Wünsche  
discipline = die Disziplin  
discriminate = diskriminieren  
dispute = der Streit — Streitigkeiten  
drinking = das Trinken  
driving = das Fahren  
educate = erziehen  
efficiently = effizient  
emphasize = betonen  
endanger = gefährden  
faith = der Glaube — Glauben  
fifty = fünfzig  
finance = die Finanzen  
firearm = die Schusswaffe — Schusswaffen  
fishing = das Fischen  
freeze — froze — frozen = einfrieren — hat eingefroren — fror  
golden = golden  
hemisphere = die Hemisphäre — Hemisphären  
hook = der Haken — Haken  
hormuz = Hormus  
husband = der Ehemann — Ehemänner  
impressive = beeindruckend  
influenza = die Influenza  
intellectual = intellektuell  
investigator = der Ermittler — Ermittler  
italian = italienisch  
jurisdiction = die Gerichtsbarkeit  
killer = der Mörder — Mörder  
landmark = das Wahrzeichen — Wahrzeichen  
legitimate = legitim  
maker = der Hersteller — Hersteller  
manager = der Manager — Manager  
marry = heiraten  
master = der Meister — Meister  
meantime = in der Zwischenzeit  
median = der Median — Mediane  
microscope = das Mikroskop — Mikroskope  
mob = der Mob  
mortality = die Sterblichkeit  
multi = multi  
narrative = die Erzählung — Erzählungen  
nationalist = nationalistisch  
neglect = die Vernachlässigung  
newsroom = der Nachrichtenraum  
nutrient = der Nährstoff — Nährstoffe  
obligation = die Verpflichtung — Verpflichtungen  
obsess = besessen  
opt = wählen  
organizer = der Organisator — Organisatoren  
originally = ursprünglich  
output = die Ausgabe — Ausgaben  
overturn = umstürzen  
overwhelm = überwältigen  
owe = schulden  
peacock = der Pfau — Pfauen  
performer = der Darsteller — Darsteller  
phenylephrine = das Phenylephrin  
philosophy = die Philosophie  
pitbull = der Pitbull — Pitbulls  
planning = die Planung  
prayer = das Gebet — Gebete  
prevention = die Prävention  
prisoner = der Gefangene — Gefangene  
radical = radikal  
react = reagieren  
regional = regional  
resemble = ähneln  
reward = die Belohnung — Belohnungen  
riot = der Aufruhr  
rotate = rotieren  
safely = sicher  
scandal = der Skandal — Skandale  
scared = verängstigt  
scratch = der Kratzer — Kratzer  
screw = die Schraube — Schrauben  
sheep — sheep = das Schaf — Schafe  
shiny = glänzend  
silver = das Silber  
sister = die Schwester — Schwestern  
slogan = der Slogan — Slogans  
spiral = die Spirale — Spiralen  
sponge = der Schwamm — Schwämme  
spy = der Spion — Spione  
statue = die Statue — Statuen  
stimulus — stimuli = der Reiz — Reize  
structural = strukturell  
suppression = die Unterdrückung  
surplus = der Überschuss — Überschüsse  
suspend = aussetzen  
swoop = der Sturzflug — Sturzflüge  
tackle = das Tackle — Tackles  
tire = der Reifen — Reifen  
tourist = der Tourist — Touristen  
transformation = die Transformation — Transformationen  
tribal = Stammes-  
tropical = tropisch  
turning = das Drehen  
upper = oberer  
vaccination = die Impfung — Impfungen  
variable = die Variable — Variablen  
warning = die Warnung — Warnungen  
weekend = das Wochenende — Wochenenden  
wildfire = der Waldbrand — Waldbrände  
Arkansas = Arkansas  
canadians = die Kanadier  
Columbia = Kolumbien  
Iraq = der Irak  
Jerusalem = Jerusalem  
medicaid = Medicaid  
Minister = der Minister — Minister  
parliament = das Parlament — Parlamente  
Seattle = Seattle  
standing = stehend  
Western = westlich  
abandon = verlassen  
abroad = im Ausland  
academy = die Akademie — Akademien  
accelerate = beschleunigen  
acquire = erwerben  
admit = zugeben  
advertise = werben  
affluent = wohlhabend  
agent = der Agent — Agenten  
alien = der Außerirdische — Außerirdische  
allocate = zuweisen  
ambition = der Ehrgeiz  
anger = der Ärger  
announcement = die Ankündigung — Ankündigungen  
anticipate = vorwegnehmen  
assign = zuweisen  
attendant = der Begleiter — Begleiter  
automatically = automatisch  
bias = die Voreingenommenheit  
bidding = das Bieten  
blast = die Explosion — Explosionen  
breakfast = das Frühstück  
brutalist = brutalistisch  
buck = der Dollar — Dollar  
bull = der Bulle — Bullen  
calf — calves = das Kalb — Kälber  
casualty = der Verlust — Verluste  
chatbot = der Chatbot — Chatbots  
chatgpt = ChatGPT  
cheat = betrügen  
client = der Kunde — Kunden  
club = der Club — Clubs  
coastal = küstennah  
command = der Befehl — Befehle  
commonly = häufig  
complain = sich beschweren  
comprehensive = umfassend  
conclusion = der Schluss — Schlüsse  
conditioning = die Konditionierung  
congressional = kongressional  
conservation = die Erhaltung  
constitutional = verfassungsmäßig  
contestant = der Teilnehmer — Teilnehmer  
cop = der Polizist — Polizisten  
crush = zerdrücken  
crystal = der Kristall — Kristalle  
demographic = demografisch  
designate = bezeichnen  
destination = das Ziel — Ziele  
diabete = der Diabetes  
dip = der Dip — Dips  
disability = die Behinderung — Behinderungen  
divert = umleiten  
downtown = die Innenstadt  
draft = der Entwurf — Entwürfe  
drum = die Trommel — Trommeln  
dynamite = das Dynamit  
edit = bearbeiten  
efficiency = die Effizienz  
emotional = emotional  
entry = der Eintrag — Einträge  
ethical = ethisch  
exclusive = exklusiv  
excuse = die Entschuldigung — Entschuldigungen  
expel = ausweisen  
farmland = das Ackerland  
FBI = das FBI  
fee = die Gebühr — Gebühren  
flash = der Blitz — Blitze  
flashcard = die Lernkarte — Lernkarten  
formally = formell  
george = George  
gesture = die Geste — Gesten  
glory = der Ruhm  
got = bekam  
gothic = gotisch  
governance = die Regierungsführung  
grandfather = der Großvater — Großväter  
grandmother = die Großmutter — Großmütter  
hat = der Hut — Hüte  
Hawaii = Hawaii  
headphone = der Kopfhörer — Kopfhörer  
heal = heilen  
hop = der Sprung — Sprünge  
horse = das Pferd — Pferde  
hypothesis — hypotheses = die Hypothese — Hypothesen  
ignite = entzünden  
illustrate = illustrieren  
infrared = infrarot  
inherit = erben  
intervene = eingreifen  
knee = das Knie — Knie  
lap = die Runde — Runden  
laptop = der Laptop — Laptops  
lava = die Lava  
liberty = die Freiheit  
licensing = die Lizenzierung  
linear = linear  
loose = locker  
lunch = das Mittagessen  
marble = der Marmor  
marker = der Marker — Marker  
maximum = das Maximum  
microfauna = die Mikrofauna  
musician = der Musiker — Musiker  
mutate = mutieren  
mystery = das Geheimnis — Geheimnisse  
navigate = navigieren  
neck = der Hals — Hälse  
nervous = nervös  
newly = neu  
offside = abseits  
ongoing = laufend  
ownership = das Eigentum  
parkour = der Parkour  
paycheck = der Gehaltsscheck — Gehaltsschecks  
penetrate = durchdringen  
pew = die Kirchenbank — Kirchenbänke  
phrase = die Phrase — Phrasen  
piano = das Klavier — Klaviere  
poison = das Gift — Gifte  
poop = der Kot  
precise = präzise  
prefer = bevorzugen  
prevail = vorherrschen  
pseudoephedrine = das Pseudoephedrin  
raw = roh  
reasonable = vernünftig  
rebel = der Rebell — Rebellen  
reconstruction = der Wiederaufbau  
regard = die Hinsicht  
remarkable = bemerkenswert  
repeatedly = wiederholt  
replacement = der Ersatz  
reproduce = reproduzieren  
resign = zurücktreten  
rider = der Fahrer — Fahrer  
rodent = das Nagetier — Nagetiere  
sad = traurig  
scatter = verstreuen  
seasonal = saisonal  
sediment = das Sediment — Sedimente  
seemingly = scheinbar  
segregation = die Segregation  
sensitive = empfindlich  
shootout = der Schusswechsel  
shower = die Dusche — Duschen  
simulate = simulieren  
singe = ansengen  
sle = das SLE  
slope = die Steigung — Steigungen  
smoke = der Rauch  
stair = die Treppe — Treppen  
steady = stabil  
stylize = stilisieren  
succeed = erfolgreich sein  
suck = saugen  
supplement = das Supplement — Supplemente  
surprising = überraschend  
suspect = der Verdächtige — Verdächtige  
swarm = der Schwarm — Schwärme  
synthetic = synthetisch  
teaching = das Lehren  
textbook = das Lehrbuch — Lehrbücher  
thickness = die Dicke  
thus = somit  
tick = der Zeckenbiss — Zeckenbisse  
tower = der Turm — Türme  
traditionally = traditionell  
trash = der Müll  
tunnel = der Tunnel — Tunnel  
unity = die Einheit  
utility = der Nutzen  
veto = das Veto — Vetos  
volcano — volcanoes = der Vulkan — Vulkane  
wavelength = die Wellenlänge  
welfare = das Wohl  
wheel = das Rad — Räder  
whoever = wer auch immer  
wildly = wild  
wireless = drahtlos  
witness = der Zeuge — Zeugen