be — was; were — been = быть  
to = к  
and = и  
of = из  
in = в  
that = тот  
it = это  
have — had — had = иметь  
they = они  
you = ты  
this = этот  
we = мы  
for = для  
not = не  
but = но  
do — did — done = делать  
on = на  
like = как  
with = с  
so = так  
as = как  
from = от  
at = в  
one = один  
there = там  
can = мочь  
go — went — gone = идти  
more = больше  
all = все  
people = люди  
what = что  
make — made — made = делать  
get — got — got/gotten = получать  
just = просто  
by = у  
or = или  
their = их  
these = эти  
about = о  
if = если  
an = один  
he = он  
up = вверх  
when = когда  
know — knew — known = знать  
out = из  
would = будет  
which = который  
see — saw — seen = видеть  
how = как  
year = год  
time = время  
will = будет  
our = наш  
who = кто  
because = потому что  
look = смотреть  
use = использовать  
take — took — taken = брать  
way = путь  
into = в  
then = затем  
could = мог  
some = некоторые  
over = над  
other = другой  
where = где  
right = правильно  
really = действительно  
thing = вещь  
than = чем  
come — came — come = приходить  
here = здесь  
work = работать  
lot = много  
want = хотеть  
now = сейчас  
think — thought — thought = думать  
start = начинать  
also = также  
your = твой  
say — said — said = говорить  
my = мой  
country — countries = страна  
even = даже  
first = первый  
most = большинство  
very = очень  
his = его  
those = те  
no = нет  
call = звонить  
new = новый  
much = много  
big — bigger — biggest = большой  
its = его  
world = мир  
well = хорошо  
mean — meant — meant = значить  
back = назад  
need — needed — needed = нуждаться  
only = только  
many = много  
around = вокруг  
two = два  
change = менять  
state = государство  
actually = фактически  
after = после  
kind = вид  
become — became — become = становиться  
find — found — found = находить  
show — showed — shown = показывать  
still = всё ещё  
down = вниз  
something = что-то  
government = правительство  
good — better — best = хороший  
every = каждый  
help = помогать  
part = часть  
give — gave — given = давать  
different = разный  
day = день  
build — built — built = строить  
happen = случаться  
same = тот же  
through = через  
long = длинный  
music = музыка  
high = высокий  
why = почему  
try — tried — tried = пытаться  
water = вода  
end = конец  
before = до  
place = место  
company — companies = компания  
million = миллион  
home = дом  
keep — kept — kept = держать  
put — put — put = класть  
too = слишком  
city — cities = город  
system = система  
video = видео  
little = маленький  
any = любой  
she = она  
off = выключить  
between = между  
might = может  
live = жить  
power = сила  
today = сегодня  
create = создавать  
let — let — let = позволять  
few = несколько  
feel — felt — felt = чувствовать  
own = собственный  
move = двигаться  
life — lives = жизнь  
far = далеко  
land = земля  
money = деньги  
vote = голосовать  
another = другой  
point = точка  
law = закон  
should = должен  
pay — paid — paid = платить  
while = пока  
black = чёрный  
case = случай  
tell — told — told = говорить  
leave — left — left = уходить  
turn = поворачивать  
human = человек  
include = включать  
problem = проблема  
area = область  
close = близко  
China = Китай  
large = большой  
less = меньше  
name = имя  
line = линия  
three = три  
each = каждый  
next = следующий  
number = число  
story — stories = история  
group = группа  
virus = вирус  
thousand = тысяча  
woman — women = женщина  
hard = трудно  
since = с  
war = война  
talk = говорить  
force = сила  
lead — led — led = вести  
control = контролировать  
grow — grew — grown = расти  
low = низкий  
movie = фильм  
set — set — set = устанавливать  
question = вопрос  
support = поддерживать  
able = способный  
small = маленький  
last = последний  
light = свет  
study = учиться  
ask = спрашивать  
always = всегда  
bring — brought — brought = приносить  
school = школа  
design = дизайн  
often = часто  
pretty = красиво  
never = никогда  
sort = сортировать  
film = фильм  
image = изображение  
away = прочь  
real = реальный  
begin — began — begun = начинать  
almost = почти  
great = великий  
across = через  
both = оба  
play = играть  
sound = звук  
again = снова  
space = пространство  
early = рано  
election = выборы  
man — men = человек  
plan = план  
second = второй  
already = уже  
run — ran — run = бежать  
building = здание  
decade = десятилетие  
police = полиция  
public = общественный  
child — children = ребёнок  
hand = рука  
once = однажды  
plant = растение  
industry = промышленность  
level = уровень  
under = под  
important = важный  
job = работа  
old = старый  
against = против  
us = нас  
fight — fought — fought = бороться  
watch = смотреть  
energy = энергия  
reason = причина  
stop = останавливать  
datum — data = данные  
history = история  
win — won — won = побеждать  
person = человек  
enough = достаточно  
air = воздух  
hundred = сто  
population = население  
white = белый  
everything = всё  
idea = идея  
president = президент  
test = тест  
ever = когда-либо  
learn — learned/learnt — learned/learnt = учиться  
pass = проходить  
during = во время  
without = без  
face = лицо  
family — families = семья  
process = процесс  
bit = немного  
allow = позволять  
later = позже  
open = открывать  
probably = вероятно  
worker = рабочий  
hold — held — held = держать  
rate = ставка  
until = до  
basically = в основном  
vaccine = вакцина  
house = дом  
side = сторона  
party = партия  
understand — understood — understood = понимать  
community — communities = сообщество  
month — months = месяц  
whole = целый  
oil = нефть  
send — sent — sent = отправлять  
though = хотя  
model = модель  
sign = знак  
Russia = Россия  
bad — worse — worst = плохой  
team = команда  
type = тип  
hear — heard — heard = слышать  
photo = фото  
gas = газ  
top = верх  
military = военный  
nearly = почти  
cause = вызывать  
seem = казаться  
body — bodies = тело  
continue = продолжать  
example = пример  
instead = вместо  
maybe = возможно  
four = четыре  
hour = час  
protect = защищать  
lose — lost — lost = терять  
form = форма  
policy = политика  
easy = легко  
federal = федеральный  
hit — hit — hit = ударять  
thank = благодарить  
death = смерть  
game = игра  
rule = правило  
together = вместе  
behind = позади  
increase = увеличивать  
car = машина  
price = цена  
risk = риск  
whether = ли  
cost = стоить  
spend — spent — spent = тратить  
write — wrote — written = писать  
least = наименее  
possible = возможный  
project = проект  
Ukraine = Украина  
push = толкать  
train = поезд  
fast = быстро  
future = будущее  
half = половина  
die — died — died = умирать  
full = полный  
record = запись  
break — broke — broken = ломать  
business = бизнес  
clear = ясно  
figure = фигура  
base = база  
fall — fell — fallen = падать  
rise — rose — risen = подниматься  
cut — cut — cut = резать  
drive — drove — driven = вести  
fact = факт  
food = еда  
kill = убивать  
major = главный  
outside = снаружи  
add = добавлять  
ground = земля  
abortion = аборт  
attack = нападать  
report = сообщать  
result = результат  
sell — sold — sold = продавать  
market = рынок  
huge = огромный  
student = студент  
likely = вероятно  
term = срок  
along = вдоль  
check = проверять  
color = цвет  
her = её  
require = требовать  
technology = технология  
everyone = каждый  
political = политический  
care = забота  
century — centuries = век  
shoot — shot — shot = стрелять  
cover = покрывать  
develop = развивать  
buy — bought — bought = покупать  
decide = решать  
map = карта  
within = в пределах  
center = центр  
picture = картина  
effect = эффект  
reach = достигать  
believe = верить  
produce = производить  
someone = кто-то  
animal = животное  
issue = проблема  
Russian = русский  
amount = количество  
health = здоровье  
inside = внутри  
research = исследование  
may = май; мочь  
week = неделя  
climate = климат  
guy = парень  
sit — sat — sat = сидеть  
America = Америка  
head = голова  
ship = корабль  
spread — spread — spread = распространять  
access = доступ  
especially = особенно  
movement = движение  
past = прошлое  
sure = уверен  
anything = что угодно  
matter = дело  
planet = планета  
States = Штаты  
order = порядок  
answer = ответ  
consider = рассматривать  
exactly = точно  
five = пять  
pandemic = пандемия  
researcher = исследователь  
fire = огонь  
program = программа  
sometimes = иногда  
billion = миллиард  
common = общий  
dollar = доллар  
economy = экономика  
fuel = топливо  
travel = путешествовать  
course = курс  
deal = сделка  
scene = сцена  
free = свободный  
entire = весь  
love = любовь  
step = шаг  
provide = предоставлять  
stay = оставаться  
moment = момент  
soon = скоро  
word = слово  
focus = фокус  
middle = середина  
scientist = учёный  
stuff = вещи  
yet = ещё  
artist = художник  
mostly = в основном  
natural = естественный  
follow = следовать  
leader = лидер  
quickly = быстро  
solar = солнечный  
World = Мир  
act = действовать  
hope = надежда  
protest = протест  
region = регион  
speed = скорость  
voter = избиратель  
wave = волна  
single = одинокий  
deep = глубокий  
experience = опыт  
local = местный  
court = суд  
target = цель  
else = ещё  
member = член  
ban = запрет  
eventually = в конечном итоге  
impact = воздействие  
official = официальный  
player = игрок  
release = выпускать  
room = комната  
scale = масштаб  
camera = камера
chart = диаграмма  
decision = решение  
piece = кусок  
disease = болезнь  
capture = захватывать  
farmer = фермер  
fly — flew — flown = летать  
kid = ребёнок  
several = несколько  
office = офис  
shape = форма  
emission = выброс  
share = делиться  
short = короткий  
source = источник  
track = след  
young = молодой  
bill = счёт  
song = песня  
tree = дерево  
challenge = вызов  
either = любой  
exist = существовать  
pull = тянуть  
stand — stood — stood = стоять  
usually = обычно  
sense = чувство  
tool = инструмент  
wait = ждать  
farm = ферма  
production = производство  
similar = похожий  
gun = оружие  
key = ключ  
late = поздно  
raise = поднимать  
service = служба  
cloud = облако  
expert = эксперт  
frame = рамка  
front = перед  
global = глобальный  
machine = машина  
door = дверь  
drop = падать  
red = красный  
seat = сиденье  
computer = компьютер  
credit = кредит  
eye = глаз  
post = пост  
safe = безопасный  
save = спасать  
store = магазин  
benefit = выгода  
class = класс  
cool = крутой  
goal = цель  
heat = тепло  
meet — met — met = встречать  
position = позиция  
race = гонка  
certain = определённый  
compare = сравнивать  
economic = экономический  
income = доход  
national = национальный  
percent = процент  
star = звезда  
internet = интернет  
itself = себя  
nothing = ничего  
reduce = уменьшать  
ten = десять  
South = Юг  
majority = большинство  
massive = массивный  
remember = помнить  
sea = море  
shot = выстрел  
slow = медленно  
speak — spoke — spoken = говорить  
strong = сильный  
Earth = Земля  
feature = особенность  
forest = лес  
solution = решение  
street = улица  
supply = поставка  
account = счёт  
ago = назад  
average = средний  
dog = собака  
information = информация  
language = язык  
measure = мера  
night = ночь  
simple = простой  
social = социальный  
North = Север  
difference = различие  
finally = наконец  
agree = соглашаться  
nation = нация  
Congress = Конгресс  
demand = требовать  
district = район  
road = дорога  
sick = больной  
such = такой  
tax = налог  
true = правда  
evidence = доказательство  
offer = предлагать  
per = за  
completely = полностью  
event = событие  
sport = спорт  
themselves = себя  
union = союз  
wear — wore — worn = носить  
yes = да  
choice = выбор  
claim = утверждать  
list = список  
ocean = океан  
pick = выбирать  
product = продукт  
remain = оставаться  
Europe = Европа  
book = книга  
catch — caught — caught = ловить  
eat — ate — eaten = есть  
flu = грипп  
foot — feet = нога  
housing = жильё  
mile = миля  
powerful = мощный  
represent = представлять  
ton = тонна  
among = среди  
British = британский  
crisis = кризис  
limit = предел  
main = главный  
read — read — read = читать  
size = размер  
approach = подход  
explain = объяснять  
interest = интерес  
rich = богатый  
accord = соглашение  
burn — burned/burnt — burned/burnt = гореть  
green = зелёный  
material = материал  
pressure = давление  
quite = довольно  
recognize = узнавать  
town = город  
Germany = Германия  
anyone = кто угодно  
art = искусство  
border = граница  
civil = гражданский  
imagine = представлять  
near = около  
six = шесть  
weapon = оружие  
California = Калифорния  
carry = нести  
choose — chose — chosen = выбирать  
expect = ожидать  
flight = полёт  
resource = ресурс  
return = возвращаться  
charge = заряд  
prevent = предотвращать  
ad = реклама  
field = поле  
individual = индивидуальный  
link = связь  
specific = конкретный  
walk = ходить  
ball = мяч  
couple = пара  
democracy = демократия  
development = развитие  
generate = генерировать  
native = родной  
site = сайт  
third = третий  
brain = мозг  
carbon = углерод  
cell = клетка  
coronavirus = коронавирус  
dangerous = опасный  
inflation = инфляция  
influence = влияние  
screen = экран  
TV = телевизор  
window = окно  
wrong = неправильно  
bunch = куча  
environment = окружающая среда  
mail = почта  
mask = маска  
notice = замечать  
officer = офицер  
perfect = идеальный  
shift = смена  
candidate = кандидат  
fund = фонд  
news = новости  
phone = телефон  
receive = получать  
rest = отдых  
surface = поверхность  
um = гм  
chance = шанс  
difficult = трудный  
flow = поток  
miss = пропускать  
view = вид  
drug = лекарство  
expensive = дорогой  
particular = особый  
replace = заменять  
block = блок  
fat = жир  
wall = стена  
Mao = Мао  
degree = степень  
enter = входить  
motion = движение  
neighborhood = соседство  
period = период  
river = река  
troop = войска  
wind = ветер  
age = возраст  
bear — bore — borne = нести  
condition = условие  
fossil = ископаемое  
highway = шоссе  
layer = слой  
minute = минута  
opportunity = возможность  
serve = служить  
weather = погода  
background = фон  
beginning = начало  
former = бывший  
legal = законный  
mass = масса  
medium = среда  
spot = пятно  
establish = устанавливать  
fish = рыба  
friend = друг  
online = онлайн  
paper = бумага  
realize = осознавать  
wage = зарплата  
blue = синий  
Chinese = китайский  
cold = холодный  
draw — drew — drawn = рисовать  
final = финальный  
location = местоположение  
throughout = на протяжении  
blood = кровь  
driver = водитель  
electricity = электричество  
fill = наполнять  
option = вариант  
outbreak = вспышка  
practice = практика  
rock = рок  
standard = стандарт  
storm = шторм  
threat = угроза  
cheap = дешёвый  
pattern = узор  
plane = самолёт  
popular = популярный  
private = частный  
teach — taught — taught = учить  
unique = уникальный  
agency = агентство  
college = колледж  
everywhere = везде  
launch = запуск  
nuclear = ядерный  
range = диапазон  
remove = удалять  
resident = житель  
response = ответ  
structure = структура  
village = деревня  
weird = странный  
ability = способность  
culture = культура  
foreign = иностранный  
match = матч  
museum = музей  
passenger = пассажир  
situation = ситуация  
soil = почва  
Republicans = республиканцы  
alone = один  
basic = базовый  
current = текущий  
ice = лёд  
island = остров  
politician = политик  
taxis = такси  
temperature = температура  
truck = грузовик  
India = Индия  
bird = птица  
gain = получать  
infrastructure = инфраструктура  
meter = метр  
roughly = примерно  
stick — stuck — stuck = прилипать  
style = стиль  
warm = тёплый  
Texas = Техас  
clean = чистый  
debt = долг  
factor = фактор  
literally = буквально  
must = должен  
non = не  
object = объект  
original = оригинальный  
oxygen = кислород  
recent = недавний  
safety = безопасность  
sample = образец  
specie = вид  
teacher = учитель  
waste = отходы  
Afghanistan = Афганистан  
Canada = Канада  
above = выше  
action = действие  
ally = союзник  
ballot = бюллетень  
box = коробка  
chemical = химический  
chip = чип  
concern = забота  
conflict = конфликт  
definitely = определённо  
double = двойной  
episode = эпизод  
label = ярлык  
promise = обещание  
relationship = отношения  
role = роль  
series = серия  
sky = небо  
stage = сцена  
super = супер  
Portuguese = португальский  
Taliban = Талибан  
campaign = кампания  
destroy = разрушать  
direction = направление  
extremely = чрезвычайно  
generation = поколение  
hospital = больница  
identify = определять  
indigenous = коренной  
mountain = гора  
organization = организация  
protection = защита  
pump = насос  
somebody = кто-то  
strategy = стратегия  
strike — struck — struck = ударять  
suppose = предполагать  
trial = испытание  
weight = вес  
worth = стоимость  
capital = столица  
dark = тёмный  
judge = судья  
message = сообщение  
pool = бассейн  
straight = прямой  
violence = насилие  
affect = влиять  
appear = появляться  
chair = стул  
count = считать  
floor = пол  
hot = горячий  
plus = плюс  
security = безопасность  
struggle = борьба  
ultimately = в конечном итоге  
voting = голосование  
wood = дерево  
zero = ноль  
attention = внимание  
baby = младенец  
board = доска  
directly = напрямую  
expand = расширять  
glass = стекло  
kick = удар  
letter = письмо  
paint = краска  
poll = опрос  
survey = обзор  
zone = зона  
West = Запад  
damage = ущерб  
digital = цифровой  
funding = финансирование  
giant = гигант  
guess = угадывать  
involve = вовлекать  
join = присоединяться  
potential = потенциал  
ready = готовый  
Republican = республиканский  
Soviet = советский  
special = особый  
studio = студия  
total = общий  
typically = обычно  
value = ценность  
beautiful = красивый  
character = характер  
depend = зависеть  
egg = яйцо  
essentially = существенно  
everybody = все  
gap = разрыв  
heavy = тяжёлый  
poor = бедный  
sun = солнце  
version = версия  
Christmas = Рождество  
administration = администрация  
anti = анти  
apart = отдельно  
budget = бюджет  
concrete = бетон  
dead = мёртвый  
distance = расстояние  
feed — fed — fed = кормить  
financial = финансовый  
fit — fit — fit = подходить  
forward = вперёд  
introduce = представлять  
onto = на  
painting = картина  
profit = прибыль  
rain = дождь  
shut — shut — shut = закрывать  
tiny = крошечный  
Democrats = демократы  
athlete = спортсмен  
bomb = бомба  
complex = сложный  
detail = деталь  
due = из-за  
education = образование  
park = парк  
rely = полагаться  
separate = отделять  
towards = к  
voice = голос  
whatever = что угодно  
announce = объявлять  
civilian = гражданский  
dozen = дюжина  
effort = усилие  
entirely = полностью  
growth = рост  
labor = труд  
left = левый  
plastic = пластик  
present = подарок  
south = юг  
suggest = предлагать  
surround = окружать  
tank = танк  
wide = широкий  
Disney = Дисней  
Union = Союз  
atmosphere = атмосфера  
below = ниже  
complete = завершать  
consumer = потребитель  
describe = описывать
email = электронная почта  
facility = объект  
hey = привет  
interesting = интересный  
international = международный  
manage = управлять  
mind = разум  
multiple = множественный  
stock = запас  
tip = совет  
treat = лечить  
activist = активист  
attempt = попытка  
beyond = за пределами  
bottom = низ  
complicated = сложный  
construction = строительство  
desert = пустыня  
electric = электрический  
era = эра  
famous = знаменитый  
general = общий  
listen = слушать  
mine = мой; шахта  
particularly = особенно  
restaurant = ресторан  
search = поиск  
visit = посещать  
bank = банк  
contact = контакт  
cross = пересекать  
effective = эффективный  
factory = фабрика  
fingerprint = отпечаток пальца  
jump = прыгать  
kilometer = километр  
milk = молоко  
quality = качество  
section = раздел  
skin = кожа  
summer = лето  
viral = вирусный  
website = веб-сайт  
Court = Суд  
Korea = Корея  
bar = бар  
cow = корова  
crop = урожай  
doctor = доктор  
fail = провалиться  
fear = страх  
invest = инвестировать  
journey = путешествие  
loss = потеря  
obviously = очевидно  
purpose = цель  
science = наука  
score = счёт  
station = станция  
text = текст  
Ukrainian = украинский  
vehicle = транспортное средство  
actual = фактический  
angle = угол  
army = армия  
contain = содержать  
extreme = экстремальный  
getting = получение  
height = высота  
host = хозяин  
increasingly = всё больше  
loan = заём  
photography = фотография  
producer = продюсер  
prove = доказывать  
rather = скорее  
specifically = конкретно  
steel = сталь  
throw — threw — thrown = бросать  
address = адрес  
amazing = удивительный  
applause = аплодисменты  
arrest = арест  
available = доступный  
brand = бренд  
collect = собирать  
connect = соединять  
designer = дизайнер  
estimate = оценивать  
hotel = отель  
interview = интервью  
path = путь  
recently = недавно  
relate = относиться  
rural = сельский  
season = сезон  
theater = театр  
wonder = чудо  
chain = цепь  
document = документ  
grid = сетка  
impossible = невозможный  
maintain = поддерживать  
protester = протестующий  
sale = продажа  
tend = склоняться  
training = обучение  
anymore = больше не  
anywhere = где угодно  
approve = одобрять  
audience = аудитория  
elect = избирать  
element = элемент  
forever = навсегда  
lie — lay — lain = лежать  
morning = утро  
north = север  
nurse = медсестра  
owner = владелец  
significant = значительный  
society = общество  
visual = визуальный  
Supreme = Верховный  
Taiwan = Тайвань  
currently = в настоящее время  
favorite = любимый  
fix = чинить  
inspire = вдохновлять  
lay — laid — laid = класть  
mix = смешивать  
necessarily = обязательно  
parent = родитель  
potentially = потенциально  
property = собственность  
ride — rode — ridden = ехать  
serious = серьёзный  
solve = решать  
sponsor = спонсор  
totally = полностью  
united = объединённый  
winter = зима  
Brazil = Бразилия  
British = британский  
circle = круг  
conservative = консервативный  
cultural = культурный  
dig — dug — dug = копать  
environmental = экологический  
fair = справедливый  
generally = в общем  
lack = недостаток  
normal = нормальный  
predict = предсказывать  
respond = отвечать  
soldier = солдат  
somewhere = где-то  
square = квадрат  
switch = переключать  
trade = торговля  
code = код  
collapse = обрушение  
combine = комбинировать  
crime = преступление  
cycle = цикл  
deadly = смертельный  
department = отдел  
direct = прямой  
fake = поддельный  
fluoride = фторид  
mark = метка  
medical = медицинский  
regime = режим  
seven = семь  
simply = просто  
suddenly = внезапно  
survive = выживать  
traditional = традиционный  
East = Восток  
London = Лондон  
university = университет  
actor = актёр  
agreement = соглашение  
apply = применять  
balance = баланс  
container = контейнер  
content = содержание  
description = описание  
heart = сердце  
immediately = немедленно  
investment = инвестиция  
meat = мясо  
method = метод  
network = сеть  
nice = приятный  
organize = организовывать  
please = пожалуйста  
press = пресса  
professor = профессор  
rail = рельс  
technique = техника  
tie = связывать  
whose = чей  
Israel = Израиль  
March = март  
app = приложение  
brown = коричневый  
citizen = гражданин  
clearly = ясно  
extra = дополнительный  
file = файл  
German = немецкий  
historic = исторический  
investigation = расследование  
Iran = Иран  
justice = справедливость  
largely = в основном  
modern = современный  
noise = шум  
overall = в целом  
patient = пациент  
phase = фаза  
pop = поп  
professional = профессиональный  
reality = реальность  
signal = сигнал  
slightly = слегка  
testing = тестирование  
trail = тропа  
wealthy = богатый  
worry = беспокоиться  
arrive = прибывать  
article = статья  
blow — blew — blown = дуть  
certainly = конечно  
date = дата  
debate = дебаты  
determine = определять  
dream = мечта  
employee = сотрудник  
equipment = оборудование  
healthy = здоровый  
loop = петля  
mining = добыча  
none = никакой  
panel = панель  
pose = позировать  
seek — sought — sought = искать  
states = штаты  
wealth = богатство  
western = западный  
Pakistan = Пакистан  
absolutely = абсолютно  
beat — beat — beaten = бить  
boy = мальчик  
category = категория  
commercial = коммерческий  
daily = ежедневный  
declare = объявлять  
deeply = глубоко  
emerge = появляться  
European = европейский  
experiment = эксперимент  
freedom = свобода  
personal = личный  
perspective = перспектива  
pipeline = трубопровод  
reserve = резерв  
successful = успешный  
trace = след  
trust = доверять  
west = запад  
album = альбом  
argue = спорить  
avoid = избегать  
boom = бум  
cement = цемент  
democratic = демократический  
despite = несмотря на  
familiar = знакомый  
flood = наводнение  
gear = снаряжение  
hide — hid — hidden = прятать  
himself = себя  
improve = улучшать  
incredible = невероятный  
marijuana = марихуана  
minimum = минимум  
note = заметка  
operate = управлять  
platform = платформа  
politic = политика  
portrait = портрет  
publish = публиковать  
reform = реформа  
relatively = относительно  
renewable = возобновляемый  
severe = суровый  
sleep — slept — slept = спать  
tear — tore — torn = рвать  
trend = тенденция  
trip = поездка  
unemployment = безработица  
vast = обширный  
vision = видение  
yourself = себя  
cup = чашка  
acre = акр  
adult = взрослый  
animation = анимация  
bat = летучая мышь  
central = центральный  
divide = делить  
eight = восемь  
hire = нанимать  
hole = дыра  
incredibly = невероятно  
infect = заражать  
nearby = поблизости  
net = сеть  
percentage = процент  
print = печатать  
propose = предлагать  
protein = белок  
review = обзор  
success = успех  
truth = правда  
band = группа  
basis = основа  
cluster = кластер  
conversation = разговор  
crash = авария  
fan = фанат  
farming = фермерство  
folk = народ  
fully = полностью  
fun = веселье  
handle = ручка  
happy = счастливый  
jet = реактивный  
leadership = лидерство  
learning = обучение  
lens = линза  
lock = замок  
nature = природа  
positive = позитивный  
prepare = готовить  
preserve = сохранять  
racial = расовый  
skater = скейтер  
tech = технология  
territory = территория  
transition = переход  
January = январь  
October = октябрь  
Washington = Вашингтон  
contract = контракт  
discover = обнаруживать  
expose = разоблачать  
favor = благосклонность  
finish = заканчивать  
gather = собирать  
immune = иммунный  
Indian = индийский  
intelligence = интеллект  
leg = нога  
mother = мать  
parking = парковка  
presidential = президентский  
primarily = в первую очередь  
rubber = резина  
shop = магазин  
spike = шип  
tall = высокий  
threaten = угрожать  
trouble = беда  
May = май  
Mexico = Мексика  
airline = авиалиния  
arm = рука  
artificial = искусственный  
battery = батарея  
click = клик  
column = колонна  
Congress = Конгресс  
consequence = последствие  
crew = экипаж  
deny = отрицать  
director = директор  
dry = сухой  
easily = легко  
enemy = враг  
industrial = промышленный  
journalist = журналист  
myself = себя  
nobody = никто  
operation = операция  
possibility = возможность  
representative = представитель  
request = запрос  
reverse = обратный  
sink — sank — sunk = тонуть  
suffer = страдать  
tennis = теннис  
trailer = трейлер  
transform = трансформировать  
user = пользователь  
soul = душа  
activity = активность  
conduct = проводить  
corner = угол  
curve = кривая  
decline = снижение  
deliver = доставлять  
drag = тащить  
enforce = обеспечивать  
father = отец  
football = футбол  
highly = высоко  
interact = взаимодействовать  
legacy = наследие  
rare = редкий  
slowly = медленно  
snow = снег  
telescope = телескоп  
theory = теория  
universal = универсальный  
unlike = в отличие  
wild = дикий  
February = февраль  
Indian = индийский  
Japan = Япония  
ahead = впереди  
battle = битва  
broad = широкий  
canal = канал  
cattle = скот  
clip = клип  
coast = побережье  
committee = комитет  
electoral = избирательный  
empty = пустой  
flee — fled — fled = бежать  
god = бог  
grade = класс  
grant = грант  
guard = охрана  
hang — hung — hung = висеть  
infection = инфекция  
interested = заинтересованный  
invasion = вторжение  
living = живой  
metal = металл  
obvious = очевидный  
occur = происходить  
prompt = побуждать  
rainforest = тропический лес  
responsible = ответственный  
revolution = революция  
round = круглый  
route = маршрут  
settlement = поселение  
stream = поток  
suit = костюм  
symptom = симптом  
touch = касаться  
treatment = лечение  
various = различный  
April = апрель  
affordable = доступный  
beach = пляж  
bond = связь  
boost = усиливать  
card = карта  
coal = уголь  
combination = комбинация  
contribute = способствовать  
corruption = коррупция  
crazy = сумасшедший  
data = данные  
defend = защищать  
effectively = эффективно  
encourage = поощрять  
engineer = инженер  
except = кроме  
fine = хороший  
footage = кадры  
Hawaiian = гавайский  
illegal = незаконный  
importantly = важно  
independence = независимость  
landscape = пейзаж  
loon = гагара  
marketing = маркетинг  
moose = лось  
neighbor = сосед  
oppose = противостоять  
peak = пик  
pitch = подача  
poverty = бедность  
repeat = повторять
self = себя  
spirit = дух  
tension = напряжение  
trick = трюк  
urban = городской  
volume = объём  
apartment = квартира  
barrier = барьер  
bid = ставка  
celebrate = праздновать  
cheese = сыр  
communist = коммунистический  
define = определять  
edge = край  
explosion = взрыв  
exposure = воздействие  
function = функция  
gold = золото  
harm = вред  
invade = вторгаться  
king = король  
knowledge = знание  
legislation = законодательство  
mention = упоминать  
mid = середина  
mirror = зеркало  
page = страница  
photograph = фотография  
pro = профессионал  
recommend = рекомендовать  
roll = катить  
symbol = символ  
tradition = традиция  
truly = истинно  
twice = дважды  
Palestinians = палестинцы  
wright = мастер  
additional = дополнительный  
African = африканский  
algorithm = алгоритм  
anybody = кто угодно  
attract = привлекать  
church = церковь  
copy = копия  
dot = точка  
drink — drank — drunk = пить  
hair = волосы  
hog = свинья  
hurdle = препятствие  
independent = независимый  
Jewish = еврейский  
mental = умственный  
necessary = необходимый  
photographer = фотограф  
pipe = труба  
portion = часть  
promote = продвигать  
quarantine = карантин  
regulation = регулирование  
spark = искра  
spin = вращать  
table = стол  
task = задача  
traffic = движение  
versus = против  
wildlife = дикая природа  
wolf = волк  
Palestine = Палестина  
adopt = принимать  
advantage = преимущество  
alliance = союз  
annual = ежегодный  
campus = кампус  
chicken = курица  
compete = соревноваться  
context = контекст  
counter = счётчик  
county = округ  
exact = точный  
French = французский  
inch = дюйм  
investor = инвестор  
lift = поднимать  
lower = ниже  
melt = плавить  
negative = отрицательный  
nowhere = нигде  
particle = частица  
partner = партнёр  
poster = плакат  
poultry = птица  
prison = тюрьма  
reference = ссылка  
sperm = сперма  
spring = весна  
steal — stole — stolen = красть  
subject = предмет  
transfer = передача  
underground = подземный  
willing = готовый  
zoo = зоопарк  
republic = республика  
Sudan = Судан  
achieve = достигать  
advanced = продвинутый  
cancer = рак  
cash = наличные  
chase = преследовать  
comment = комментарий  
concept = концепция  
customer = клиент  
dramatically = драматично  
ecosystem = экосистема  
employer = работодатель  
ensure = обеспечивать  
explore = исследовать  
feeling = чувство  
flat = плоский  
grass = трава  
item = предмет  
muscle = мышца  
occupy = занимать  
ourselves = себя  
panther = пантера  
peace = мир  
performance = представление  
reflect = отражать  
replicate = копировать  
responsibility = ответственность  
satellite = спутник  
scan = сканировать  
sex = пол  
smooth = гладкий  
transportation = транспортировка  
unit = единица  
Cairo = Каир  
crown = корона  
queen = королева  
acknowledge = признавать  
advance = продвигаться  
assist = помогать  
authority = власть  
baseball = бейсбол  
breed = порода  
criminal = преступник  
deforestation = вырубка лесов  
extend = расширять  
identity = идентичность  
immunity = иммунитет  
institution = учреждение  
journalism = журналистика  
lawsuit = судебный процесс  
loud = громкий  
membership = членство  
memory = память  
mutation = мутация  
Napoleon = Наполеон  
newspaper = газета  
participate = участвовать  
pilot = пилот  
pollution = загрязнение  
possibly = возможно  
radio = радио  
railroad = железная дорога  
refuse = отказываться  
regular = регулярный  
regulate = регулировать  
retirement = пенсия  
reveal = раскрывать  
secure = безопасный  
shooting = стрельба  
stretch = растягивать  
strict = строгий  
sudden = внезапный  
tap = кран  
transit = транзит  
universe = вселенная  
useful = полезный  
August = август  
Chicago = Чикаго  
Everest = Эверест  
Philippines = Филиппины  
aim = цель  
airplane = самолёт  
approval = одобрение  
associate = ассоциировать  
brutal = жестокий  
camp = лагерь  
collection = коллекция  
competition = конкуренция  
confirm = подтверждать  
corporation = корпорация  
correct = правильный  
critical = критический  
crucial = решающий  
disaster = катастрофа  
emit = излучать  
engage = вовлекать  
evolve = развиваться  
filmmaker = режиссёр  
gender = пол  
guarantee = гарантия  
guide = руководство  
historical = исторический  
illness = болезнь  
knife — knives = нож  
liquid = жидкость  
male = мужской  
management = управление  
march = маршировать  
mission = миссия  
moon = луна  
murder = убийство  
normally = нормально  
pedestrian = пешеход  
perfectly = идеально  
quick = быстрый  
reaction = реакция  
senate = сенат  
software = программное обеспечение  
somehow = как-то  
southern = южный  
speech = речь  
sue = судиться  
Kashmir = Кашмир  
agriculture = сельское хозяйство  
architect = архитектор  
bright = яркий  
capacity = вместимость  
cast = бросать  
channel = канал  
climb = взбираться  
comfortable = удобный  
contribution = вклад  
destruction = разрушение  
distribute = распределять  
efficient = эффективный  
eliminate = устранять  
export = экспорт  
fold = складывать  
forecast = прогноз  
forget — forgot — forgotten = забывать  
grocery = бакалея  
iron = железо  
lake = озеро  
miniature = миниатюра  
munition = боеприпасы  
officially = официально  
overdose = передозировка  
pack = упаковка  
pair = пара  
payment = платёж  
perform = исполнять  
permanent = постоянный  
pickleball = пиклбол  
presence = присутствие  
refer = ссылаться  
remote = удалённый  
royal = королевский  
settle = урегулировать  
skill = навык  
split = раскалывать  
successfully = успешно  
surprise = сюрприз  
tough = жёсткий  
trap = ловушка  
typeface = шрифт  
underneath = под  
unprecedented = беспрецедентный  
wife = жена  
September = сентябрь  
Valley = долина  
Yemen = Йемен  
ancient = древний  
bind — bound — bound = связывать  
bounce = отскакивать  
census = перепись  
concerned = обеспокоенный  
core = ядро  
corona = корона  
dance = танец  
devastating = разрушительный  
device = устройство  
dose = доза  
fairly = справедливо  
fighter = боец  
Filipino = филиппинский  
grab = хватать  
habitat = среда обитания  
lawn = газон  
Lebanon = Ливан  
manufacturing = производство  
nationwide = общенациональный  
oyster = устрица  
physical = физический  
pound = фунт  
profitable = прибыльный  
progress = прогресс  
quarter = четверть  
register = регистрировать  
reporting = отчётность  
respect = уважение  
seismic = сейсмический  
shortage = нехватка  
stadium = стадион  
trigger = спусковой крючок  
upon = на  
wake — woke — woken = просыпаться  
yellow = жёлтый  
Cape = мыс  
July = июль  
June = июнь  
Madagascar = Мадагаскар  
November = ноябрь  
accurate = точный  
afford = позволить  
alive = живой  
although = хотя  
amendment = поправка  
bike = велосипед  
birth = рождение  
bungalow = бунгало  
connection = связь  
constantly = постоянно  
crack = трещина  
custom = обычай  
dairy = молочный  
defense = защита  
detainee = задержанный  
differently = по-разному  
discrimination = дискриминация  
equal = равный  
famine = голод  
girl = девочка  
gravity = гравитация  
grouse = тетерев  
hate = ненавидеть  
hydrogen = водород  
ideal = идеальный  
invent = изобретать  
investigate = расследовать  
isolate = изолировать  
lady = дама  
length = длина  
lighting = освещение  
load = нагрузка  
lockdown = локдаун  
magazine = журнал  
mainly = главным образом  
mainstream = мейнстрим  
migrant = мигрант  
minority = меньшинство  
nose = нос  
orange = оранжевый  
outcome = результат  
ozone = озон  
perhaps = возможно  
pre = до  
prime = главный  
principle = принцип  
quote = цитата  
racism = расизм  
rating = рейтинг  
rent = аренда  
sage = шалфей  
scary = страшный  
secret = секрет  
senator = сенатор  
shipping = доставка  
stake = ставка  
stewardess = стюардесса  
storage = хранение  
substance = вещество  
toward = к  
unless = если не  
France = Франция  
Russians = русские  
Stanford = Стэнфорд  
Uruguay = Уругвай  
accept = принимать  
aid = помощь  
aircraft = самолёт  
Arab = арабский  
Augustine = Августин  
author = автор  
Azerbaijan = Азербайджан  
bacteria = бактерии  
became = стал  
belong = принадлежать  
bombing = бомбардировка  
clothing = одежда  
consume = потреблять  
cough = кашель  
creation = создание  
decrease = уменьшать  
demonstration = демонстрация  
earthquake = землетрясение  
expansion = расширение  
fighting = борьба  
flip = переворачивать  
float = плавать  
further = дальше  
gallon = галлон  
graphic = графика  
greenhouse = теплица  
Hampton = Хэмптон  
hero = герой  
highlight = выделять  
hunt = охотиться  
inequality = неравенство  
instrument = инструмент  
lab = лаборатория  
lesson = урок  
locate = находить  
methane = метан  
mimic = подражать  
naturally = естественно  
nest = гнездо  
nine = девять  
opening = открытие  
physics = физика  
postcard = открытка  
previous = предыдущий  
realistic = реалистичный  
restore = восстанавливать  
ring = кольцо  
row = ряд  
scenario = сценарий  
sequence = последовательность  
setting = настройка  
shadow = тень  
shout = кричать  
suicide = самоубийство  
swing = качаться  
tactic = тактика  
television = телевидение  
thinking = мышление  
translate = переводить  
typical = типичный  
variety = разнообразие  
victory = победа  
welcome = добро пожаловать  
Britain = Британия  
Island = Остров  
Pennsylvania = Пенсильвания  
Poland = Польша  
Space = Космос  
Ukrainians = украинцы  
absorb = поглощать  
agricultural = сельскохозяйственный  
apple = яблоко  
architecture = архитектура  
aside = в сторону  
auction = аукцион  
barely = едва  
branch = ветвь  
career = карьера  
ceiling = потолок  
comparison = сравнение  
creative = творческий  
curious = любопытный  
delay = задержка  
disappear = исчезать  
droplet = капля  
editorial = редакционный  
empire = империя  
employment = занятость  
excited = взволнованный  
fade = исчезать  
flooding = наводнение  
helpful = полезный  
household = домашний  
iconic = знаковый  
implement = внедрять  
initial = начальный  
intense = интенсивный  
Japanese = японский  
laser = лазер  
league = лига  
lighthouse = маяк  
medal = медаль  
meeting = встреча  
mistake = ошибка  
mom = мама  
obstacle = препятствие  
opposite = противоположный  
physically = физически  
polling = опрос  
prop = опора  
rancher = ранчер  
reject = отклонять  
religious = религиозный  
residential = жилой  
restriction = ограничение  
roof = крыша  
seriously = серьёзно  
shine = сиять  
significantly = значительно  
sled = сани  
son = сын
sorry = извини  
supporter = сторонник  
volunteer = волонтёр  
vulnerable = уязвимый  
widespread = широко распространённый  
wing = крыло  
worried = обеспокоенный  
Georgia = Грузия  
Senate = Сенат  
active = активный  
adjust = регулировать  
advertising = реклама  
analyze = анализировать  
application = приложение  
armed = вооружённый  
Armenia = Армения  
basement = подвал  
bed = кровать  
beef = говядина  
belief = вера  
bite — bit — bitten = кусать  
breathe = дышать  
chapter = глава  
coalition = коалиция  
coaster = подставка  
commit = совершать  
communicate = общаться  
consistently = последовательно  
constitution = конституция  
convince = убеждать  
corporate = корпоративный  
dataset = набор данных  
dementia = деменция  
dominate = доминировать  
dramatic = драматический  
earn = зарабатывать  
enforcement = принуждение  
engine = двигатель  
essential = существенный  
exchange = обмен  
executive = исполнительный  
exercise = упражнение  
female = женский  
font = шрифт  
friendly = дружелюбный  
fruit = фрукт  
governor = губернатор  
honestly = честно  
horror = ужас  
joy = радость  
lane = полоса  
lifetime = lifetime  
meanwhile = тем временем  
minister = министр  
narrow = узкий  
overlap = перекрытие  
pig = свинья  
plate = тарелка  
prediction = предсказание  
punch = удар  
rapidly = быстро  
rebuild = перестраивать  
reef = риф  
rid = избавляться  
ruling = правящий  
shoulder = плечо  
signature = подпись  
skyrocket = резко расти  
soft = мягкий  
spray = спрей  
status = статус  
terrorist = террорист  
transmission = передача  
trucker = дальнобойщик  
turbine = турбина  
vaccinate = вакцинировать  
variation = вариация  
vary = варьироваться  
violent = жестокий  
widely = широко  
Australia = Австралия  
God = Бог  
Italy = Италия  
Manhattan = Манхэттен  
abuse = злоупотребление  
analysis = анализ  
assume = предполагать  
backyard = задний двор  
behavior = поведение  
being = существо  
boat = лодка  
bone = кость  
bus = автобус  
classic = классический  
coat = пальто  
colleague = коллега  
colonial = колониальный  
communication = коммуникация  
convert = преобразовывать  
coverage = покрытие  
critic = критик  
dam = плотина  
developer = разработчик  
displacement = смещение  
division = деление  
dress = платье  
dynamic = динамичный  
ear = ухо  
elite = элита  
emergency = чрезвычайная ситуация  
employ = нанимать  
explanation = объяснение  
flag = флаг  
flower = цветок  
found = основывать  
foundation = основа  
genetic = генетический  
gentleman = джентльмен  
gray = серый  
historically = исторически  
hurricane = ураган  
immigration = иммиграция  
import = импорт  
initially = изначально  
margin = маржа  
measurement = измерение  
militia = ополчение  
monitor = монитор  
moral = моральный  
northern = северный  
opioid = опиоид  
package = пакет  
patch = заплатка  
perceive = воспринимать  
pill = таблетка  
port = порт  
pregnancy = беременность  
primary = первичный  
remind = напоминать  
revenue = доход  
root = корень  
sanction = санкция  
select = выбирать  
shake — shook — shaken = трясти  
shrink — shrank — shrunk = сжиматься  
statement = заявление  
strange = странный  
surge = всплеск  
sweep — swept — swept = мести  
tag = метка  
tanker = танкер  
technical = технический  
tight = плотный  
timber = древесина  
tone = тон  
topic = тема  
tour = тур  
tricky = сложный  
vice = порок  
wash = мыть  
wire = провод  
England = Англия  
grand = грандиозный  
Service = служба  
advocate = адвокат  
aggressive = агрессивный  
anyway = в любом случае  
axis = ось  
balloon = воздушный шар  
beaver = бобр  
bridge = мост  
chant = скандировать  
crowd = толпа  
dad = папа  
dense = плотный  
diet = диета  
domestic = домашний  
doubt = сомнение  
editor = редактор  
electronic = электронный  
elsewhere = в другом месте  
enable = включать  
engineering = инженерия  
enjoy = наслаждаться  
estate = недвижимость  
ethnic = этнический  
exploit = эксплуатировать  
extract = извлекать  
fellow = товарищ  
founder = основатель  
frequency = частота  
garden = сад  
hurt = боль  
imagery = образы  
insurance = страховка  
interaction = взаимодействие  
invisible = невидимый  
limited = ограниченный  
meteorite = метеорит  
molecule = молекула  
opinion = мнение  
otherwise = иначе  
parallel = параллельный  
partly = частично  
pathogen = патоген  
pile = куча  
presidency = президентство  
priority = приоритет  
processing = обработка  
propaganda = пропаганда  
qualified = квалифицированный  
random = случайный  
recession = рецессия  
refugee = беженец  
regardless = независимо  
removal = удаление  
reporter = репортёр  
requirement = требование  
resistance = сопротивление  
sector = сектор  
seize = захватывать  
shield = щит  
shirt = рубашка  
shutdown = закрытие  
slavery = рабство  
stable = стабильный  
strength = сила  
strengthen = укреплять  
swim — swam — swum = плавать  
ticket = билет  
unfortunately = к сожалению  
unusual = необычный  
warming = потепление  
bay = залив  
December = декабрь  
Egypt = Египет  
English = английский  
Jakarta = Джакарта  
monopoly = монополия  
spider = паук  
addition = добавление  
alternative = альтернатива  
appeal = апелляция  
appearance = появление  
appoint = назначать  
archive = архив  
astronaut = астронавт  
bag = сумка  
bathroom = ванная  
booster = усилитель  
burden = бремя  
buyback = обратный выкуп  
clue = подсказка  
continent = континент  
decarbonize = декарбонизировать  
deepfake = дипфейк  
diaper = подгузник  
dioxide = диоксид  
display = дисплей  
dive = нырять  
domain = домен  
dust = пыль  
eastern = восточный  
embrace = обнимать  
escape = убегать  
explode = взрываться  
facial = лицевой  
failure = неудача  
fashion = мода  
filter = фильтр  
fraud = мошенничество  
Fred = Фред  
funny = смешной  
handful = горсть  
harsh = суровый  
heavily = тяжело  
immigrant = иммигрант  
jail = тюрьма  
leverage = рычаг  
log = бревно  
odd = странный  
pain = боль  
participant = участник  
pathway = путь  
pledge = обещание  
pregnant = беременная  
prohibit = запрещать  
provider = провайдер  
purchase = покупка  
recognition = признание  
recreate = воссоздавать  
recruit = вербовать  
reduction = снижение  
restrict = ограничивать  
ruin = разрушать  
runoff = сток  
saint = святой  
salary = зарплата  
settler = поселенец  
shoe = обувь  
sing — sang — sung = петь  
skate = кататься  
solid = твёрдый  
string = строка  
surf = серфинг  
SUV = внедорожник  
swimming = плавание  
talent = талант  
temporary = временный  
thought = мысль  
tribe = племя  
tweet = твит  
valuable = ценный  
via = через  
virtual = виртуальный  
visible = видимый  
wish = желание  
wound = рана  
wrap = обёртывать  
Arctic = Арктика  
Commonwealth = Содружество  
Gaza = Газа  
accident = авария  
acid = кислота  
adapt = адаптировать  
additive = добавка  
Afghan = афганский  
altogether = совсем  
attach = прикреплять  
blame = винить  
boundary = граница  
button = кнопка  
cancel = отменять  
cat = кот  
catastrophic = катастрофический  
chairman = председатель  
clinic = клиника  
commitment = обязательство  
danger = опасность  
detect = обнаруживать  
dirty = грязный  
distancing = дистанцирование  
diverse = разнообразный  
exciting = захватывающий  
fatality = смертельный исход  
finger = палец  
fox = лиса  
ghost = призрак  
honor = честь  
hopefully = надеюсь  
Houthis = хуситы  
insect = насекомое  
invention = изобретение  
invite = приглашать  
livestock = скот  
magic = магия  
manufacture = производство  
medication = медикамент  
missile = ракета  
mortgage = ипотека  
oversight = надзор  
pit = яма  
plenty = много  
protective = защитный  
pulp = мякоть  
quiet = тихий  
recommendation = рекомендация  
relation = отношение  
reputation = репутация  
rush = спешка  
seal = печать  
senior = старший  
shall = должен  
shock = шок  
slave = раб  
Spotify = Спотифай  
statistic = статистика  
streaming = поток  
stress = стресс  
sugar = сахар  
suppress = подавлять  
texture = текстура  
therefore = поэтому  
thrive = процветать  
title = заголовок  
tournament = турнир  
understanding = понимание  
vitamin = витамин  
vocal = вокальный  
wet = мокрый  
whenever = когда угодно  
winner = победитель  
withdraw = отзывать  
youth = молодёжь  
Asia = Азия  
Berlin = Берлин  
Bush = Буш  
Kabul = Кабул  
Wisconsin = Висконсин  
accessible = доступный  
activate = активировать  
antibody = антитело  
assemble = собирать  
attend = посещать  
awesome = потрясающий  
beam = луч  
billionaire = миллиардер  
bold = смелый  
borrow = занимать  
canopy = навес  
careful = осторожный  
carefully = осторожно  
catapult = катапульта  
competitive = конкурентный  
complaint = жалоба  
contagious = заразный  
controversial = противоречивый  
corrupt = коррумпированный  
craft = ремесло  
cruise = круиз  
density = плотность  
deploy = развертывать  
discovery = открытие  
dominant = доминирующий  
drought = засуха  
economist = экономист  
enormous = огромный  
Europe = Европа  
excess = избыток  
execute = выполнять  
exploration = исследование  
fatal = фатальный  
firm = фирма  
formal = формальный  
formula = формула  
frankly = откровенно  
fungus = грибок  
gay = гей  
globe = глобус  
hail = град  
hell = ад  
however = однако  
ideology = идеология  
ignore = игнорировать  
incentive = стимул  
influential = влиятельный  
install = устанавливать  
interpret = интерпретировать  
kingdom = королевство  
lawyer = адвокат  
legalization = легализация  
legislature = законодательный орган  
library = библиотека  
liner = лайнер  
making = изготовление  
math = математика  
meaning = значение  
medicine = медицина  
minimize = минимизировать  
monarchy = монархия  
navy = флот  
penalty = штраф  
proposal = предложение  
rally = митинг  
reinforce = усиливать  
rocket = ракета  
scientific = научный  
sewer = канализация  
simulation = симуляция  
smart = умный  
soap = мыло  
span = промежуток  
stack = стопка  
stare = смотреть  
submit = представлять  
surveyor = геодезист  
technically = технически  
thin = тонкий  
toll = пошлина  
tooth — teeth = зуб  
treaty = договор  
uncertainty = неопределённость  
weigh = взвешивать  
worldwide = всемирный  
writing = письмо  
Alex = Алекс  
Arizona = Аризона  
Brooklyn = Бруклин  
COVID = КОВИД  
Jupiter = Юпитер  
Metro = Метро  
Paris = Париж  
Turkey = Турция  
alter = изменять  
ambitious = амбициозный  
argument = аргумент  
Asian = азиатский  
assault = нападение  
aware = осведомлённый  
awareness = осведомлённость
blockbuster = блокбастер  
breakthrough = прорыв  
broadcast = трансляция  
brother = брат  
cannabis = каннабис  
celebrity = знаменитость  
chief = главный  
circumstance = обстоятельство  
cocci = кокки  
colony = колония  
conspiracy = заговор  
contrast = контраст  
coup = переворот  
defeat = поражение  
delivery = доставка  
demonstrate = демонстрировать  
depict = изображать  
dump = свалка  
enact = вводить  
epidemic = эпидемия  
equally = равно  
escalate = обострять  
everyday = повседневный  
existence = существование  
exoplanet = экзопланета  
expectation = ожидание  
fraction = доля  
Fresnel = Френель  
galaxy = галактика  
globally = глобально  
govern = управлять  
graduate = выпускник  
harmful = вредный  
harvest = урожай  
headline = заголовок  
headquarters = штаб-квартира  
heritage = наследие  
importance = важность  
indicate = указывать  
inquit = беспокоить  
intend = намереваться  
joint = совместный  
justify = оправдывать  
lean = наклоняться  
license = лицензия  
lord = лорд  
manufacturer = производитель  
menu = меню  
militant = боевик  
monthly = ежемесячный  
mouth = рот  
orbit = орбита  
origin = происхождение  
phenomenon = явление  
plain = равнина  
pour = наливать  
previously = ранее  
properly = должным образом  
rapid = быстрый  
receptor = рецептор  
relative = родственник  
render = рендерить  
repair = ремонт  
ski = лыжи  
soccer = футбол  
sovereignty = суверенитет  
speaker = спикер  
species = вид  
spectrum = спектр  
spending = расходы  
squeeze = сжимать  
stone = камень  
surrender = сдаваться  
sustainable = устойчивый  
tenant = арендатор  
tide = прилив  
toxic = токсичный  
transport = транспорт  
tube = трубка  
umbrella = зонт  
unite = объединять  
variant = вариант  
weak = слабый  
wipe = вытирать  
working = работающий  
Antarctica = Антарктика  
Bible = Библия  
Jersey = Джерси  
absolute = абсолютный  
alongside = рядом  
animate = оживлять  
artifact = артефакт  
aspect = аспект  
assistant = помощник  
backwards = назад  
Benin = Бенин  
bury = хоронить  
busy = занятый  
catastrophe = катастрофа  
cent = цент  
challenging = сложный  
coffee = кофе  
competitor = конкурент  
complexity = сложность  
conference = конференция  
consistent = последовательный  
constant = постоянный  
cry = плакать  
dedicate = посвящать  
deposit = депозит  
depth = глубина  
dialogue = диалог  
disrupt = нарушать  
distribution = распределение  
Dominican = доминиканский  
drain = слив  
duty = долг  
dying = умирающий  
dyslexia = дислексия  
evangelical = евангельский  
fault = вина  
footprint = след  
fresh = свежий  
gate = ворота  
geothermal = геотермальный  
grain = зерно  
gross = валовой  
groundwater = грунтовые воды  
guilty = виновный  
hello = привет  
hip = бедро  
humanity = человечество  
identical = идентичный  
immediate = немедленный  
impose = налагать  
initiative = инициатива  
injure = ранить  
internal = внутренний  
kitchen = кухня  
lagoon = лагуна  
legalize = легализовать  
lifeboat = спасательная шлюпка  
luckily = к счастью  
lucky = удачливый  
lung = лёгкое  
mill = мельница  
misinformation = дезинформация  
motor = мотор  
Muslim = мусульманин  
negotiate = вести переговоры  
neutral = нейтральный  
obtain = получать  
occupation = занятие  
opposition = оппозиция  
painter = художник  
Palestinian = палестинский  
permit = разрешение  
physicist = физик  
pixel = пиксель  
plantation = плантация  
porn = порно  
practical = практичный  
profile = профиль  
proper = правильный  
proud = гордый  
province = провинция  
qualify = квалифицироваться  
ramp = пандус  
rank = ранг  
recover = восстанавливаться  
representation = представление  
respiratory = дыхательный  
retire = уходить на пенсию  
revolutionary = революционный  
rival = соперник  
schedule = расписание  
script = сценарий  
sculpture = скульптура  
seaweed = морские водоросли  
seed = семя  
sentence = предложение  
staff = персонал  
strain = напряжение  
strait = пролив  
strategic = стратегический  
suffering = страдание  
survival = выживание  
swap = обмен  
tilt = наклон  
trillion = триллион  
verify = проверять  
vibration = вибрация  
victim = жертва  
visitor = посетитель  
warn = предупреждать  
whereas = тогда как  
whom = кого  
yard = двор  
Boston = Бостон  
Dutch = голландский  
Iceland = Исландия  
Indonesia = Индонезия  
institute = институт  
mount = гора  
Northern = северный  
politburo = политбюро  
rights = права  
secretary = секретарь  
Vancouver = Ванкувер  
accuse = обвинять  
adoption = усыновление  
afraid = бояться  
alcohol = алкоголь  
apology = извинение  
association = ассоциация  
basketball = баскетбол  
beauty = красота  
bend — bent — bent = гнуть  
beneath = под  
biodiversity = биоразнообразие  
brightness = яркость  
bucket = ведро  
bump = удар  
CEO = генеральный директор  
ceremony = церемония  
chaos = хаос  
cite = цитировать  
citizenship = гражданство  
clothe = одевать  
commission = комиссия  
composition = композиция  
concentrate = концентрироваться  
conclude = заключать  
consent = согласие  
consumption = потребление  
countryside = сельская местность  
creator = создатель  
darkness = тьма  
database = база данных  
definition = определение  
dessert = десерт  
dimensional = размерный  
disagree = не соглашаться  
distinct = отличный  
donor = донор  
drainage = дренаж  
drill = сверлить  
duck = утка  
elderly = пожилой  
electron = электрон  
encounter = столкновение  
equivalent = эквивалент  
exclude = исключать  
expense = расход  
express = выражать  
expression = выражение  
fever = лихорадка  
follower = последователь  
forth = вперёд  
gathering = собрание  
graph = график  
having = имеющий  
hearing = слух  
hike = поход  
historian = историк  
honest = честный  
infected = заражённый  
ingredient = ингредиент  
injury = травма  
Instagram = Инстаграм  
instruction = инструкция  
intention = намерение  
Iranian = иранский  
iwi = иви  
jaw = челюсть  
jury = жюри  
lobby = лобби  
metric = метрический  
micro = микро  
mode = режим  
myopia = миопия  
neither = ни  
novel = роман  
patent = патент  
petition = петиция  
pink = розовый  
plot = сюжет  
pocket = карман  
popularity = популярность  
prior = предыдущий  
prioritize = расставлять приоритеты  
privilege = привилегия  
puzzle = головоломка  
quiz = викторина  
recording = запись  
refine = очищать  
rough = грубый  
saving = сбережение  
scare = пугать  
shade = тень  
shelf = полка  
sight = зрение  
skateboard = скейтборд  
slide = скользить  
smell = запах  
smile = улыбка  
subscriber = подписчик  
sustain = поддерживать  
terrible = ужасный  
thick = толстый  
unlikely = маловероятный  
urge = побуждать  
violation = нарушение  
virtually = виртуально  
airlines = авиалинии  
Alabama = Алабама  
Filipino = филиппинский  
Houston = Хьюстон  
Hyde = Хайд  
Indus = Инд  
Ohio = Огайо  
Pacific = Тихий океан  
Phoenix = Феникс  
accumulate = накапливать  
airport = аэропорт  
animator = аниматор  
anon = анон  
anthropos = антропос  
award = награда  
bedroom = спальня  
blanket = одеяло  
boycott = бойкот  
brick = кирпич  
brilliant = блестящий  
brutality = жестокость  
cab = такси  
calculate = вычислять  
Canadian = канадский  
cap = крышка  
cargo = груз  
carrier = перевозчик  
chef = шеф-повар  
Christian = христианский  
circular = круговой  
classroom = классная комната  
clinical = клинический  
closely = близко  
coach = тренер  
compartment = отделение  
compromise = компромисс  
concert = концерт  
confine = ограничивать  
congestion = затор  
construct = строить  
cook = готовить  
corn = кукуруза  
council = совет  
crater = кратер  
criticize = критиковать  
crowded = переполненный  
daughter = дочь  
dependent = зависимый  
detailed = подробный  
diagram = диаграмма  
diamond = бриллиант  
dirt = грязь  
discuss = обсуждать  
displace = вытеснять  
enslave = порабощать  
error = ошибка  
evolution = эволюция  
examine = исследовать  
explosive = взрывчатый  
false = ложный  
fancy = причудливый  
flame = пламя  
Florida = Флорида  
foster = способствовать  
gift = подарок  
glacier = ледник  
hill = холм  
humanitarian = гуманитарный  
indoor = внутренний  
infectious = инфекционный  
instance = пример  
joke = шутка  
kinda = типа  
laugh = смеяться  
legally = законно  
lens = объектив  
literacy = грамотность  
logo = логотип  
makeup = макияж  
marriage = брак  
migration = миграция  
mild = мягкий  
mineral = минерал  
minor = незначительный  
mitigate = смягчать  
mujahideen = моджахеды  
narrator = рассказчик  
nursing = уход  
overthrow = свергать  
pace = темп  
peer = ровня  
podcast = подкаст  
pollster = опросчик  
pope = папа  
prominent = выдающийся  
proof = доказательство  
publicly = публично  
punish = наказывать  
racist = расист  
regularly = регулярно  
relief = облегчение  
reminder = напоминание  
remnant = остаток  
reparation = возмещение  
Republicans = республиканцы  
resist = сопротивляться  
rice = рис  
ridge = хребет  
ridiculous = смешной  
rifle = винтовка  
rip = рвать  
risky = рискованный  
robot = робот  
scream = кричать  
sheet = лист  
slash = косая черта  
Spanish = испанский  
sphere = сфера  
statehood = государственность  
strip = полоса  
subtle = тонкий  
swell = набухать  
tape = лента  
taste = вкус  
Terri = Терри  
theme = тема  
tomorrow = завтра  
tonight = сегодня вечером  
transmit = передавать  
triple = тройной  
tweak = корректировать  
ultimate = конечный  
undermine = подрывать  
update = обновление  
urgent = срочный  
vegetation = растительность  
vertical = вертикальный  
violate = нарушать  
weaken = ослаблять  
whoa = уау  
wobble = колебаться  
yield = урожай  
Germans = немцы  
Greenland = Гренландия  
metals = металлы  
Nigeria = Нигерия  
Syria = Сирия  
Tennessee = Теннесси  
Wade = Уэйд  
absentee = отсутствующий  
academic = академический  
align = выравнивать  
apologize = извиняться  
apparently = очевидно  
appreciate = ценить  
arcade = аркада  
array = массив  
atom = атом  
banana = банан  
bet = ставка  
bloody = кровавый  
brush = щётка  
bug = жук  
builder = строитель  
bullet = пуля  
buyer = покупатель  
calculator = калькулятор  
canyon = каньон  
capsule = капсула  
charity = благотворительность  
chin = подбородок  
cholera = холера  
chunk = кусок  
Clearview = Клирвью  
compound = соединение  
compress = сжимать  
concentration = концентрация  
confidence = уверенность  
contamination = загрязнение  
cotton = хлопок  
cute = милый  
deserve = заслуживать  
desire = желание  
discipline = дисциплина  
discriminate = дискриминировать  
dispute = спор
drinking = питьё  
driving = вождение  
educate = обучать  
efficiently = эффективно  
emphasize = подчёркивать  
endanger = подвергать опасности  
faith = вера  
fifty = пятьдесят  
finance = финансы  
firearm = огнестрельное оружие  
fishing = рыбалка  
freeze — froze — frozen = замораживать  
golden = золотой  
hemisphere = полушарие  
hook = крючок  
hormuz = Хормуз  
husband = муж  
impressive = впечатляющий  
influenza = грипп  
intellectual = интеллектуальный  
investigator = следователь  
italian = итальянский  
jurisdiction = юрисдикция  
killer = убийца  
landmark = ориентир  
legitimate = законный  
maker = изготовитель  
manager = менеджер  
marry = жениться  
master = мастер  
meantime = тем временем  
median = медиана  
microscope = микроскоп  
mob = толпа  
mortality = смертность  
multi = много  
narrative = повествование  
nationalist = националист  
neglect = пренебрегать  
newsroom = редакция  
nutrient = питательное вещество  
obligation = обязательство  
obsess = одержимость  
opt = выбирать  
organizer = организатор  
originally = изначально  
output = выход  
overturn = опрокидывать  
overwhelm = подавлять  
owe = быть должным  
peacock = павлин  
performer = исполнитель  
phenylephrine = фенилэфрин  
philosophy = философия  
pitbull = питбуль  
planning = планирование  
prayer = молитва  
prevention = предотвращение  
prisoner = заключённый  
radical = радикальный  
react = реагировать  
regional = региональный  
resemble = напоминать  
reward = награда  
riot = бунт  
rotate = вращать  
safely = безопасно  
scandal = скандал  
scared = напуганный  
scratch = царапина  
screw = винт  
sheep — sheep = овца  
shiny = блестящий  
silver = серебро  
sister = сестра  
slogan = слоган  
spiral = спираль  
sponge = губка  
spy = шпион  
statue = статуя  
stimulus — stimuli = стимул  
structural = структурный  
suppression = подавление  
surplus = избыток  
suspend = приостанавливать  
swoop = налёт  
tackle = решать  
tire = шина  
tourist = турист  
transformation = трансформация  
tribal = племенной  
tropical = тропический  
turning = поворот  
upper = верхний  
vaccination = вакцинация  
variable = переменная  
warning = предупреждение  
weekend = выходные  
wildfire = лесной пожар  
Arkansas = Арканзас  
canadians = канадцы  
Columbia = Колумбия  
Iraq = Ирак  
Jerusalem = Иерусалим  
medicaid = медикейд  
Minister = Министр  
parliament = парламент  
Seattle = Сиэтл  
standing = стоящий  
Western = западный  
abandon = покидать  
abroad = за границей  
academy = академия  
accelerate = ускорять  
acquire = приобретать  
admit = признавать  
advertise = рекламировать  
affluent = состоятельный  
agent = агент  
alien = инопланетянин  
allocate = распределять  
ambition = амбиция  
anger = гнев  
announcement = объявление  
anticipate = предвидеть  
assign = назначать  
attendant = обслуживающий  
automatically = автоматически  
bias = предубеждение  
bidding = торги  
blast = взрыв  
breakfast = завтрак  
brutalist = бруталистский  
buck = доллар  
bull = бык  
calf — calves = телёнок  
casualty = жертва  
chatbot = чат-бот  
chatgpt = ЧатGPT  
cheat = обманывать  
client = клиент  
club = клуб  
coastal = прибрежный  
command = команда  
commonly = обычно  
complain = жаловаться  
comprehensive = всеобъемлющий  
conclusion = вывод  
conditioning = кондиционирование  
congressional = конгрессовый  
conservation = сохранение  
constitutional = конституционный  
contestant = участник  
cop = полицейский  
crush = раздавить  
crystal = кристалл  
demographic = демографический  
designate = обозначать  
destination = пункт назначения  
diabete = диабет  
dip = окунать  
disability = инвалидность  
divert = перенаправлять  
downtown = центр города  
draft = черновик  
drum = барабан  
dynamite = динамит  
edit = редактировать  
efficiency = эффективность  
emotional = эмоциональный  
entry = вход  
ethical = этический  
exclusive = эксклюзивный  
excuse = оправдание  
expel = исключать  
farmland = сельхозугодья  
FBI = ФБР  
fee = плата  
flash = вспышка  
flashcard = карточка  
formally = формально  
george = Джордж  
gesture = жест  
glory = слава  
got = получил  
gothic = готический  
governance = управление  
grandfather = дедушка  
grandmother = бабушка  
hat = шляпа  
Hawaii = Гавайи  
headphone = наушники  
heal = исцелять  
hop = прыгать  
horse = лошадь  
hypothesis — hypotheses = гипотеза  
ignite = зажигать  
illustrate = иллюстрировать  
infrared = инфракрасный  
inherit = наследовать  
intervene = вмешиваться  
knee = колено  
lap = круг  
laptop = ноутбук  
lava = лава  
liberty = свобода  
licensing = лицензирование  
linear = линейный  
loose = свободный  
lunch = обед  
marble = мрамор  
marker = маркер  
maximum = максимум  
microfauna = микрофауна  
musician = музыкант  
mutate = мутировать  
mystery = тайна  
navigate = ориентироваться  
neck = шея  
nervous = нервный  
newly = недавно  
offside = офсайд  
ongoing = продолжающийся  
ownership = владение  
parkour = паркур  
paycheck = зарплата  
penetrate = проникать  
pew = скамья  
phrase = фраза  
piano = пианино  
poison = яд  
poop = какашки  
precise = точный  
prefer = предпочитать  
prevail = преобладать  
pseudoephedrine = псевдоэфедрин  
raw = сырой  
reasonable = разумный  
rebel = бунтарь  
reconstruction = реконструкция  
regard = отношение  
remarkable = замечательный  
repeatedly = неоднократно  
replacement = замена  
reproduce = воспроизводить  
resign = уходить в отставку  
rider = всадник  
rodent = грызун  
sad = грустный  
scatter = рассеивать  
seasonal = сезонный  
sediment = осадок  
seemingly = казалось бы  
segregation = сегрегация  
sensitive = чувствительный  
shootout = перестрелка  
shower = душ  
simulate = симулировать  
singe = опалить  
sle = сани  
slope = склон  
smoke = дым  
stair = лестница  
steady = устойчивый  
stylize = стилизовать  
succeed = преуспевать  
suck = сосать  
supplement = дополнение  
surprising = удивительный  
suspect = подозревать  
swarm = рой  
synthetic = синтетический  
teaching = обучение  
textbook = учебник  
thickness = толщина  
thus = таким образом  
tick = галочка  
tower = башня  
traditionally = традиционно  
trash = мусор  
tunnel = туннель  
unity = единство  
utility = утилита  
veto = вето  
volcano — volcanoes = вулкан  
wavelength = длина волны  
welfare = благосостояние  
wheel = колесо  
whoever = кто бы ни  
wildly = дико  
wireless = беспроводной  
witness = свидетель