surrender = сдаться
rang = звонил
mom = мама
scared = испугался
heroism = героизм
medals = медали
alive = живой
shot = застрелен
combat = бой
coward = трус
Cowardice = трусость
courage = мужество
recurring = повторяющийся
Conscripted = призывник
scared = испугался
dying = умирающий
haunts = преследует
rewires = перемонтирует
trenches = траншеи
Doctors = врачи
Volunteers = добровольцы
deserve = заслуживают
bow = лук
survivors = выжившие
sick = больные
relatives = родственники
uniforms = форма
carry  = нести
weight = тяжесть
praises = хвалы
live = жить
rebuild = восстановить
would’ve = бы
raise = поднять
bravery = храбрость
cruelty = жестокость
I took my family somewhere safe. = Я увез свою семью в безопасное место.
victory = победа
fall = падение
none = никто
feeds = кормит
calms = успокаивает
politician = политик
nightmares = кошмары
Smaller = меньше
Quieter = тише
preach = проповедовать
politicians = политики
camouflage = камуфляж
pensioners = пенсионеры
fought = боролись
argument = спор
mud = грязь
yours = твой
judge = судья
politics = политика
storm = шторм
adapted = адаптированный
ancestors = предки
courage = мужество