be — was; were — been = бути  
to = до  
and = і  
of = з  
in = в  
that = той  
it = це  
have — had — had = мати  
they = вони  
you = ти  
this = цей  
we = ми  
for = для  
not = не  
but = але  
do — did — done = робити  
on = на  
like = подобатися; як  
with = з  
so = так  
as = як  
from = від  
at = у  
one = один  
there = там  
can = могти  
go — went — gone = йти  
more = більше  
all = все  
people = люди  
what = що  
make — made — made = робити  
get — got — got/gotten = отримувати  
just = просто  
by = за  
or = або  
their = їхній  
these = ці  
about = про  
if = якщо  
an = один  
he = він  
up = вгору  
when = коли  
know — knew — known = знати  
out = з  
would = хотів би  
which = який  
see — saw — seen = бачити  
how = як  
year = рік  
time = час  
will = буде  
our = наш  
who = хто  
because = тому що  
look = дивитися  
use = використовувати  
take — took — taken = брати  
way = шлях  
into = в  
then = тоді  
could = міг би  
some = деякі  
over = над  
other = інший  
where = де  
right = правильно; правий  
really = справді  
thing = річ  
than = ніж  
come — came — come = приходити  
here = тут  
work = працювати  
lot = багато  
want = хотіти  
now = зараз  
think — thought — thought = думати  
start = починати  
also = також  
your = твій  
say — said — said = сказати  
my = мій  
country — countries = країна  
even = навіть  
first = перший  
most = найбільше  
very = дуже  
his = його  
those = ті  
no = ні  
call = дзвонити; називати  
new = новий  
much = багато  
big — bigger — biggest = великий  
its = його  
world = світ  
well = добре  
mean — meant — meant = означати  
back = назад  
need — needed — needed = потребувати  
only = тільки  
many = багато  
around = навколо  
two = два  
change = змінювати  
state = стан; держава  
actually = насправді  
after = після  
kind = вид; добрий  
become — became — become = ставати  
find — found — found = знаходити  
show — showed — shown = показувати  
still = ще  
down = вниз  
something = щось  
government = уряд  
good — better — best = хороший  
every = кожен  
help = допомагати  
part = частина  
give — gave — given = давати  
different = різний  
day = день  
build — built — built = будувати  
happen = відбуватися  
same = той самий  
through = через  
long = довгий  
music = музика  
high = високий  
why = чому  
try — tried — tried = намагатися  
water = вода  
end = кінець  
before = перед  
place = місце  
company — companies = компанія  
million = мільйон  
home = дім  
keep — kept — kept = тримати  
put — put — put = класти  
too = також  
city — cities = місто  
system = система  
video = відео  
little = маленький  
any = будь-який  
she = вона  
off = вимкнено; від  
between = між  
might = міг би  
live = жити  
power = сила  
today = сьогодні  
create = створювати  
let — let — let = дозволяти  
few = кілька  
feel — felt — felt = відчувати  
own = власний  
move = рухатися  
life — lives = життя  
far = далеко  
land = земля  
money = гроші  
vote = голосувати  
another = інший  
point = точка  
law = закон  
should = повинен  
pay — paid — paid = платити  
while = поки  
black = чорний  
case = випадок  
tell — told — told = розповідати  
leave — left — left = залишати  
turn = повертати  
human = людина  
include = включати  
problem = проблема  
area = область  
close = закривати; близький  
China = Китай  
large = великий  
less = менше  
name = ім’я  
line = лінія  
three = три  
each = кожен  
next = наступний  
number = число  
story — stories = історія  
group = група  
virus = вірус  
thousand = тисяча  
woman — women = жінка  
hard = важкий  
since = з  
war = війна  
talk = говорити  
force = сила  
lead — led — led = вести  
control = контролювати  
grow — grew — grown = рости  
low = низький  
movie = фільм  
set — set — set = встановлювати  
question = питання  
support = підтримувати  
able = здатний  
small = маленький  
last = останній  
light = світло  
study = вчитися  
ask = питати  
always = завжди  
bring — brought — brought = приносити  
school = школа  
design = дизайн  
often = часто  
pretty = гарний  
never = ніколи  
sort = сортувати; вид  
film = фільм  
image = зображення  
away = геть  
real = справжній  
begin — began — begun = починати  
almost = майже  
great = великий  
across = через  
both = обидва  
play = грати  
sound = звук  
again = знову  
space = простір  
early = рано  
election = вибори  
man — men = чоловік  
plan = план  
second = другий  
already = вже  
run — ran — run = бігти  
building = будівля  
decade = десятиліття  
police = поліція  
public = громадський  
child — children = дитина  
hand = рука  
once = одного разу  
plant = рослина; завод  
industry = промисловість  
level = рівень  
under = під  
important = важливий  
job = робота  
old = старий  
against = проти  
us = нас  
fight — fought — fought = боротися  
watch = дивитися  
energy = енергія  
reason = причина  
stop = зупинятися  
datum — data = дані  
history = історія  
win — won — won = вигравати  
person = особа  
enough = достатньо  
air = повітря  
hundred = сто  
population = населення  
white = білий  
everything = все  
idea = ідея  
president = президент  
test = тест  
ever = коли-небудь  
learn — learned/learnt — learned/learnt = вчитися  
pass = проходити  
during = під час  
without = без  
face = обличчя  
family — families = сім’я  
process = процес  
bit = трохи  
allow = дозволяти  
later = пізніше  
open = відкривати  
probably = ймовірно  
worker = працівник  
hold — held — held = тримати  
rate = ставка  
until = до  
basically = в основному  
vaccine = вакцина  
house = будинок  
side = сторона  
party = партія  
understand — understood — understood = розуміти  
community — communities = громада  
month — months = місяць  
whole = цілий  
oil = нафта  
send — sent — sent = надсилати  
though = хоча  
model = модель  
sign = знак  
Russia = Росія  
bad — worse — worst = поганий  
team = команда  
type = тип  
hear — heard — heard = чути  
photo = фото  
gas = газ  
top = верх  
military = військовий  
nearly = майже  
cause = викликати  
seem = здаватися  
body — bodies = тіло  
continue = продовжувати  
example = приклад  
instead = замість  
maybe = можливо  
four = чотири  
hour = година  
protect = захищати  
lose — lost — lost = втрачати  
form = форма  
policy = політика  
easy = легкий  
federal = федеральний  
hit — hit — hit = вдарити  
thank = дякувати  
death = смерть  
game = гра  
rule = правило  
together = разом  
behind = позаду  
increase = збільшувати  
car = автомобіль  
price = ціна  
risk = ризик  
whether = чи  
cost = коштувати  
spend — spent — spent = витрачати  
write — wrote — written = писати  
least = найменше  
possible = можливий  
project = проєкт  
Ukraine = Україна  
push = штовхати  
train = поїзд; тренувати  
fast = швидкий  
future = майбутнє  
half = половина  
die — died — died = вмирати  
full = повний  
record = запис  
break — broke — broken = ламати  
business = бізнес  
clear = ясний  
figure = фігура  
base = основа  
fall — fell — fallen = падати  
rise — rose — risen = підніматися  
cut — cut — cut = різати  
drive — drove — driven = їхати  
fact = факт  
food = їжа  
kill = вбивати  
major = головний  
outside = зовні  
add = додавати  
ground = земля  
abortion = аборт  
attack = напад  
report = звіт  
result = результат  
sell — sold — sold = продавати  
market = ринок  
huge = величезний  
student = студент  
likely = ймовірно  
term = термін  
along = уздовж  
check = перевіряти  
color = колір  
her = її  
require = вимагати  
technology = технологія  
everyone = кожен  
political = політичний  
care = піклуватися  
century — centuries = століття  
shoot — shot — shot = стріляти  
cover = покривати  
develop = розвивати  
buy — bought — bought = купувати  
decide = вирішувати  
map = карта  
within = в межах  
center = центр  
picture = картина  
effect = ефект  
reach = досягати  
believe = вірити  
produce = виробляти  
someone = хтось  
animal = тварина  
issue = питання  
Russian = російський  
amount = кількість  
health = здоров’я  
inside = всередині  
research = дослідження  
may = травень; може  
week = тиждень  
climate = клімат  
guy = хлопець  
sit — sat — sat = сидіти  
America = Америка  
head = голова  
ship = корабель  
spread — spread — spread = поширювати  
access = доступ  
especially = особливо  
movement = рух  
past = минуле  
sure = впевнений  
anything = будь-що  
matter = справа  
planet = планета  
States = Штати  
order = порядок  
answer = відповідь  
consider = розглядати  
exactly = точно  
five = п’ять  
pandemic = пандемія  
researcher = дослідник  
fire = вогонь  
program = програма  
sometimes = іноді  
billion = мільярд  
common = спільний  
dollar = долар  
economy = економіка  
fuel = паливо  
travel = подорожувати  
course = курс  
deal = угода  
scene = сцена  
free = вільний  
entire = весь  
love = любити  
step = крок  
provide = надавати  
stay = залишатися  
moment = момент  
soon = скоро  
word = слово  
focus = фокус  
middle = середина  
scientist = вчений  
stuff = речі  
yet = ще  
artist = художник  
mostly = здебільшого  
natural = природний  
follow = слідувати  
leader = лідер  
quickly = швидко  
solar = сонячний  
World = Світ  
act = діяти  
hope = сподіватися  
protest = протест  
region = регіон  
speed = швидкість  
voter = виборець  
wave = хвиля  
single = один  
deep = глибокий  
experience = досвід  
local = місцевий  
court = суд  
target = ціль  
else = ще  
member = член  
ban = заборона  
eventually = зрештою  
impact = вплив  
official = офіційний  
player = гравець  
release = випускати  
room = кімната  
scale = масштаб  
camera = камера
chart = діаграма  
decision = рішення  
piece = шматок  
disease = хвороба  
capture = захоплювати  
farmer = фермер  
fly — flew — flown = літати  
kid = дитина  
several = кілька  
office = офіс  
shape = форма  
emission = викид  
share = ділитися  
short = короткий  
source = джерело  
track = доріжка  
young = молодий  
bill = рахунок  
song = пісня  
tree = дерево  
challenge = виклик  
either = будь-який  
exist = існувати  
pull = тягнути  
stand — stood — stood = стояти  
usually = зазвичай  
sense = сенс  
tool = інструмент  
wait = чекати  
farm = ферма  
production = виробництво  
similar = схожий  
gun = зброя  
key = ключ  
late = пізній  
raise = піднімати  
service = служба  
cloud = хмара  
expert = експерт  
frame = рамка  
front = перед  
global = глобальний  
machine = машина  
door = двері  
drop = крапля  
red = червоний  
seat = сидіння  
computer = комп’ютер  
credit = кредит  
eye = око  
post = пост  
safe = безпечний  
save = зберігати  
store = магазин  
benefit = вигода  
class = клас  
cool = крутий  
goal = мета  
heat = тепло  
meet — met — met = зустрічати  
position = позиція  
race = гонка  
certain = певний  
compare = порівнювати  
economic = економічний  
income = дохід  
national = національний  
percent = відсоток  
star = зірка  
internet = інтернет  
itself = себе  
nothing = нічого  
reduce = зменшувати  
ten = десять  
South = Південь  
majority = більшість  
massive = масивний  
remember = пам’ятати  
sea = море  
shot = постріл  
slow = повільний  
speak — spoke — spoken = говорити  
strong = сильний  
Earth = Земля  
feature = особливість  
forest = ліс  
solution = рішення  
street = вулиця  
supply = постачання  
account = рахунок  
ago = тому  
average = середній  
dog = собака  
information = інформація  
language = мова  
measure = міра  
night = ніч  
simple = простий  
social = соціальний  
North = Північ  
difference = різниця  
finally = нарешті  
agree = погоджуватися  
nation = нація  
Congress = Конгрес  
demand = вимога  
district = район  
road = дорога  
sick = хворий  
such = такий  
tax = податок  
true = правдивий  
evidence = доказ  
offer = пропозиція  
per = за  
completely = повністю  
event = подія  
sport = спорт  
themselves = себе  
union = союз  
wear — wore — worn = носити  
yes = так  
choice = вибір  
claim = претензія  
list = список  
ocean = океан  
pick = вибирати  
product = продукт  
remain = залишатися  
Europe = Європа  
book = книга  
catch — caught — caught = ловити  
eat — ate — eaten = їсти  
flu = грип  
foot — feet = нога  
housing = житло  
mile = миля  
powerful = потужний  
represent = представляти  
ton = тонна  
among = серед  
British = британський  
crisis = криза  
limit = межа  
main = головний  
read — read — read = читати  
size = розмір  
approach = підхід  
explain = пояснювати  
interest = інтерес  
rich = багатий  
accord = згода  
burn — burned/burnt — burned/burnt = горіти  
green = зелений  
material = матеріал  
pressure = тиск  
quite = досить  
recognize = розпізнавати  
town = місто  
Germany = Німеччина  
anyone = будь-хто  
art = мистецтво  
border = кордон  
civil = цивільний  
imagine = уявляти  
near = близько  
six = шість  
weapon = зброя  
California = Каліфорнія  
carry = нести  
choose — chose — chosen = вибирати  
expect = очікувати  
flight = політ  
resource = ресурс  
return = повертатися  
charge = заряд  
prevent = запобігати  
ad = реклама  
field = поле  
individual = індивідуальний  
link = посилання  
specific = конкретний  
walk = ходити  
ball = м’яч  
couple = пара  
democracy = демократія  
development = розвиток  
generate = генерувати  
native = рідний  
site = сайт  
third = третій  
brain = мозок  
carbon = вуглець  
cell = клітина  
coronavirus = коронавірус  
dangerous = небезпечний  
inflation = інфляція  
influence = вплив  
screen = екран  
TV = телевізор  
window = вікно  
wrong = неправильний  
bunch = купа  
environment = середовище  
mail = пошта  
mask = маска  
notice = помічати  
officer = офіцер  
perfect = ідеальний  
shift = зсув  
candidate = кандидат  
fund = фонд  
news = новини  
phone = телефон  
receive = отримувати  
rest = відпочинок  
surface = поверхня  
um = гм  
chance = шанс  
difficult = складний  
flow = потік  
miss = пропускати  
view = вигляд  
drug = наркотик  
expensive = дорогий  
particular = особливий  
replace = замінювати  
block = блок  
fat = жир  
wall = стіна  
Mao = Мао  
degree = ступінь  
enter = входити  
motion = рух  
neighborhood = сусідство  
period = період  
river = річка  
troop = війська  
wind = вітер  
age = вік  
bear — bore — borne = нести  
condition = стан  
fossil = викопне  
highway = шосе  
layer = шар  
minute = хвилина  
opportunity = можливість  
serve = служити  
weather = погода  
background = фон  
beginning = початок  
former = колишній  
legal = законний  
mass = маса  
medium = середній  
spot = пляма  
establish = встановлювати  
fish = риба  
friend = друг  
online = онлайн  
paper = папір  
realize = усвідомлювати  
wage = зарплата  
blue = синій  
Chinese = китайський  
cold = холодний  
draw — drew — drawn = малювати  
final = остаточний  
location = місце  
throughout = протягом  
blood = кров  
driver = водій  
electricity = електрика  
fill = наповнювати  
option = варіант  
outbreak = спалах  
practice = практика  
rock = скеля  
standard = стандарт  
storm = шторм  
threat = загроза  
cheap = дешевий  
pattern = шаблон  
plane = літак  
popular = популярний  
private = приватний  
teach — taught — taught = навчати  
unique = унікальний  
agency = агентство  
college = коледж  
everywhere = всюди  
launch = запуск  
nuclear = ядерний  
range = діапазон  
remove = видаляти  
resident = житель  
response = відповідь  
structure = структура  
village = село  
weird = дивний  
ability = здатність  
culture = культура  
foreign = іноземний  
match = матч  
museum = музей  
passenger = пасажир  
situation = ситуація  
soil = ґрунт  
Republicans = Республіканці  
alone = сам  
basic = базовий  
current = поточний  
ice = лід  
island = острів  
politician = політик  
taxis = таксі  
temperature = температура  
truck = вантажівка  
India = Індія  
bird = птах  
gain = отримувати  
infrastructure = інфраструктура  
meter = метр  
roughly = приблизно  
stick — stuck — stuck = приклеювати  
style = стиль  
warm = теплий  
Texas = Техас  
clean = чистий  
debt = борг  
factor = фактор  
literally = буквально  
must = мусить  
non = не  
object = об’єкт  
original = оригінальний  
oxygen = кисень  
recent = недавній  
safety = безпека  
sample = зразок  
specie = вид  
teacher = вчитель  
waste = відходи  
Afghanistan = Афганістан  
Canada = Канада  
above = вище  
action = дія  
ally = союзник  
ballot = бюлетень  
box = коробка  
chemical = хімічний  
chip = чіп  
concern = занепокоєння  
conflict = конфлікт  
definitely = точно  
double = подвійний  
episode = епізод  
label = етикетка  
promise = обіцянка  
relationship = стосунки  
role = роль  
series = серія  
sky = небо  
stage = етап  
super = супер  
Portuguese = португальський  
Taliban = Талібан  
campaign = кампанія  
destroy = знищувати  
direction = напрямок  
extremely = надзвичайно  
generation = покоління  
hospital = лікарня  
identify = ідентифікувати  
indigenous = корінний  
mountain = гора  
organization = організація  
protection = захист  
pump = насос  
somebody = хтось  
strategy = стратегія  
strike — struck — struck = страйкувати  
suppose = припускати  
trial = суд  
weight = вага  
worth = вартий  
capital = столиця  
dark = темний  
judge = суддя  
message = повідомлення  
pool = басейн  
straight = прямий  
violence = насильство  
affect = впливати  
appear = з’являтися  
chair = стілець  
count = рахувати  
floor = підлога  
hot = гарячий  
plus = плюс  
security = безпека  
struggle = боротьба  
ultimately = зрештою  
voting = голосування  
wood = дерево  
zero = нуль  
attention = увага  
baby = немовля  
board = дошка  
directly = прямо  
expand = розширювати  
glass = скло  
kick = удар  
letter = лист  
paint = фарба  
poll = опитування  
survey = дослідження  
zone = зона  
West = Захід  
damage = пошкодження  
digital = цифровий  
funding = фінансування  
giant = гігант  
guess = вгадувати  
involve = залучати  
join = приєднуватися  
potential = потенціал  
ready = готовий  
Republican = Республіканець  
Soviet = Радянський  
special = особливий  
studio = студія  
total = загальний  
typically = зазвичай  
value = цінність  
beautiful = красивий  
character = характер  
depend = залежати  
egg = яйце  
essentially = по суті  
everybody = усі  
gap = розрив  
heavy = важкий  
poor = бідний  
sun = сонце  
version = версія  
Christmas = Різдво  
administration = адміністрація  
anti = анти  
apart = окремо  
budget = бюджет  
concrete = бетон  
dead = мертвий  
distance = відстань  
feed — fed — fed = годувати  
financial = фінансовий  
fit — fit — fit = підходити  
forward = вперед  
introduce = представляти  
onto = на  
painting = картина  
profit = прибуток  
rain = дощ  
shut — shut — shut = закривати  
tiny = крихітний  
Democrats = Демократи  
athlete = спортсмен  
bomb = бомба  
complex = комплекс  
detail = деталь  
due = через  
education = освіта  
park = парк  
rely = покладатися  
separate = окремий  
towards = до  
voice = голос  
whatever = що завгодно  
announce = оголошувати  
civilian = цивільний  
dozen = дюжина  
effort = зусилля  
entirely = повністю  
growth = ріст  
labor = праця  
left = лівий  
plastic = пластик  
present = присутній  
south = південь  
suggest = пропонувати  
surround = оточувати  
tank = танк  
wide = широкий  
Disney = Дісней  
Union = Союз  
atmosphere = атмосфера  
below = нижче  
complete = завершувати  
consumer = споживач  
describe = описувати
email = електронна пошта  
facility = заклад  
hey = привіт  
interesting = цікавий  
international = міжнародний  
manage = керувати  
mind = розум  
multiple = множинний  
stock = запас  
tip = порада  
treat = лікувати  
activist = активіст  
attempt = спроба  
beyond = за межами  
bottom = низ  
complicated = складний  
construction = будівництво  
desert = пустеля  
electric = електричний  
era = ера  
famous = відомий  
general = загальний  
listen = слухати  
mine = мій; шахта  
particularly = зокрема  
restaurant = ресторан  
search = пошук  
visit = відвідувати  
bank = банк  
contact = контакт  
cross = перетинати  
effective = ефективний  
factory = фабрика  
fingerprint = відбиток пальця  
jump = стрибати  
kilometer = кілометр  
milk = молоко  
quality = якість  
section = розділ  
skin = шкіра  
summer = літо  
viral = вірусний  
website = вебсайт  
Court = суд  
Korea = Корея  
bar = бар  
cow = корова  
crop = врожай  
doctor = лікар  
fail = зазнавати невдачі  
fear = страх  
invest = інвестувати  
journey = подорож  
loss = втрата  
obviously = очевидно  
purpose = мета  
science = наука  
score = рахунок  
station = станція  
text = текст  
Ukrainian = український  
vehicle = транспортний засіб  
actual = фактичний  
angle = кут  
army = армія  
contain = містити  
extreme = екстремальний  
getting = отримання  
height = висота  
host = господар  
increasingly = дедалі більше  
loan = позика  
photography = фотографія  
producer = продюсер  
prove = доводити  
rather = скоріше  
specifically = конкретно  
steel = сталь  
throw — threw — thrown = кидати  
address = адреса  
amazing = дивовижний  
applause = оплески  
arrest = арешт  
available = доступний  
brand = бренд  
collect = збирати  
connect = з’єднувати  
designer = дизайнер  
estimate = оцінювати  
hotel = готель  
interview = інтерв’ю  
path = шлях  
recently = недавно  
relate = стосуватися  
rural = сільський  
season = сезон  
theater = театр  
wonder = дивуватися  
chain = ланцюг  
document = документ  
grid = сітка  
impossible = неможливий  
maintain = підтримувати  
protester = протестувальник  
sale = продаж  
tend = прагнути  
training = тренування  
anymore = більше не  
anywhere = будь-де  
approve = схвалювати  
audience = аудиторія  
elect = обирати  
element = елемент  
forever = назавжди  
lie — lay — lain = лежати  
morning = ранок  
north = північ  
nurse = медсестра  
owner = власник  
significant = значний  
society = суспільство  
visual = візуальний  
Supreme = Верховний  
Taiwan = Тайвань  
currently = зараз  
favorite = улюблений  
fix = виправляти  
inspire = надихати  
lay — laid — laid = класти  
mix = змішувати  
necessarily = обов’язково  
parent = батько  
potentially = потенційно  
property = власність  
ride — rode — ridden = їхати  
serious = серйозний  
solve = вирішувати  
sponsor = спонсор  
totally = повністю  
united = об’єднаний  
winter = зима  
Brazil = Бразилія  
British = британський  
circle = коло  
conservative = консервативний  
cultural = культурний  
dig — dug — dug = копати  
environmental = екологічний  
fair = справедливий  
generally = загалом  
lack = брак  
normal = нормальний  
predict = передбачати  
respond = відповідати  
soldier = солдат  
somewhere = десь  
square = квадрат  
switch = перемикач  
trade = торгівля  
code = код  
collapse = обвал  
combine = комбінувати  
crime = злочин  
cycle = цикл  
deadly = смертельний  
department = департамент  
direct = прямий  
fake = підроблений  
fluoride = фторид  
mark = позначка  
medical = медичний  
regime = режим  
seven = сім  
simply = просто  
suddenly = раптово  
survive = виживати  
traditional = традиційний  
East = Схід  
London = Лондон  
university = університет  
actor = актор  
agreement = угода  
apply = застосовувати  
balance = баланс  
container = контейнер  
content = зміст  
description = опис  
heart = серце  
immediately = негайно  
investment = інвестиція  
meat = м’ясо  
method = метод  
network = мережа  
nice = приємний  
organize = організовувати  
please = будь ласка  
press = прес  
professor = професор  
rail = рейка  
technique = техніка  
tie = краватка; зв’язувати  
whose = чий  
Israel = Ізраїль  
March = Березень  
app = додаток  
brown = коричневий  
citizen = громадянин  
clearly = чітко  
extra = додатковий  
file = файл  
German = німецький  
historic = історичний  
investigation = розслідування  
Iran = Іран  
justice = справедливість  
largely = значною мірою  
modern = сучасний  
noise = шум  
overall = загальний  
patient = пацієнт  
phase = фаза  
pop = поп  
professional = професійний  
reality = реальність  
signal = сигнал  
slightly = злегка  
testing = тестування  
trail = стежка  
wealthy = багатий  
worry = хвилюватися  
arrive = прибувати  
article = стаття  
blow — blew — blown = дути  
certainly = безумовно  
date = дата  
debate = дебати  
determine = визначати  
dream = мрія  
employee = працівник  
equipment = обладнання  
healthy = здоровий  
loop = петля  
mining = видобуток  
none = жоден  
panel = панель  
pose = позувати  
seek — sought — sought = шукати  
states = штати  
wealth = багатство  
western = західний  
Pakistan = Пакистан  
absolutely = абсолютно  
beat — beat — beaten = бити  
boy = хлопчик  
category = категорія  
commercial = комерційний  
daily = щоденний  
declare = оголошувати  
deeply = глибоко  
emerge = з’являтися  
European = європейський  
experiment = експеримент  
freedom = свобода  
personal = особистий  
perspective = перспектива  
pipeline = трубопровід  
reserve = резерв  
successful = успішний  
trace = слід  
trust = довіра  
west = захід  
album = альбом  
argue = сперечатися  
avoid = уникати  
boom = бум  
cement = цемент  
democratic = демократичний  
despite = незважаючи на  
familiar = знайомий  
flood = повінь  
gear = спорядження  
hide — hid — hidden = ховати  
himself = себе  
improve = покращувати  
incredible = неймовірний  
marijuana = марихуана  
minimum = мінімум  
note = нотатка  
operate = працювати  
platform = платформа  
politic = політика  
portrait = портрет  
publish = публікувати  
reform = реформа  
relatively = відносно  
renewable = відновлюваний  
severe = суворий  
sleep — slept — slept = спати  
tear — tore — torn = рвати  
trend = тенденція  
trip = поїздка  
unemployment = безробіття  
vast = величезний  
vision = бачення  
yourself = себе  
cup = чашка  
acre = акр  
adult = дорослий  
animation = анімація  
bat = кажан  
central = центральний  
divide = ділити  
eight = вісім  
hire = наймати  
hole = діра  
incredibly = неймовірно  
infect = заражати  
nearby = поблизу  
net = мережа  
percentage = відсоток  
print = друкувати  
propose = пропонувати  
protein = білок  
review = огляд  
success = успіх  
truth = правда  
band = група  
basis = основа  
cluster = кластер  
conversation = розмова  
crash = аварія  
fan = вентилятор; фанат  
farming = фермерство  
folk = народ  
fully = повністю  
fun = веселощі  
handle = ручка  
happy = щасливий  
jet = реактивний  
leadership = лідерство  
learning = навчання  
lens = об’єктив  
lock = замок  
nature = природа  
positive = позитивний  
prepare = готувати  
preserve = зберігати  
racial = расовий  
skater = ковзаняр  
tech = технологія  
territory = територія  
transition = перехід  
January = Січень  
October = Жовтень  
Washington = Вашингтон  
contract = контракт  
discover = відкривати  
expose = викривати  
favor = прихильність  
finish = закінчувати  
gather = збирати  
immune = імунний  
Indian = індійський  
intelligence = інтелект  
leg = нога  
mother = мати  
parking = паркування  
presidential = президентський  
primarily = переважно  
rubber = гума  
shop = магазин  
spike = шип  
tall = високий  
threaten = погрожувати  
trouble = проблема  
May = Травень  
Mexico = Мексика  
airline = авіалінія  
arm = рука  
artificial = штучний  
battery = батарея  
click = клацання  
column = колонка  
Congress = Конгрес  
consequence = наслідок  
crew = екіпаж  
deny = заперечувати  
director = директор  
dry = сухий  
easily = легко  
enemy = ворог  
industrial = промисловий  
journalist = журналіст  
myself = себе  
nobody = ніхто  
operation = операція  
possibility = можливість  
representative = представник  
request = запит  
reverse = зворотний  
sink — sank — sunk = тонути  
suffer = страждати  
tennis = теніс  
trailer = трейлер  
transform = трансформувати  
user = користувач  
soul = душа  
activity = діяльність  
conduct = проводити  
corner = кут  
curve = крива  
decline = спад  
deliver = доставляти  
drag = тягнути  
enforce = примушувати  
father = батько  
football = футбол  
highly = високо  
interact = взаємодіяти  
legacy = спадщина  
rare = рідкісний  
slowly = повільно  
snow = сніг  
telescope = телескоп  
theory = теорія  
universal = універсальний  
unlike = на відміну від  
wild = дикий  
February = Лютий  
Indian = індійський  
Japan = Японія  
ahead = попереду  
battle = битва  
broad = широкий  
canal = канал  
cattle = худоба  
clip = кліп  
coast = узбережжя  
committee = комітет  
electoral = виборчий  
empty = порожній  
flee — fled — fled = тікати  
god = бог  
grade = оцінка  
grant = грант  
guard = охорона  
hang — hung — hung = вішати  
infection = інфекція  
interested = зацікавлений  
invasion = вторгнення  
living = живий  
metal = метал  
obvious = очевидний  
occur = відбуватися  
prompt = підказка  
rainforest = тропічний ліс  
responsible = відповідальний  
revolution = революція  
round = круглий  
route = маршрут  
settlement = поселення  
stream = потік  
suit = костюм  
symptom = симптом  
touch = дотик  
treatment = лікування  
various = різноманітний  
April = Квітень  
affordable = доступний  
beach = пляж  
bond = зв’язок  
boost = підсилення  
card = картка  
coal = вугілля  
combination = комбінація  
contribute = сприяти  
corruption = корупція  
crazy = божевільний  
data = дані  
defend = захищати  
effectively = ефективно  
encourage = заохочувати  
engineer = інженер  
except = крім  
fine = штраф; прекрасний  
footage = відеоматеріал  
Hawaiian = гавайський  
illegal = незаконний  
importantly = важливо  
independence = незалежність  
landscape = ландшафт  
loon = гагарка  
marketing = маркетинг  
moose = лось  
neighbor = сусід  
oppose = протистояти  
peak = пік  
pitch = висота  
poverty = бідність  
repeat = повторювати
self = себе  
spirit = дух  
tension = напруга  
trick = трюк  
urban = міський  
volume = об’єм  
apartment = квартира  
barrier = бар’єр  
bid = пропозиція  
celebrate = святкувати  
cheese = сир  
communist = комуністичний  
define = визначати  
edge = край  
explosion = вибух  
exposure = вплив  
function = функція  
gold = золото  
harm = шкода  
invade = вторгатися  
king = король  
knowledge = знання  
legislation = законодавство  
mention = згадувати  
mid = середина  
mirror = дзеркало  
page = сторінка  
photograph = фотографія  
pro = професіонал  
recommend = рекомендувати  
roll = котити  
symbol = символ  
tradition = традиція  
truly = справді  
twice = двічі  
Palestinians = палестинці  
wright = майстер  
additional = додатковий  
African = африканський  
algorithm = алгоритм  
anybody = будь-хто  
attract = приваблювати  
church = церква  
copy = копія  
dot = крапка  
drink — drank — drunk = пити  
hair = волосся  
hog = свиня  
hurdle = перешкода  
independent = незалежний  
Jewish = єврейський  
mental = розумовий  
necessary = необхідний  
photographer = фотограф  
pipe = труба  
portion = порція  
promote = просувати  
quarantine = карантин  
regulation = регулювання  
spark = іскра  
spin = обертати  
table = стіл  
task = завдання  
traffic = рух  
versus = проти  
wildlife = дика природа  
wolf = вовк  
Palestine = Палестина  
adopt = приймати  
advantage = перевага  
alliance = альянс  
annual = щорічний  
campus = кампус  
chicken = курка  
compete = змагатися  
context = контекст  
counter = лічильник  
county = округ  
exact = точний  
French = французький  
inch = дюйм  
investor = інвестор  
lift = піднімати  
lower = нижчий  
melt = танути  
negative = негативний  
nowhere = ніде  
particle = частинка  
partner = партнер  
poster = плакат  
poultry = птиця  
prison = в’язниця  
reference = посилання  
sperm = сперма  
spring = весна  
steal — stole — stolen = красти  
subject = предмет  
transfer = передавати  
underground = підземний  
willing = готовий  
zoo = зоопарк  
republic = республіка  
Sudan = Судан  
achieve = досягати  
advanced = просунутий  
cancer = рак  
cash = готівка  
chase = гнатися  
comment = коментар  
concept = концепція  
customer = клієнт  
dramatically = драматично  
ecosystem = екосистема  
employer = роботодавець  
ensure = забезпечувати  
explore = досліджувати  
feeling = почуття  
flat = плоский  
grass = трава  
item = предмет  
muscle = м’яз  
occupy = займати  
ourselves = себе  
panther = пантера  
peace = мир  
performance = вистава  
reflect = відображати  
replicate = відтворювати  
responsibility = відповідальність  
satellite = супутник  
scan = сканувати  
sex = стать  
smooth = гладкий  
transportation = транспорт  
unit = одиниця  
Cairo = Каїр  
crown = корона  
queen = королева  
acknowledge = визнавати  
advance = просуватися  
assist = допомагати  
authority = влада  
baseball = бейсбол  
breed = порода  
criminal = злочинець  
deforestation = вирубка лісів  
extend = розширювати  
identity = ідентичність  
immunity = імунітет  
institution = установа  
journalism = журналістика  
lawsuit = позов  
loud = гучний  
membership = членство  
memory = пам’ять  
mutation = мутація  
Napoleon = Наполеон  
newspaper = газета  
participate = брати участь  
pilot = пілот  
pollution = забруднення  
possibly = можливо  
radio = радіо  
railroad = залізниця  
refuse = відмовлятися  
regular = регулярний  
regulate = регулювати  
retirement = пенсія  
reveal = розкривати  
secure = безпечний  
shooting = стрілянина  
stretch = розтягувати  
strict = суворий  
sudden = раптовий  
tap = кран  
transit = транзит  
universe = всесвіт  
useful = корисний  
August = Серпень  
Chicago = Чикаго  
Everest = Еверест  
Philippines = Філіппіни  
aim = ціль  
airplane = літак  
approval = схвалення  
associate = асоціювати  
brutal = жорстокий  
camp = табір  
collection = колекція  
competition = конкуренція  
confirm = підтверджувати  
corporation = корпорація  
correct = правильний  
critical = критичний  
crucial = вирішальний  
disaster = катастрофа  
emit = випускати  
engage = залучати  
evolve = розвиватися  
filmmaker = режисер  
gender = стать  
guarantee = гарантія  
guide = гід  
historical = історичний  
illness = хвороба  
knife — knives = ніж  
liquid = рідина  
male = чоловік  
management = управління  
march = марш  
mission = місія  
moon = місяць  
murder = вбивство  
normally = нормально  
pedestrian = пішохід  
perfectly = ідеально  
quick = швидкий  
reaction = реакція  
senate = сенат  
software = програмне забезпечення  
somehow = якось  
southern = південний  
speech = промова  
sue = подавати до суду  
Kashmir = Кашмір  
agriculture = сільське господарство  
architect = архітектор  
bright = яскравий  
capacity = місткість  
cast = кидати  
channel = канал  
climb = підніматися  
comfortable = комфортний  
contribution = внесок  
destruction = руйнування  
distribute = розподіляти  
efficient = ефективний  
eliminate = усувати  
export = експорт  
fold = складати  
forecast = прогноз  
forget — forgot — forgotten = забувати  
grocery = бакалія  
iron = залізо  
lake = озеро  
miniature = мініатюра  
munition = боєприпаси  
officially = офіційно  
overdose = передозування  
pack = пакувати  
pair = пара  
payment = платіж  
perform = виконувати  
permanent = постійний  
pickleball = піклбол  
presence = присутність  
refer = посилатися  
remote = віддалений  
royal = королівський  
settle = оселятися  
skill = навичка  
split = розколювати  
successfully = успішно  
surprise = сюрприз  
tough = міцний  
trap = пастка  
typeface = шрифт  
underneath = під  
unprecedented = безпрецедентний  
wife = дружина  
September = Вересень  
Valley = Долина  
Yemen = Ємен  
ancient = стародавній  
bind — bound — bound = зв’язувати  
bounce = відскакувати  
census = перепис  
concerned = стурбований  
core = ядро  
corona = корона  
dance = танець  
devastating = спустошливий  
device = пристрій  
dose = доза  
fairly = досить  
fighter = боєць  
Filipino = філіппінський  
grab = хапати  
habitat = середовище існування  
lawn = газон  
Lebanon = Ліван  
manufacturing = виробництво  
nationwide = загальнонаціональний  
oyster = устриця  
physical = фізичний  
pound = фунт  
profitable = прибутковий  
progress = прогрес  
quarter = чверть  
register = реєструвати  
reporting = звітність  
respect = повага  
seismic = сейсмічний  
shortage = нестача  
stadium = стадіон  
trigger = спусковий гачок  
upon = на  
wake — woke — woken = прокидатися  
yellow = жовтий  
Cape = Мис  
July = Липень  
June = Червень  
Madagascar = Мадагаскар  
November = Листопад  
accurate = точний  
afford = дозволити собі  
alive = живий  
although = хоча  
amendment = поправка  
bike = велосипед  
birth = народження  
bungalow = бунгало  
connection = зв’язок  
constantly = постійно  
crack = тріщина  
custom = звичай  
dairy = молочний  
defense = захист  
detainee = затриманий  
differently = по-різному  
discrimination = дискримінація  
equal = рівний  
famine = голод  
girl = дівчинка  
gravity = гравітація  
grouse = тетерук  
hate = ненавидіти  
hydrogen = водень  
ideal = ідеальний  
invent = винаходити  
investigate = розслідувати  
isolate = ізолювати  
lady = леді  
length = довжина  
lighting = освітлення  
load = навантаження  
lockdown = локдаун  
magazine = журнал  
mainly = головним чином  
mainstream = мейнстрим  
migrant = мігрант  
minority = меншість  
nose = ніс  
orange = помаранчевий  
outcome = результат  
ozone = озон  
perhaps = можливо  
pre = перед  
prime = головний  
principle = принцип  
quote = цитата  
racism = расизм  
rating = рейтинг  
rent = оренда  
sage = шавлія  
scary = страшний  
secret = секрет  
senator = сенатор  
shipping = доставка  
stake = ставка  
stewardess = стюардеса  
storage = зберігання  
substance = речовина  
toward = до  
unless = якщо не  
France = Франція  
Russians = росіяни  
Stanford = Стенфорд  
Uruguay = Уругвай  
accept = приймати  
aid = допомога  
aircraft = літак  
Arab = арабський  
Augustine = Августин  
author = автор  
Azerbaijan = Азербайджан  
bacteria = бактерії  
became = став  
belong = належати  
bombing = бомбардування  
clothing = одяг  
consume = споживати  
cough = кашель  
creation = створення  
decrease = зменшувати  
demonstration = демонстрація  
earthquake = землетрус  
expansion = розширення  
fighting = боротьба  
flip = перевертати  
float = плавати  
further = далі  
gallon = галон  
graphic = графічний  
greenhouse = теплиця  
Hampton = Хемптон  
hero = герой  
highlight = висвітлювати  
hunt = полювати  
inequality = нерівність  
instrument = інструмент  
lab = лабораторія  
lesson = урок  
locate = знаходити  
methane = метан  
mimic = імітувати  
naturally = природно  
nest = гніздо  
nine = дев’ять  
opening = відкриття  
physics = фізика  
postcard = листівка  
previous = попередній  
realistic = реалістичний  
restore = відновлювати  
ring = кільце  
row = ряд  
scenario = сценарій  
sequence = послідовність  
setting = налаштування  
shadow = тінь  
shout = кричати  
suicide = самогубство  
swing = гойдалки  
tactic = тактика  
television = телебачення  
thinking = мислення  
translate = перекладати  
typical = типовий  
variety = різноманітність  
victory = перемога  
welcome = вітати  
Britain = Британія  
Island = Острів  
Pennsylvania = Пенсільванія  
Poland = Польща  
Space = Космос  
Ukrainians = українці  
absorb = поглинати  
agricultural = сільськогосподарський  
apple = яблуко  
architecture = архітектура  
aside = осторонь  
auction = аукціон  
barely = ледве  
branch = гілка  
career = кар’єра  
ceiling = стеля  
comparison = порівняння  
creative = творчий  
curious = цікавий  
delay = затримка  
disappear = зникати  
droplet = крапля  
editorial = редакційний  
empire = імперія  
employment = працевлаштування  
excited = схвильований  
fade = зникати  
flooding = повінь  
helpful = корисний  
household = домашнє господарство  
iconic = культовий  
implement = впроваджувати  
initial = початковий  
intense = інтенсивний  
Japanese = японський  
laser = лазер  
league = ліга  
lighthouse = маяк  
medal = медаль  
meeting = зустріч  
mistake = помилка  
mom = мама  
obstacle = перешкода  
opposite = протилежний  
physically = фізично  
polling = опитування  
prop = опора  
rancher = фермер  
reject = відхиляти  
religious = релігійний  
residential = житловий  
restriction = обмеження  
roof = дах  
seriously = серйозно  
shine = сяяти  
significantly = значно  
sled = сани  
son = син
sorry = вибач  
supporter = прихильник  
volunteer = волонтер  
vulnerable = вразливий  
widespread = поширений  
wing = крило  
worried = стурбований  
Georgia = Джорджія  
Senate = Сенат  
active = активний  
adjust = налаштувати  
advertising = реклама  
analyze = аналізувати  
application = заявка  
armed = озброєний  
Armenia = Вірменія  
basement = підвал  
bed = ліжко  
beef = яловичина  
belief = віра  
bite — bit — bitten = кусати  
breathe = дихати  
chapter = розділ  
coalition = коаліція  
coaster = підстаканник  
commit = вчиняти  
communicate = спілкуватися  
consistently = послідовно  
constitution = конституція  
convince = переконувати  
corporate = корпоративний  
dataset = набір даних  
dementia = деменція  
dominate = домінувати  
dramatic = драматичний  
earn = заробляти  
enforcement = примус  
engine = двигун  
essential = необхідний  
exchange = обмін  
executive = виконавчий  
exercise = вправа  
female = жінка  
font = шрифт  
friendly = дружній  
fruit = фрукт  
governor = губернатор  
honestly = чесно  
horror = жах  
joy = радість  
lane = смуга  
lifetime = життя  
meanwhile = тим часом  
minister = міністр  
narrow = вузький  
overlap = перекриття  
pig = свиня  
plate = тарілка  
prediction = прогноз  
punch = удар  
rapidly = швидко  
rebuild = перебудувати  
reef = риф  
rid = позбутися  
ruling = рішення  
shoulder = плече  
signature = підпис  
skyrocket = стрімко зростати  
soft = м’який  
spray = спрей  
status = статус  
terrorist = терорист  
transmission = передача  
trucker = водій вантажівки  
turbine = турбіна  
vaccinate = вакцинувати  
variation = варіація  
vary = варіювати  
violent = насильницький  
widely = широко  
Australia = Австралія  
God = Бог  
Italy = Італія  
Manhattan = Манхеттен  
abuse = зловживання  
analysis = аналіз  
assume = припускати  
backyard = задній двір  
behavior = поведінка  
being = буття  
boat = човен  
bone = кістка  
bus = автобус  
classic = класичний  
coat = пальто  
colleague = колега  
colonial = колоніальний  
communication = спілкування  
convert = конвертувати  
coverage = покриття  
critic = критик  
dam = гребля  
developer = розробник  
displacement = переміщення  
division = поділ  
dress = сукня  
dynamic = динамічний  
ear = вухо  
elite = еліта  
emergency = надзвичайна ситуація  
employ = працевлаштовувати  
explanation = пояснення  
flag = прапор  
flower = квітка  
found = засновувати  
foundation = фундамент  
genetic = генетичний  
gentleman = джентльмен  
gray = сірий  
historically = історично  
hurricane = ураган  
immigration = імміграція  
import = імпорт  
initially = спочатку  
margin = маржа  
measurement = вимірювання  
militia = міліція  
monitor = монітор  
moral = моральний  
northern = північний  
opioid = опіоїд  
package = пакет  
patch = латка  
perceive = сприймати  
pill = таблетка  
port = порт  
pregnancy = вагітність  
primary = первинний  
remind = нагадувати  
revenue = дохід  
root = корінь  
sanction = санкція  
select = вибирати  
shake — shook — shaken = трясти  
shrink — shrank — shrunk = скорочуватися  
statement = заява  
strange = дивний  
surge = сплеск  
sweep — swept — swept = підмітати  
tag = тег  
tanker = танкер  
technical = технічний  
tight = тугий  
timber = деревина  
tone = тон  
topic = тема  
tour = тур  
tricky = складний  
vice = порок  
wash = мити  
wire = дріт  
England = Англія  
grand = великий  
Service = служба  
advocate = адвокат  
aggressive = агресивний  
anyway = у будь-якому разі  
axis = вісь  
balloon = повітряна куля  
beaver = бобер  
bridge = міст  
chant = скандування  
crowd = натовп  
dad = тато  
dense = щільний  
diet = дієта  
domestic = внутрішній  
doubt = сумнів  
editor = редактор  
electronic = електронний  
elsewhere = деінде  
enable = уможливлювати  
engineering = інженерія  
enjoy = насолоджуватися  
estate = маєток  
ethnic = етнічний  
exploit = експлуатувати  
extract = видобувати  
fellow = товариш  
founder = засновник  
frequency = частота  
garden = сад  
hurt = боліти  
imagery = зображення  
insurance = страхування  
interaction = взаємодія  
invisible = невидимий  
limited = обмежений  
meteorite = метеорит  
molecule = молекула  
opinion = думка  
otherwise = інакше  
parallel = паралельний  
partly = частково  
pathogen = патоген  
pile = купа  
presidency = президентство  
priority = пріоритет  
processing = обробка  
propaganda = пропаганда  
qualified = кваліфікований  
random = випадковий  
recession = рецесія  
refugee = біженець  
regardless = незалежно від  
removal = видалення  
reporter = репортер  
requirement = вимога  
resistance = опір  
sector = сектор  
seize = захоплювати  
shield = щит  
shirt = сорочка  
shutdown = відключення  
slavery = рабство  
stable = стабільний  
strength = сила  
strengthen = зміцнювати  
swim — swam — swum = плавати  
ticket = квиток  
unfortunately = на жаль  
unusual = незвичайний  
warming = потепління  
bay = затока  
December = Грудень  
Egypt = Єгипет  
English = англійський  
Jakarta = Джакарта  
monopoly = монополія  
spider = павук  
addition = додавання  
alternative = альтернатива  
appeal = апеляція  
appearance = зовнішність  
appoint = призначати  
archive = архів  
astronaut = астронавт  
bag = сумка  
bathroom = ванна  
booster = підсилювач  
burden = тягар  
buyback = викуп  
clue = підказка  
continent = континент  
decarbonize = декарбонізувати  
deepfake = діпфейк  
diaper = підгузник  
dioxide = діоксид  
display = дисплей  
dive = пірнати  
domain = домен  
dust = пил  
eastern = східний  
embrace = обіймати  
escape = втікати  
explode = вибухати  
facial = лицевий  
failure = невдача  
fashion = мода  
filter = фільтр  
fraud = шахрайство  
Fred = Фред  
funny = смішний  
handful = жменя  
harsh = суворий  
heavily = важко  
immigrant = іммігрант  
jail = в’язниця  
leverage = важіль  
log = колода  
odd = дивний  
pain = біль  
participant = учасник  
pathway = шлях  
pledge = обіцянка  
pregnant = вагітна  
prohibit = забороняти  
provider = постачальник  
purchase = покупка  
recognition = визнання  
recreate = відтворювати  
recruit = наймати  
reduction = скорочення  
restrict = обмежувати  
ruin = руїна  
runoff = стік  
saint = святий  
salary = зарплата  
settler = поселенець  
shoe = взуття  
sing — sang — sung = співати  
skate = ковзати  
solid = твердий  
string = рядок  
surf = серфінг  
SUV = позашляховик  
swimming = плавання  
talent = талант  
temporary = тимчасовий  
thought = думка  
tribe = плем’я  
tweet = твіт  
valuable = цінний  
via = через  
virtual = віртуальний  
visible = видимий  
wish = бажання  
wound = рана  
wrap = обгортка  
Arctic = Арктика  
Commonwealth = Співдружність  
Gaza = Газа  
accident = аварія  
acid = кислота  
adapt = адаптувати  
additive = добавка  
Afghan = афганський  
altogether = взагалі  
attach = прикріплювати  
blame = звинувачувати  
boundary = межа  
button = кнопка  
cancel = скасовувати  
cat = кіт  
catastrophic = катастрофічний  
chairman = голова  
clinic = клініка  
commitment = зобов’язання  
danger = небезпека  
detect = виявляти  
dirty = брудний  
distancing = дистанціювання  
diverse = різноманітний  
exciting = захоплюючий  
fatality = смертність  
finger = палець  
fox = лисиця  
ghost = привид  
honor = честь  
hopefully = сподіваюся  
Houthis = хусити  
insect = комаха  
invention = винахід  
invite = запрошувати  
livestock = худоба  
magic = магія  
manufacture = виробляти  
medication = ліки  
missile = ракета  
mortgage = іпотека  
oversight = нагляд  
pit = яма  
plenty = багато  
protective = захисний  
pulp = м’якоть  
quiet = тихий  
recommendation = рекомендація  
relation = відношення  
reputation = репутація  
rush = поспішити  
seal = печатка  
senior = старший  
shall = має  
shock = шок  
slave = раб  
Spotify = Спотіфай  
statistic = статистика  
streaming = потокове передавання  
stress = стрес  
sugar = цукор  
suppress = придушувати  
texture = текстура  
therefore = тому  
thrive = процвітати  
title = назва  
tournament = турнір  
understanding = розуміння  
vitamin = вітамін  
vocal = вокальний  
wet = мокрий  
whenever = коли завгодно  
winner = переможець  
withdraw = вилучати  
youth = молодь  
Asia = Азія  
Berlin = Берлін  
Bush = Буш  
Kabul = Кабул  
Wisconsin = Вісконсин  
accessible = доступний  
activate = активувати  
antibody = антитіло  
assemble = збирати  
attend = відвідувати  
awesome = чудовий  
beam = промінь  
billionaire = мільярдер  
bold = сміливий  
borrow = позичати  
canopy = навіс  
careful = обережний  
carefully = обережно  
catapult = катапульта  
competitive = конкурентний  
complaint = скарга  
contagious = заразний  
controversial = суперечливий  
corrupt = корумпований  
craft = ремесло  
cruise = круїз  
density = щільність  
deploy = розгортати  
discovery = відкриття  
dominant = домінуючий  
drought = посуха  
economist = економіст  
enormous = величезний  
Europe = Європа  
excess = надлишок  
execute = виконувати  
exploration = дослідження  
fatal = смертельний  
firm = фірма  
formal = формальний  
formula = формула  
frankly = відверто  
fungus = грибок  
gay = гей  
globe = глобус  
hail = град  
hell = пекло  
however = однак  
ideology = ідеологія  
ignore = ігнорувати  
incentive = стимул  
influential = впливовий  
install = встановлювати  
interpret = тлумачити  
kingdom = королівство  
lawyer = адвокат  
legalization = легалізація  
legislature = законодавча влада  
library = бібліотека  
liner = лайнер  
making = створення  
math = математика  
meaning = значення  
medicine = медицина  
minimize = мінімізувати  
monarchy = монархія  
navy = флот  
penalty = штраф  
proposal = пропозиція  
rally = мітинг  
reinforce = підсилювати  
rocket = ракета  
scientific = науковий  
sewer = каналізація  
simulation = симуляція  
smart = розумний  
soap = мило  
span = проміжок  
stack = стопка  
stare = дивитися  
submit = подавати  
surveyor = геодезист  
technically = технічно  
thin = тонкий  
toll = плата  
tooth — teeth = зуб  
treaty = договір  
uncertainty = невизначеність  
weigh = зважувати  
worldwide = всесвітній  
writing = письмо  
Alex = Алекс  
Arizona = Аризона  
Brooklyn = Бруклін  
COVID = КОВІД  
Jupiter = Юпітер  
Metro = Метро  
Paris = Париж  
Turkey = Туреччина  
alter = змінювати  
ambitious = амбітний  
argument = аргумент  
Asian = азійський  
assault = напад  
aware = усвідомлений  
awareness = обізнаність
blockbuster = блокбастер  
breakthrough = прорив  
broadcast = трансляція  
brother = брат  
cannabis = конопля  
celebrity = знаменитість  
chief = головний  
circumstance = обставина  
cocci = кокки  
colony = колонія  
conspiracy = змова  
contrast = контраст  
coup = переворот  
defeat = поразка  
delivery = доставка  
demonstrate = демонструвати  
depict = зображати  
dump = скидати  
enact = вводити в дію  
epidemic = епідемія  
equally = однаково  
escalate = загострювати  
everyday = щоденний  
existence = існування  
exoplanet = екзопланета  
expectation = очікування  
fraction = частка  
Fresnel = Френель  
galaxy = галактика  
globally = глобально  
govern = керувати  
graduate = випускник  
harmful = шкідливий  
harvest = урожай  
headline = заголовок  
headquarters = штаб-квартира  
heritage = спадщина  
importance = важливість  
indicate = вказувати  
inquit = розслідувати  
intend = мати намір  
joint = спільний  
justify = виправдовувати  
lean = спиратися  
license = ліцензія  
lord = лорд  
manufacturer = виробник  
menu = меню  
militant = бойовик  
monthly = щомісячний  
mouth = рот  
orbit = орбіта  
origin = походження  
phenomenon = явище  
plain = рівнина  
pour = наливати  
previously = раніше  
properly = належним чином  
rapid = швидкий  
receptor = рецептор  
relative = відносний  
render = надавати  
repair = ремонтувати  
ski = лижі  
soccer = футбол  
sovereignty = суверенітет  
speaker = спікер  
species = вид  
spectrum = спектр  
spending = витрати  
squeeze = стискати  
stone = камінь  
surrender = здаватися  
sustainable = стійкий  
tenant = орендар  
tide = приплив  
toxic = токсичний  
transport = транспорт  
tube = трубка  
umbrella = парасолька  
unite = об’єднувати  
variant = варіант  
weak = слабкий  
wipe = витирати  
working = робочий  
Antarctica = Антарктида  
Bible = Біблія  
Jersey = Джерсі  
absolute = абсолютний  
alongside = поруч  
animate = оживляти  
artifact = артефакт  
aspect = аспект  
assistant = помічник  
backwards = назад  
Benin = Бенін  
bury = ховати  
busy = зайнятий  
catastrophe = катастрофа  
cent = цент  
challenging = складний  
coffee = кава  
competitor = конкурент  
complexity = складність  
conference = конференція  
consistent = послідовний  
constant = постійний  
cry = плакати  
dedicate = присвячувати  
deposit = депозит  
depth = глибина  
dialogue = діалог  
disrupt = порушувати  
distribution = розподіл  
Dominican = Домініканський  
drain = злив  
duty = обов’язок  
dying = вмирання  
dyslexia = дислексія  
evangelical = євангельський  
fault = провина  
footprint = відбиток  
fresh = свіжий  
gate = ворота  
geothermal = геотермальний  
grain = зерно  
gross = валовий  
groundwater = підземні води  
guilty = винний  
hello = привіт  
hip = стегно  
humanity = людство  
identical = ідентичний  
immediate = негайний  
impose = накладати  
initiative = ініціатива  
injure = травмувати  
internal = внутрішній  
kitchen = кухня  
lagoon = лагуна  
legalize = легалізувати  
lifeboat = рятувальний човен  
luckily = на щастя  
lucky = щасливий  
lung = легеня  
mill = млин  
misinformation = дезінформація  
motor = двигун  
Muslim = мусульманин  
negotiate = домовлятися  
neutral = нейтральний  
obtain = отримувати  
occupation = заняття  
opposition = опозиція  
painter = художник  
Palestinian = палестинський  
permit = дозвіл  
physicist = фізик  
pixel = піксель  
plantation = плантація  
porn = порно  
practical = практичний  
profile = профіль  
proper = належний  
proud = гордий  
province = провінція  
qualify = кваліфікуватися  
ramp = пандус  
rank = ранг  
recover = відновлюватися  
representation = представництво  
respiratory = дихальний  
retire = виходити на пенсію  
revolutionary = революційний  
rival = суперник  
schedule = розклад  
script = сценарій  
sculpture = скульптура  
seaweed = морські водорості  
seed = насіння  
sentence = речення  
staff = персонал  
strain = напруга  
strait = протока  
strategic = стратегічний  
suffering = страждання  
survival = виживання  
swap = обмін  
tilt = нахил  
trillion = трильйон  
verify = перевіряти  
vibration = вібрація  
victim = жертва  
visitor = відвідувач  
warn = попереджати  
whereas = тоді як  
whom = кого  
yard = двір  
Boston = Бостон  
Dutch = голландський  
Iceland = Ісландія  
Indonesia = Індонезія  
institute = інститут  
mount = гора  
Northern = північний  
politburo = політбюро  
rights = права  
secretary = секретар  
Vancouver = Ванкувер  
accuse = звинувачувати  
adoption = усиновлення  
afraid = наляканий  
alcohol = алкоголь  
apology = вибачення  
association = асоціація  
basketball = баскетбол  
beauty = краса  
bend — bent — bent = згинати  
beneath = під  
biodiversity = біорізноманіття  
brightness = яскравість  
bucket = відро  
bump = горбик  
CEO = генеральний директор  
ceremony = церемонія  
chaos = хаос  
cite = цитувати  
citizenship = громадянство  
clothe = одягати  
commission = комісія  
composition = композиція  
concentrate = концентрувати  
conclude = завершувати  
consent = згода  
consumption = споживання  
countryside = сільська місцевість  
creator = творець  
darkness = темрява  
database = база даних  
definition = визначення  
dessert = десерт  
dimensional = розмірний  
disagree = не погоджуватися  
distinct = окремий  
donor = донор  
drainage = дренаж  
drill = свердлити  
duck = качка  
elderly = літній  
electron = електрон  
encounter = зустріч  
equivalent = еквівалент  
exclude = виключати  
expense = витрата  
express = виражати  
expression = вираз  
fever = лихоманка  
follower = послідовник  
forth = вперед  
gathering = зібрання  
graph = графік  
having = наявність  
hearing = слух  
hike = похід  
historian = історик  
honest = чесний  
infected = заражений  
ingredient = інгредієнт  
injury = травма  
Instagram = Інстаграм  
instruction = інструкція  
intention = намір  
Iranian = іранський  
iwi = плем’я  
jaw = щелепа  
jury = присяжні  
lobby = лобі  
metric = метричний  
micro = мікро  
mode = режим  
myopia = короткозорість  
neither = жоден  
novel = роман  
patent = патент  
petition = петиція  
pink = рожевий  
plot = сюжет  
pocket = кишеня  
popularity = популярність  
prior = попередній  
prioritize = надавати пріоритет  
privilege = привілей  
puzzle = головоломка  
quiz = вікторина  
recording = запис  
refine = очищати  
rough = грубий  
saving = заощадження  
scare = лякати  
shade = тінь  
shelf = полиця  
sight = зір  
skateboard = скейтборд  
slide = слайд  
smell = запах  
smile = усмішка  
subscriber = передплатник  
sustain = підтримувати  
terrible = жахливий  
thick = товстий  
unlikely = малоймовірний  
urge = закликати  
violation = порушення  
virtually = віртуально  
airlines = авіалінії  
Alabama = Алабама  
Filipino = філіппінський  
Houston = Х’юстон  
Hyde = Хайд  
Indus = Інд  
Ohio = Огайо  
Pacific = Тихий океан  
Phoenix = Фенікс  
accumulate = накопичувати  
airport = аеропорт  
animator = аніматор  
anon = анонім  
anthropos = антропос  
award = нагорода  
bedroom = спальня  
blanket = ковдра  
boycott = бойкот  
brick = цегла  
brilliant = блискучий  
brutality = жорстокість  
cab = таксі  
calculate = розраховувати  
Canadian = канадський  
cap = кришка  
cargo = вантаж  
carrier = перевізник  
chef = шеф-кухар  
Christian = християнський  
circular = круговий  
classroom = класна кімната  
clinical = клінічний  
closely = тісно  
coach = тренер  
compartment = відсік  
compromise = компроміс  
concert = концерт  
confine = обмежувати  
congestion = затори  
construct = будувати  
cook = готувати  
corn = кукурудза  
council = рада  
crater = кратер  
criticize = критикувати  
crowded = переповнений  
daughter = дочка  
dependent = залежний  
detailed = детальний  
diagram = діаграма  
diamond = діамант  
dirt = бруд  
discuss = обговорювати  
displace = зміщувати  
enslave = поневолювати  
error = помилка  
evolution = еволюція  
examine = досліджувати  
explosive = вибуховий  
false = помилковий  
fancy = вишуканий  
flame = полум’я  
Florida = Флорида  
foster = сприяти  
gift = подарунок  
glacier = льодовик  
hill = пагорб  
humanitarian = гуманітарний  
indoor = внутрішній  
infectious = інфекційний  
instance = приклад  
joke = жарт  
kinda = типу  
laugh = сміятися  
legally = законно  
lens = об’єктив  
literacy = грамотність  
logo = логотип  
makeup = макіяж  
marriage = шлюб  
migration = міграція  
mild = м’який  
mineral = мінерал  
minor = незначний  
mitigate = пом’якшувати  
mujahideen = моджахеди  
narrator = оповідач  
nursing = догляд  
overthrow = повалити  
pace = темп  
peer = ровесник  
podcast = подкаст  
pollster = соціолог  
pope = папа  
prominent = видатний  
proof = доказ  
publicly = публічно  
punish = карати  
racist = расистський  
regularly = регулярно  
relief = полегшення  
reminder = нагадування  
remnant = залишок  
reparation = відшкодування  
Republicans = республіканці  
resist = чинити опір  
rice = рис  
ridge = хребет  
ridiculous = смішний  
rifle = гвинтівка  
rip = рвати  
risky = ризикований  
robot = робот  
scream = кричати  
sheet = лист  
slash = рубати  
Spanish = іспанський  
sphere = сфера  
statehood = державність  
strip = смуга  
subtle = тонкий  
swell = набухати  
tape = стрічка  
taste = смак  
Terri = Террі  
theme = тема  
tomorrow = завтра  
tonight = сьогодні ввечері  
transmit = передавати  
triple = потрійний  
tweak = налаштувати  
ultimate = остаточний  
undermine = підривати  
update = оновлення  
urgent = терміновий  
vegetation = рослинність  
vertical = вертикальний  
violate = порушувати  
weaken = послаблювати  
whoa = ого  
wobble = хитатися  
yield = врожай  
Germans = німці  
Greenland = Гренландія  
metals = метали  
Nigeria = Нігерія  
Syria = Сирія  
Tennessee = Теннессі  
Wade = Вейд  
absentee = відсутній  
academic = академічний  
align = вирівнювати  
apologize = вибачатися  
apparently = очевидно  
appreciate = цінувати  
arcade = аркада  
array = масив  
atom = атом  
banana = банан  
bet = ставка  
bloody = кривавий  
brush = щітка  
bug = жук  
builder = будівельник  
bullet = куля  
buyer = покупець  
calculator = калькулятор  
canyon = каньйон  
capsule = капсула  
charity = благодійність  
chin = підборіддя  
cholera = холера  
chunk = шматок  
Clearview = Клірвью  
compound = сполука  
compress = стискати  
concentration = концентрація  
confidence = впевненість  
contamination = забруднення  
cotton = бавовна  
cute = милий  
deserve = заслуговувати  
desire = бажання  
discipline = дисципліна  
discriminate = дискримінувати  
dispute = суперечка
drinking = пиття  
driving = водіння  
educate = навчати  
efficiently = ефективно  
emphasize = підкреслювати  
endanger = наражати на небезпеку  
faith = віра  
fifty = п’ятдесят  
finance = фінансувати  
firearm = вогнепальна зброя  
fishing = риболовля  
freeze — froze — frozen = замерзати  
golden = золотий  
hemisphere = півкуля  
hook = гачок  
hormuz = Хормуз  
husband = чоловік  
impressive = вражаючий  
influenza = грип  
intellectual = інтелектуальний  
investigator = слідчий  
italian = італійський  
jurisdiction = юрисдикція  
killer = вбивця  
landmark = орієнтир  
legitimate = законний  
maker = виробник  
manager = менеджер  
marry = одружуватися  
master = майстер  
meantime = тим часом  
median = медіана  
microscope = мікроскоп  
mob = натовп  
mortality = смертність  
multi = багато  
narrative = оповідь  
nationalist = націоналіст  
neglect = нехтувати  
newsroom = редакція  
nutrient = поживна речовина  
obligation = обов’язок  
obsess = одержимий  
opt = вибирати  
organizer = організатор  
originally = спочатку  
output = вихід  
overturn = перевертати  
overwhelm = перевантажувати  
owe = заборгувати  
peacock = павич  
performer = виконавець  
phenylephrine = фенілефрин  
philosophy = філософія  
pitbull = пітбуль  
planning = планування  
prayer = молитва  
prevention = профілактика  
prisoner = в’язень  
radical = радикальний  
react = реагувати  
regional = регіональний  
resemble = нагадувати  
reward = нагорода  
riot = бунт  
rotate = обертати  
safely = безпечно  
scandal = скандал  
scared = наляканий  
scratch = дряпати  
screw = гвинт  
sheep — sheep = вівця  
shiny = блискучий  
silver = срібний  
sister = сестра  
slogan = гасло  
spiral = спіраль  
sponge = губка  
spy = шпигун  
statue = статуя  
stimulus — stimuli = стимул  
structural = структурний  
suppression = придушення  
surplus = надлишок  
suspend = призупиняти  
swoop = налітати  
tackle = вирішувати  
tire = шина  
tourist = турист  
transformation = трансформація  
tribal = племінний  
tropical = тропічний  
turning = поворот  
upper = верхній  
vaccination = вакцинація  
variable = змінна  
warning = попередження  
weekend = вихідні  
wildfire = лісова пожежа  
Arkansas = Арканзас  
canadians = канадці  
Columbia = Колумбія  
Iraq = Ірак  
Jerusalem = Єрусалим  
medicaid = медична допомога  
Minister = міністр  
parliament = парламент  
Seattle = Сіетл  
standing = стоячи  
Western = західний  
abandon = покидати  
abroad = за кордоном  
academy = академія  
accelerate = прискорювати  
acquire = набувати  
admit = визнавати  
advertise = рекламувати  
affluent = заможний  
agent = агент  
alien = чужий  
allocate = розподіляти  
ambition = амбіція  
anger = гнів  
announcement = оголошення  
anticipate = передбачати  
assign = призначати  
attendant = супроводжуючий  
automatically = автоматично  
bias = упередження  
bidding = торги  
blast = вибух  
breakfast = сніданок  
brutalist = бруталістичний  
buck = долар  
bull = бик  
calf — calves = теля  
casualty = жертва  
chatbot = чат-бот  
chatgpt = ЧатGPT  
cheat = обманювати  
client = клієнт  
club = клуб  
coastal = прибережний  
command = команда  
commonly = зазвичай  
complain = скаржитися  
comprehensive = всебічний  
conclusion = висновок  
conditioning = кондиціонування  
congressional = конгресовий  
conservation = збереження  
constitutional = конституційний  
contestant = учасник  
cop = поліцейський  
crush = розчавити  
crystal = кристал  
demographic = демографічний  
designate = призначати  
destination = пункт призначення  
diabete = діабет  
dip = занурювати  
disability = інвалідність  
divert = відводити  
downtown = центр міста  
draft = чернетка  
drum = барабан  
dynamite = динаміт  
edit = редагувати  
efficiency = ефективність  
emotional = емоційний  
entry = вхід  
ethical = етичний  
exclusive = ексклюзивний  
excuse = виправдання  
expel = виключати  
farmland = сільськогосподарські угіддя  
FBI = ФБР  
fee = плата  
flash = спалах  
flashcard = картка  
formally = офіційно  
george = Джордж  
gesture = жест  
glory = слава  
got = отримав  
gothic = готичний  
governance = управління  
grandfather = дідусь  
grandmother = бабуся  
hat = капелюх  
Hawaii = Гаваї  
headphone = навушники  
heal = зцілювати  
hop = стрибати  
horse = кінь  
hypothesis — hypotheses = гіпотеза  
ignite = запалювати  
illustrate = ілюструвати  
infrared = інфрачервоний  
inherit = успадковувати  
intervene = втручатися  
knee = коліно  
lap = коло  
laptop = ноутбук  
lava = лава  
liberty = свобода  
licensing = ліцензування  
linear = лінійний  
loose = вільний  
lunch = обід  
marble = мармур  
marker = маркер  
maximum = максимум  
microfauna = мікрофауна  
musician = музикант  
mutate = мутувати  
mystery = таємниця  
navigate = орієнтуватися  
neck = шия  
nervous = нервовий  
newly = недавно  
offside = поза грою  
ongoing = триваючий  
ownership = власність  
parkour = паркур  
paycheck = зарплата  
penetrate = проникати  
pew = лавка  
phrase = фраза  
piano = фортепіано  
poison = отрута  
poop = какати  
precise = точний  
prefer = віддавати перевагу  
prevail = переважати  
pseudoephedrine = псевдоефедрин  
raw = сирий  
reasonable = розумний  
rebel = бунтівник  
reconstruction = реконструкція  
regard = повага  
remarkable = примітний  
repeatedly = неодноразово  
replacement = заміна  
reproduce = відтворювати  
resign = подавати у відставку  
rider = вершник  
rodent = гризун  
sad = сумний  
scatter = розкидати  
seasonal = сезонний  
sediment = осад  
seemingly = здається  
segregation = сегрегація  
sensitive = чутливий  
shootout = перестрілка  
shower = душ  
simulate = симулювати  
singe = обпалювати  
sle = санчата  
slope = схил  
smoke = дим  
stair = сходи  
steady = стабільний  
stylize = стилізувати  
succeed = досягати успіху  
suck = смоктати  
supplement = додаток  
surprising = дивовижний  
suspect = підозрювати  
swarm = рій  
synthetic = синтетичний  
teaching = навчання  
textbook = підручник  
thickness = товщина  
thus = таким чином  
tick = кліщ  
tower = вежа  
traditionally = традиційно  
trash = сміття  
tunnel = тунель  
unity = єдність  
utility = корисність  
veto = вето  
volcano — volcanoes = вулкан  
wavelength = довжина хвилі  
welfare = добробут  
wheel = колесо  
whoever = хто б не  
wildly = дико  
wireless = бездротовий  
witness = свідок